,scorer,neutral,minute,own_goal,penalty,home_goal,away_goal,total_goals,nation
0,A'ala Hubail,5,717.0,0,1,10,3,13,Bahrain
1,A. Elangovan,0,42.0,0,0,1,0,1,Malaysia
2,Aage Rou Jensen,0,85.0,0,0,0,1,1,Republic of Ireland
3,Aaran Lines,1,170.0,0,0,3,0,3,New Zealand
4,Aaron Boupendza,1,16.0,0,0,0,1,1,Comoros
5,Aaron Hughes,0,5.0,0,0,1,0,1,Northern Ireland
6,Aaron Long,0,131.0,0,0,2,0,2,United States
7,Aaron Mooy,0,217.0,0,0,2,2,4,Australia
8,Aaron Njovu,1,108.0,0,0,1,1,2,Nigeria
9,Aaron Ramsey,2,813.0,0,5,7,10,17,Liechtenstein
10,Aaron Tumwa,0,90.0,0,0,1,0,1,Antigua and Barbuda
11,Aarón Padilla Gutiérrez,0,80.0,0,0,1,1,2,Jamaica
12,Aatef Jenyat,1,17.0,0,0,0,1,1,Afghanistan
13,Abay Bokoleyev,1,63.0,0,0,0,1,1,Myanmar
14,Abbas Ahmed Atwi,1,122.0,0,1,1,1,2,Lebanon
15,Abbas Chahrour,0,28.0,0,0,1,0,1,Lebanon
16,Abbas Hassan Hassun,2,147.0,0,0,0,2,2,Macau
17,Abbas Obeid,1,4.0,0,0,0,1,1,Japan
18,Abbas Souan,0,90.0,0,0,1,0,1,Israel
19,Abdah Alif,1,32.0,0,0,0,1,1,United Arab Emirates
20,Abdallah Azhar,1,160.0,0,1,2,1,3,Morocco
21,Abdallah Deeb,0,291.0,0,2,2,5,7,Jordan
22,Abdallah El Said,1,242.0,0,0,3,1,4,Egypt
23,Abdel Halim Ali,1,135.0,0,0,3,1,4,Egypt
24,Abdel Kafi El-Sheikh,0,38.0,0,0,1,0,1,Sudan
25,Abdel Rasoul Hesham,0,146.0,0,0,2,1,3,Malawi
26,Abdel Razak Al-Farjani,0,43.0,0,0,1,0,1,Libya
27,Abdel Razak Jaranah,0,58.0,0,0,1,0,1,Libya
28,Abdel Sattar Sabry,1,159.0,0,0,3,1,4,Egypt
29,Abdel-Hadi Al-Maharmeh,0,28.0,0,0,0,1,1,Laos
30,Abdel-Zaher El-Saqqa,0,84.0,1,0,1,1,2,Egypt
31,Abdelatif Bahdari,0,90.0,0,0,1,0,1,Palestine
32,Abdelaziz Barrada,0,3.0,0,0,1,0,1,Morocco
33,Abdelaziz Daidi,0,44.0,0,0,1,0,1,Morocco
34,Abdelaziz Ibrahim Adam,1,90.0,0,0,0,1,1,Nigeria
35,Abdelfattah El Khattari,0,48.0,0,0,2,0,2,Morocco
36,Abdelfettah Rhiati,1,83.0,0,0,1,1,2,Ivory Coast
37,Abdelghani Lakhal,0,35.0,0,0,1,0,1,Morocco
38,Abdelhafid Tasfaout,2,449.0,0,0,7,3,10,Algeria
39,Abdelhakim Serrar,0,20.0,1,0,0,1,1,Algeria
40,Abdelilah Hafidi,0,82.0,0,0,0,1,1,South Africa
41,Abdeljalil Hadda,2,397.0,0,0,5,1,6,Morocco
42,Abdelkabir Mezyane,0,72.0,0,0,1,0,1,Morocco
43,Abdelkader Ben Hassen,1,48.0,0,0,1,0,1,Tunisia
44,Abdelkader Ferhaoui,1,36.0,0,0,1,0,1,Algeria
45,Abdelkader Ghezzal,0,86.0,0,0,2,0,2,Algeria
46,Abdelkader Rakbaoui,0,72.0,0,0,2,0,2,Tunisia
47,Abdelkarim Hassan,1,164.0,0,0,1,2,3,Hong Kong
48,Abdelkrim Merry,2,168.0,0,1,1,2,3,Cameroon
49,Abdellah Tazi,1,19.0,0,0,1,0,1,Morocco
50,Abdelmajid Bouyboud,0,93.0,0,0,0,2,2,Tunisia
51,Abdelmajid Chetali,1,109.0,0,0,2,1,3,Tunisia
52,Abdelmajid Tlemçani,0,60.0,0,0,1,0,1,Tunisia
53,Abdelmalek Cherrad,1,125.0,0,0,2,2,4,Algeria
54,Abdelmoumene Djabou,2,158.0,0,0,0,2,2,South Korea
55,Abdelmutaleb Nasir,1,40.0,0,0,0,1,1,Ethiopia
56,Abdelrazak Belgharbi,1,36.0,1,0,0,1,1,Algeria
57,Abdelrazaq Al Hussain,4,251.0,0,0,1,3,4,Saudi Arabia
58,Abdelwahab Lahmar,0,84.0,0,0,1,0,1,Tunisia
59,Abdelâali Zahraoui,2,168.0,0,0,1,1,2,Morocco
60,Abderraouf Ben Aziza,2,266.0,0,0,3,1,4,Egypt
61,Abderrazak Hamdallah,0,39.0,0,1,1,0,1,Morocco
62,Abderrazak Khairi,2,45.0,0,0,0,2,2,Portugal
63,Abdesalam Kames,1,42.0,0,0,1,0,1,Libya
64,Abdeslam Laghrissi,0,62.0,0,0,1,0,1,Morocco
65,Abdeslam Ouaddou,2,165.0,0,0,1,1,2,Morocco
66,Abdessalam Benjelloun,0,40.0,0,0,1,1,2,Morocco
67,Abdesselam Adhouma,0,15.0,0,0,0,1,1,Ivory Coast
68,Abdesselem Cheman,1,87.0,0,0,1,0,1,Tunisia
69,Abdi Idleh Hamza,0,74.0,0,0,1,0,1,Djibouti
70,Abdiel Arroyo,3,326.0,0,0,3,2,5,Chile
71,Abdoh Otaif,0,78.0,0,1,2,1,3,Saudi Arabia
72,Abdolreza Barzegari,2,114.0,0,0,0,2,2,Bangladesh
73,Abdou Bin Amidou,0,39.0,0,0,0,1,1,DR Congo
74,Abdou Diallo,1,151.0,0,0,1,1,2,Senegal
75,Abdou Jammeh,0,93.0,0,0,2,0,2,Gambia
76,Abdou Karim Sèye,0,24.0,0,0,1,0,1,Senegal
77,Abdou Traoré,0,54.0,0,0,0,1,1,Rwanda
78,Abdou-Rahman Njie,0,64.0,0,0,1,0,1,Gambia
79,Abdoul Camara,2,107.0,0,1,1,2,3,Botswana
80,Abdoul Tapsoba,4,220.0,0,0,2,2,4,Burkina Faso
81,Abdoul-Aziz Nikiema,0,79.0,0,0,1,0,1,Burkina Faso
82,Abdoulai Demba,0,48.0,0,0,1,0,1,Mali
83,Abdoulay Diaby,1,37.0,0,0,1,0,1,Mali
84,Abdoulaye Ba,0,63.0,0,0,1,0,1,Senegal
85,Abdoulaye Cissé,0,79.0,0,0,2,0,2,Burkina Faso
86,Abdoulaye Emmerson,0,116.0,0,0,2,0,2,Guinea
87,Abdoulaye Faye,1,155.0,0,0,3,0,3,Senegal
88,Abdoulaye M'Baye,1,80.0,0,0,0,1,1,Zambia
89,Abdoulaye Makhtar Diop,0,32.0,0,0,1,0,1,Senegal
90,Abdoulaye Traoré,9,888.0,0,1,13,4,17,Ivory Coast
91,Abdukahhor Marifaliev,0,62.0,0,0,0,2,2,Cambodia
92,Abdul Aziz Al-Muqbali,1,382.0,0,0,6,1,7,Oman
93,Abdul Aziz Corr,0,18.0,0,1,1,0,1,Gambia
94,Abdul Farooq,0,80.0,0,0,0,1,1,Jordan
95,Abdul Hadi Yahya,0,70.0,0,0,0,1,1,Singapore
96,Abdul Hakim,0,80.0,0,0,1,0,1,India
97,Abdul Hamid Al Katbi,0,36.0,0,0,1,0,1,Syria
98,Abdul Jaloof,0,126.0,0,0,1,1,2,Qatar
99,Abdul Kader Kardaghli,0,4.0,0,0,1,0,1,Syria
100,Abdul Kader Keïta,4,457.0,0,0,8,0,8,Ivory Coast
101,Abdul Kader Rifai,0,10.0,0,0,1,0,1,Syria
102,Abdul Latif Helou,0,226.0,0,0,2,2,4,Saudi Arabia
103,Abdul Majeed Waris,0,141.0,0,0,3,0,3,Ghana
104,Abdul Mubin Mokhtar,0,132.0,0,0,3,0,3,Malaysia
105,Abdul Nzayinawo,0,64.0,0,0,1,0,1,Angola
106,Abdul Rahman Abdulla,0,65.0,0,0,1,0,1,Yemen
107,Abdul Razaq Ibrahim,0,52.0,0,0,2,1,3,United Arab Emirates
108,Abdul Rwatubyaye,0,21.0,0,0,1,0,1,Rwanda
109,Abdul Sesay,1,81.0,0,0,1,0,1,Sierra Leone
110,Abdul-Aziz Hassan,0,45.0,0,0,1,0,1,Qatar
111,Abdul-Hamid Bassiouny,0,127.0,0,0,3,0,3,Egypt
112,Abdul-Wahab Abu Al-Hail,4,243.0,0,3,5,2,7,Iraq
113,Abdulaziz Al Sulaiti,0,14.0,0,0,0,1,1,Indonesia
114,Abdulaziz Al-Anberi,2,646.0,0,0,9,4,13,Kuwait
115,Abdulaziz Al-Dosari,0,30.0,0,0,1,0,1,Saudi Arabia
116,Abdulaziz Al-Hajeri,0,5.0,0,0,0,1,1,Pakistan
117,Abdulaziz Hatem,5,256.0,0,0,3,4,7,South Korea
118,Abdulaziz Mohamed,1,241.0,0,0,2,1,3,United Arab Emirates
119,Abdulfattah Asiri,0,95.0,0,0,2,0,2,Saudi Arabia
120,Abdulfattah Shehab,0,64.0,0,0,1,1,2,Singapore
121,Abdulgadir Ilyas Bakur,0,37.0,0,0,0,1,1,Uzbekistan
122,Abdulghani Tatiche,0,12.0,0,0,0,1,1,Iran
123,Abdulla Al Marzooqi,0,8.0,0,0,1,0,1,Bahrain
124,Abdulla Baba Fatadi,0,71.0,0,0,1,1,2,Bahrain
125,Abdulla Nasur,1,25.0,0,0,0,2,2,Zambia
126,Abdullah Al-Buloushi,2,154.0,0,0,1,1,2,France
127,Abdullah Al-Dosari,1,155.0,0,0,1,1,2,Macau
128,Abdullah Al-Hamdan,0,61.0,0,0,1,0,1,Saudi Arabia
129,Abdullah Al-Waked,0,61.0,0,1,1,1,2,Bahrain
130,Abdullah Bin Shehan,2,209.0,0,0,1,4,5,Thailand
131,Abdullah Fawaz,2,281.0,0,1,3,2,5,Afghanistan
132,Abdullah Jumaan Al-Dosari,0,50.0,0,0,1,0,1,Saudi Arabia
133,Abdullah Mawei,0,59.0,0,0,1,0,1,Kuwait
134,Abdullah Omar,1,66.0,0,0,0,1,1,Yemen
135,Abdullah Wabran,2,83.0,0,0,3,0,3,Kuwait
136,Abdullah Yousuf Ma'yoof,0,16.0,0,0,0,1,1,Qatar
137,Abdulnaser Abbas,1,88.0,0,0,1,0,1,Yemen
138,Abdulnasser Al-Obaidly,1,93.0,0,0,0,2,2,Japan
139,Abdulrahim Jumaa,0,19.0,0,0,1,0,1,United Arab Emirates
140,Abdulrahman Al-Qahtani,1,45.0,0,0,1,0,1,Saudi Arabia
141,Abdulrahman Fawzi,3,109.0,0,0,2,1,3,Israel
142,Abdulrahman Ibrahim,0,148.0,0,0,2,0,2,United Arab Emirates
143,Abdulrahman Mohamed,0,78.0,0,0,1,0,1,United Arab Emirates
144,Abdulrazaq Ibrahim Balooshi,2,320.0,0,1,6,0,6,United Arab Emirates
145,Abdulsalaam Jumaa,0,49.0,0,0,0,1,1,Brunei
146,Abdulsalam Al Ghurbani,0,170.0,0,0,2,1,3,India
147,Abdulwahab Al-Malood,0,153.0,0,0,1,1,2,Philippines
148,Abdulwasea Al-Matari,1,37.0,0,0,1,1,2,Yemen
149,Abdy Bäşimow,0,44.0,0,0,1,0,1,Turkmenistan
150,Abe Lenstra,0,106.0,0,0,3,0,3,Netherlands
151,Abedi Pele,6,411.0,0,0,3,5,8,Zambia
152,Abedi Saïd,0,77.0,0,0,3,0,3,Rwanda
153,Abekah Ankrah,0,18.0,0,0,0,1,1,Nigeria
154,Abel Aguilar,3,261.0,0,0,3,2,5,Peru
155,Abel Balbo,4,249.0,0,0,2,3,5,Australia
156,Abel Hernández,5,246.0,0,1,6,0,6,Uruguay
157,Abel Lobatón,1,16.0,0,0,1,0,1,Peru
158,Abel Xavier,0,128.0,0,0,1,1,2,Slovakia
159,Abelardo Fernández,0,43.0,0,0,2,0,2,Spain
160,Abinesh Samy,2,145.0,0,0,2,0,2,Fiji
161,Ablie Jallow,2,100.0,0,0,1,1,2,Mauritania
162,Abner Trigueros,1,176.0,0,0,1,1,2,Guatemala
163,Abou Diaby,0,20.0,0,0,0,1,1,Finland
164,Abou Seydou,0,89.0,0,0,1,0,1,Niger
165,Aboubacar Titi Camara,1,44.0,0,0,0,1,1,Senegal
166,Aboubakar Kamara,0,22.0,0,0,1,0,1,Mauritania
167,Aboubakari Ouédraogo,1,74.0,0,0,0,1,1,Sierra Leone
168,Abraham Tedros,0,89.0,0,0,0,1,1,Rwanda
169,Abram Raselemane,1,35.0,0,0,0,1,1,Jamaica
170,Absalom Iimbondi,0,25.0,0,0,1,0,1,Namibia
171,Abu Kamara,0,23.0,1,0,0,1,1,Sierra Leone
172,Abu Kanu,0,104.0,0,0,2,0,2,Sierra Leone
173,Abu Obeida Adam,0,82.0,0,0,1,0,1,Sudan
174,Abuaagla Abdalla,0,53.0,1,0,1,0,1,Morocco
175,Abubakar Al-Mass,0,74.0,0,0,1,0,1,Yemen DPR
176,Abubaker Bani,0,161.0,0,0,2,0,2,Libya
177,Abubaker Ben Brahim,0,53.0,0,0,1,0,1,Libya
178,Abubaker Tabula,0,77.0,0,0,1,0,1,Uganda
179,Abubeker Nassir,0,86.0,0,0,0,1,1,Zimbabwe
180,Abukari Gariba,2,140.0,0,0,0,2,2,Benin
181,Abzal Beisebekov,0,62.0,1,0,0,1,1,Kazakhstan
182,Achille Emaná,2,239.0,0,0,2,3,5,Cameroon
183,Achraf Dari,1,9.0,0,0,0,1,1,Croatia
184,Achraf Hakimi,2,326.0,0,0,4,1,5,Morocco
185,Aco Stojkov,0,176.0,0,0,4,0,4,North Macedonia
186,Ad-Diba,4,271.0,0,0,5,1,6,Egypt
187,Adalbert Deşu,1,1.0,0,0,0,1,1,Peru
188,Adalberto Escobar,0,63.0,0,0,0,2,2,Bolivia
189,Adam Abdulativ,0,142.0,0,0,2,0,2,Maldives
190,Adam Buksa,0,375.0,0,0,2,3,5,Poland
191,Adam El-Abd,0,4.0,1,0,0,1,1,Egypt
192,Adam Gnezda Čerin,0,84.0,0,0,1,0,1,Slovenia
193,Adam Hložek,1,65.0,0,0,0,1,1,Belarus
194,Adam Johnson,0,152.0,0,0,1,1,2,England
195,Adam Lallana,0,140.0,0,0,1,1,2,Slovakia
196,Adam Ledwoń,0,32.0,0,0,1,0,1,Poland
197,Adam Marušić,0,47.0,0,0,0,2,2,Turkey
198,Adam Ndlovu,1,265.0,0,0,2,3,5,Zimbabwe
199,Adam Nemec,0,336.0,0,0,5,3,8,North Macedonia
200,Adam Newton,0,88.0,0,0,0,1,1,Barbados
201,Adam Ounas,3,166.0,0,0,1,2,3,Tanzania
202,Adam Taggart,0,44.0,0,0,0,3,3,Taiwan
203,Adama Coulibaly,0,32.0,0,0,1,0,1,Mali
204,Adama Diomande,0,77.0,0,0,1,0,1,Norway
205,Adama Guira,1,90.0,1,0,0,1,1,Burkina Faso
206,Adama Klofie Koné,1,2.0,0,0,1,0,1,Ivory Coast
207,Adama Traoré,5,173.0,0,0,5,0,5,Mali
208,Adane Girma,1,155.0,0,0,1,1,2,Ethiopia
209,Adel Abbas Hussain,1,60.0,0,1,1,0,1,Kuwait
210,Adel Abdelrahman,1,75.0,0,0,0,1,1,Ivory Coast
211,Adel Abdulrahman Marzouq,1,1.0,0,0,1,0,1,Bahrain
212,Adel Al-Salimi,0,208.0,0,1,3,2,5,Brunei
213,Adel Chedli,0,147.0,0,0,2,0,2,Tunisia
214,Adel Khamis,0,150.0,0,0,2,1,3,Qatar
215,Adel Khamis Al Noobi,0,30.0,0,0,1,0,1,Qatar
216,Adel Khudhair,1,63.0,0,0,1,0,1,Iraq
217,Adel Malulla,0,90.0,0,0,1,0,1,Qatar
218,Adel Mohamed Abdulla,0,75.0,0,0,0,2,2,Bahrain
219,Adel Mubarak Khamis,0,85.0,0,0,0,1,1,Iraq
220,Adel Sellimi,2,429.0,0,3,3,5,8,Tunisia
221,Adel Taarabt,0,178.0,0,0,0,2,2,Togo
222,Adelaido Camaití,2,46.0,0,0,0,2,2,Peru
223,Adelardo Rodríguez,1,35.0,0,0,0,1,1,Brazil
224,Adem Ljajić,0,233.0,0,0,2,1,3,Serbia
225,Ademir de Menezes,6,930.0,0,0,20,2,22,Bolivia
226,Ademola Adeshina,1,118.0,0,0,1,1,2,Ethiopia
227,Adhemar Canavesi,1,85.0,1,0,1,0,1,Argentina
228,Adi Hütter,0,176.0,0,0,2,0,2,Austria
229,Adi Said,0,36.0,0,0,0,1,1,Taiwan
230,Adil Khan,0,88.0,0,0,1,0,1,India
231,Adis Jahović,0,149.0,0,1,1,1,2,Serbia
232,Adisak Kraisorn,2,208.0,0,0,2,1,3,Thailand
233,Admir Mehmedi,2,320.0,0,0,4,2,6,Switzerland
234,Admiral Muskwe,0,86.0,0,0,1,0,1,Zimbabwe
235,Adnan Ahmed Al-Sabbou,0,88.0,0,0,0,1,1,Bahrain
236,Adnan Al Talyani,6,908.0,0,0,13,5,18,United Arab Emirates
237,Adnan Ali Deif,0,69.0,0,0,1,0,1,Bahrain
238,Adnan Dirjal,1,89.0,0,0,1,0,1,Iraq
239,Adnan Januzaj,1,51.0,0,0,0,1,1,England
240,Adnan Kovačević,0,88.0,1,0,1,0,1,Greece
241,Adnan Ćustović,0,90.0,0,0,1,0,1,Bosnia and Herzegovina
242,Ado Onaiwu,0,91.0,0,1,3,0,3,Japan
243,Adokiye Amiesimaka,1,120.0,0,0,1,1,2,Ivory Coast
244,Adolf Scherer,4,546.0,0,1,8,2,10,Czechoslovakia
245,Adolf Urban,0,38.0,0,0,0,1,1,Finland
246,Adolfino Cañete,2,122.0,0,0,2,0,2,Paraguay
247,Adolfo Aldana,0,90.0,0,0,1,0,1,Spain
248,Adolfo Bautista,4,155.0,0,0,4,2,6,Mexico
249,Adolfo Erico,1,38.0,0,1,1,0,1,Paraguay
250,Adolfo Magallanes,2,41.0,0,0,1,1,2,Peru
251,Adolfo Olivares,0,113.0,0,0,1,1,2,Chile
252,Adolfo Pedernera,1,98.0,0,0,3,0,3,Argentina
253,Adolfo Valencia,2,391.0,0,0,3,3,6,Colombia
254,Adolfo Zumelzú,2,163.0,0,0,4,0,4,Argentina
255,Adolpho Millón Junior,0,77.0,0,0,1,0,1,Brazil
256,Adoram Keisi,0,37.0,0,0,0,2,2,Cyprus
257,Adrian Aliaj,0,101.0,1,0,2,0,2,Republic of Ireland
258,Adrian Alston,0,250.0,0,0,4,0,4,Australia
259,Adrian Bumbescu,0,70.0,0,0,1,0,1,Romania
260,Adrian Clifton,2,149.0,0,0,2,0,2,Montserrat
261,Adrian Elrick,0,81.0,0,0,1,0,1,New Zealand
262,Adrian Ilie,1,258.0,0,0,6,3,9,Romania
263,Adrian Knup,2,750.0,0,1,6,9,15,Switzerland
264,Adrian Kunz,0,90.0,0,0,1,0,1,Switzerland
265,Adrian Madaschi,0,56.0,0,0,2,0,2,Australia
266,Adrian Mariappa,0,166.0,1,0,2,0,2,Jamaica
267,Adrian Mierzejewski,0,130.0,0,0,0,2,2,Montenegro
268,Adrian Mutu,1,1047.0,0,5,17,7,24,Romania
269,Adrian Popa,0,95.0,0,0,1,1,2,Romania
270,Adrian Popescu,0,31.0,0,0,0,1,1,Bulgaria
271,Adrian Rus,0,45.0,1,0,1,0,1,Spain
272,Adrian Serioux,0,4.0,0,0,1,0,1,Canada
273,Adriano,14,815.0,0,0,10,7,17,Brazil
274,Adriano Leite Ribeiro,0,293.0,0,0,5,1,6,Brazil
275,Adriano Samaniego,1,73.0,0,0,0,1,1,Mexico
276,Adrien Rabiot,1,102.0,0,0,2,0,2,France
277,Adrien Silva,1,104.0,0,1,1,0,1,Portugal
278,Adrián Escudero,1,78.0,0,0,0,1,1,Turkey
279,Adrián Ramos,1,105.0,0,0,1,1,2,Paraguay
280,Adrián Romero,0,49.0,0,0,1,0,1,Uruguay
281,Ady Schmit,0,285.0,0,0,3,2,5,Luxembourg
282,Ady Williams,0,59.0,0,0,0,1,1,Denmark
283,Adékambi Olufadé,2,160.0,0,0,2,2,4,Senegal
284,Afonso Guimarães da Silva,1,30.0,0,0,1,0,1,Brazil
285,Afran Ismayilov,0,132.0,0,1,3,0,3,Azerbaijan
286,Aftandil Hacıyev,0,16.0,1,0,1,0,1,Poland
287,Agent Sawu,0,306.0,0,0,4,3,7,Zimbabwe
288,Agim Ibraimi,0,103.0,0,2,2,1,3,North Macedonia
289,Agne Simonsson,0,419.0,0,0,7,1,8,Sweden
290,Agung Setyabudi,0,7.0,0,0,1,0,1,Indonesia
291,Agustin Kola,0,138.0,1,0,1,1,2,Austria
292,Agustín Delgado,7,1106.0,0,0,15,8,23,Ecuador
293,Agustín Garcia,1,80.0,0,0,1,0,1,Mexico
294,Agustín Gaínza,0,130.0,0,0,1,1,2,Portugal
295,Agustín Lizarbe,1,81.0,0,0,1,0,1,Peru
296,Agustín Zelada,1,49.0,0,0,0,1,1,Argentina
297,Agustín Álvarez,0,47.0,0,0,1,0,1,Uruguay
298,Ahmad Abu Nahyeh,3,141.0,0,0,3,0,3,Palestine
299,Ahmad Ajab,0,254.0,0,0,6,0,6,Kuwait
300,Ahmad Al Saleh,1,90.0,0,0,1,0,1,Syria
301,Ahmad Al-Bashir,1,44.0,0,0,0,1,1,Pakistan
302,Ahmad Che Zambil,0,2.0,0,0,1,0,1,Malaysia
303,Ahmad Elrich,0,250.0,0,0,2,1,3,Australia
304,Ahmad Ersan,0,103.0,0,0,2,0,2,Jordan
305,Ahmad Hayel,0,333.0,0,0,6,1,7,Jordan
306,Ahmad Ibrahim Khalaf,0,125.0,1,0,1,1,2,Thailand
307,Ahmad Kadhim,0,228.0,0,0,3,0,3,Iraq
308,Ahmad Kallasi,1,57.0,0,0,1,0,1,Syria
309,Ahmad Khalifa Hashim,0,154.0,0,0,1,1,2,United Arab Emirates
310,Ahmad Mnajed,2,135.0,0,0,2,0,2,Iraq
311,Ahmad Nourollahi,1,120.0,0,0,1,2,3,Iran
312,Ahmad Salah Alwan,0,57.0,0,0,0,1,1,Uzbekistan
313,Ahmed Aadil,1,4.0,0,0,0,1,1,Chad
314,Ahmed Abdel Baki,0,80.0,0,0,0,1,1,Tunisia
315,Ahmed Abdul Karim Al-Brid,2,111.0,0,0,0,2,2,Pakistan
316,Ahmed Abdul Maqsoud,0,90.0,0,0,0,1,1,Maldives
317,Ahmed Abou El Fotouh,0,39.0,0,0,0,1,1,Libya
318,Ahmed Abou Rehab,1,34.0,0,0,1,0,1,Egypt
319,Ahmed Abouali,1,58.0,0,0,1,0,1,Morocco
320,Ahmed Akaïchi,2,221.0,0,0,0,4,4,Cameroon
321,Ahmed Al Hashmi,0,87.0,0,0,1,0,1,United Arab Emirates
322,Ahmed Al Masli,0,186.0,0,0,4,1,5,Libya
323,Ahmed Al Nifawi,1,10.0,0,0,1,0,1,Saudi Arabia
324,Ahmed Al-Fraidi,0,153.0,0,0,1,1,2,United Arab Emirates
325,Ahmed Al-Mousa,2,93.0,0,0,2,0,2,Saudi Arabia
326,Ahmed Al-Sarori,1,173.0,0,0,1,1,2,Philippines
327,Ahmed Al-Tash,1,64.0,0,0,0,1,1,Guinea
328,Ahmed Awad,0,77.0,0,0,1,0,1,Palestine
329,Ahmed Bahja,1,89.0,0,1,1,3,4,Gabon
330,Ahmed Bareed,1,77.0,0,0,1,0,1,Yemen
331,Ahmed Belal,1,25.0,0,0,0,1,1,Algeria
332,Ahmed Ben Soed,0,90.0,0,0,0,1,1,Ethiopia
333,Ahmed Bushara Wahba,1,128.0,0,0,1,1,2,Sudan
334,Ahmed Chombi,1,114.0,0,0,0,2,2,Kuwait
335,Ahmed Daham,1,90.0,0,0,1,0,1,Iraq
336,Ahmed Daher,0,23.0,0,0,0,1,1,Malawi
337,Ahmed Eid Abdel Malek,0,216.0,0,0,2,1,3,Egypt
338,Ahmed El-Kass,2,223.0,0,0,3,2,5,Zimbabwe
339,Ahmed Elmohamady,1,77.0,0,0,3,0,3,Egypt
340,Ahmed Faras,6,534.0,0,0,10,2,12,Morocco
341,Ahmed Faris Al-Binali,0,3.0,1,0,1,0,1,Japan
342,Ahmed Fathy,1,59.0,1,0,1,1,2,Ivory Coast
343,Ahmed H. Saeed,0,14.0,0,0,1,0,1,United Arab Emirates
344,Ahmed Hadid Al-Mukhaini,0,39.0,0,0,1,0,1,Oman
345,Ahmed Hassan,7,1070.0,0,2,11,8,19,Egypt
346,Ahmed Hassan Mahgoub,0,76.0,0,0,2,0,2,Egypt
347,Ahmed Issa Al-Mohannadi,0,52.0,0,0,1,0,1,Qatar
348,Ahmed Jamil Madani,2,227.0,0,0,1,2,3,Yemen
349,Ahmed Keshkesh,1,82.0,0,0,1,0,1,Palestine
350,Ahmed Khalil,4,1226.0,0,5,17,6,23,United Arab Emirates
351,Ahmed Limane,0,34.0,0,0,1,0,1,Morocco
352,Ahmed Makrouh,1,86.0,0,0,0,1,1,Guinea
353,Ahmed Mogni,2,147.0,0,0,0,2,2,Ghana
354,Ahmed Mohammed Al-Mahri,0,40.0,0,0,1,0,1,United Arab Emirates
355,Ahmed Mubarak Al-Mahaijri,1,392.0,0,1,6,3,9,India
356,Ahmed Musa,6,405.0,0,1,4,3,7,Mali
357,Ahmed Nashid,0,11.0,0,0,0,1,1,Bhutan
358,Ahmed Niyaz,0,87.0,0,0,1,0,1,Maldives
359,Ahmed Osman,0,74.0,0,0,1,0,1,Libya
360,Ahmed Ouattara,2,230.0,0,0,2,1,3,Ivory Coast
361,Ahmed Radhi,10,845.0,0,0,13,5,18,Jordan
362,Ahmed Rahim,0,90.0,0,0,1,0,1,Brunei
363,Ahmed Saad Osman,3,354.0,0,0,5,1,6,Libya
364,Ahmed Salah Hosny,1,30.0,0,0,1,0,1,Egypt
365,Ahmed Samir,0,127.0,0,1,1,1,2,Jordan
366,Ahmed Sidibe,0,10.0,0,0,1,0,1,Mauritania
367,Ahmed Thoriq,0,181.0,0,0,3,0,3,Maldives
368,Ahmed Touba,0,118.0,0,0,1,0,1,Algeria
369,Ahmed Waseem Razeek,2,71.0,0,1,0,2,2,Lebanon
370,Ahmed Yasin Ghani,4,300.0,0,0,3,1,4,Iraq
371,Ahmed Zuway,1,22.0,0,0,1,1,2,Togo
372,Ahmet Ataýew,1,79.0,0,1,0,1,1,Japan
373,Ahn Jung-hwan,3,461.0,0,0,5,1,6,South Korea
374,Aias Aosman,1,83.0,0,1,0,2,2,Maldives
375,Aibek Bokoev,0,76.0,0,0,1,0,1,Kyrgyzstan
376,Aidas Preikšaitis,0,88.0,0,0,1,0,1,Lithuania
377,Aiden McGeady,0,136.0,0,0,1,3,4,Republic of Ireland
378,Aidil Zafuan,0,54.0,0,0,1,0,1,Malaysia
379,Ainārs Linards,0,114.0,0,0,2,1,3,Latvia
380,Ajdin Hrustic,1,220.0,0,0,0,3,3,Kuwait
381,Akaki Khubutia,0,28.0,1,0,1,0,1,Scotland
382,Akbar Eftekhari,0,111.0,0,0,2,0,2,Iran
383,Akbar Kargarjam,0,85.0,0,0,1,0,1,Iran
384,Akhlidin Israilov,1,42.0,0,0,0,1,1,China PR
385,Akhtam Khamrakulov,0,61.0,0,0,1,0,1,Tajikistan
386,Akhtam Nazarov,0,122.0,0,2,1,1,2,Kyrgyzstan
387,Akhyar Rashid,0,144.0,0,0,2,0,2,Malaysia
388,Aki Heiskanen,0,133.0,0,0,1,2,3,Finland
389,Aki Hyryläinen,0,139.0,0,0,0,2,2,Israel
390,Aki Lahtinen,0,40.0,1,0,1,0,1,Wales
391,Aki Riihilahti,0,246.0,0,0,3,2,5,Finland
392,Akie Noah,0,58.0,0,0,1,0,1,Sierra Leone
393,Akihiro Nishimura,0,116.0,0,0,2,0,2,Japan
394,Akinori Nishizawa,5,327.0,0,0,7,1,8,Japan
395,Akira Kaji,0,28.0,0,0,1,0,1,Japan
396,Akmal Kholmatov,0,50.0,0,0,1,1,2,Tajikistan
397,Akmal Rizal Ahmad Rakhli,2,208.0,0,1,2,2,4,Hong Kong
398,Akmal Shorakhmedov,0,43.0,1,0,1,0,1,South Korea
399,Akram Afif,4,509.0,0,2,7,3,10,Qatar
400,Akram Al-Selwi,0,73.0,0,0,1,0,1,Yemen
401,Akram Emmanuel,0,47.0,0,0,0,1,1,China PR
402,Akram Moghrabi,0,52.0,0,0,1,0,1,Lebanon
403,Akram Tawfik,0,59.0,0,0,0,1,1,Angola
404,Akram Zuway,0,88.0,0,0,0,1,1,Guinea
405,Akuetteh Armah,0,35.0,0,1,1,0,1,Ghana
406,Akwá,0,807.0,0,0,11,3,14,Angola
407,Al Hasan Al-Yami,0,59.0,0,0,1,0,1,Saudi Arabia
408,Al Zerhusen,0,84.0,0,0,1,0,1,United States
409,Ala Al-Sasi,1,69.0,0,0,1,0,1,Yemen
410,Ala'a Eldin Yousif,0,45.0,0,0,1,0,1,Sudan
411,Alaa Abbas,2,180.0,0,0,1,1,2,Yemen
412,Alaa Abdul-Zahra,1,186.0,0,0,2,1,3,Iraq
413,Alaa Al Dali,1,17.0,0,0,1,1,2,Lebanon
414,Alaa El-Hamouly,0,32.0,0,0,0,1,1,Italy
415,Alaa Kadhim,8,317.0,0,0,1,7,8,Yemen
416,Alaa Mayhoub,0,7.0,0,0,1,0,1,Egypt
417,Alagame Seck,0,109.0,0,0,2,0,2,Senegal
418,Alain Boghossian,0,81.0,0,0,0,1,1,Russia
419,Alain Cervantes,1,135.0,0,0,0,2,2,Costa Rica
420,Alain Couriol,1,72.0,0,0,0,1,1,Poland
421,Alain Geiger,0,162.0,1,0,1,1,2,Switzerland
422,Alain Giresse,3,280.0,0,0,4,1,5,France
423,Alain Masudi,1,35.0,0,0,1,0,1,DR Congo
424,Alain N'Kong,0,72.0,0,0,0,1,1,Ghana
425,Alain Nana,0,73.0,0,0,1,0,1,Burkina Faso
426,Alain Nurenberg,0,37.0,0,0,1,0,1,Luxembourg
427,Alain Rakotondramanana,0,23.0,0,0,0,1,1,Benin
428,Alain Roche,0,89.0,0,0,0,1,1,Israel
429,Alain Sutter,1,53.0,0,0,1,3,4,Luxembourg
430,Alain Traoré,5,549.0,0,0,6,2,8,Burkina Faso
431,Alaixys Romao,0,21.0,1,0,0,1,1,Togo
432,Alan Ball Jr.,0,90.0,0,1,0,1,1,Wales
433,Alan Browne,0,18.0,0,0,0,1,1,Serbia
434,Alan Carvalho,1,238.0,0,0,3,0,3,China PR
435,Alan Curtis,0,138.0,0,0,1,1,2,Germany
436,Alan Durban,0,67.0,0,0,1,1,2,Scotland
437,Alan Dzagoev,2,365.0,0,0,4,4,8,Republic of Ireland
438,Alan Edward Davidson,0,33.0,0,0,1,0,1,Australia
439,Alan Gilzean,0,183.0,0,0,2,3,5,Scotland
440,Alan Kernaghan,0,25.0,0,0,1,0,1,Republic of Ireland
441,Alan Marley,0,270.0,0,0,3,0,3,New Zealand
442,Alan McDonald,1,119.0,1,0,1,2,3,Spain
443,Alan McLoughlin,0,86.0,0,0,0,2,2,Northern Ireland
444,Alan Mullery,1,31.0,0,0,1,0,1,England
445,Alan Shearer,4,679.0,0,5,15,6,21,England
446,Alan Smith,0,21.0,0,0,1,0,1,England
447,Alan Vest,1,264.0,0,0,2,2,4,New Zealand
448,Alassane Ouédraogo,1,96.0,0,0,1,1,2,Burkina Faso
449,Alban Bushi,0,333.0,0,0,4,2,6,Norway
450,Albeiro Usuriaga,0,73.0,0,0,1,0,1,Colombia
451,Albert Bell,0,90.0,0,0,1,0,1,Samoa
452,Albert Brülls,1,141.0,0,0,2,2,4,Northern Ireland
453,Albert Bwalya,0,67.0,0,0,0,1,1,Tanzania
454,Albert Cluytens,0,13.0,0,0,0,1,1,Republic of Ireland
455,Albert Emon,0,62.0,0,0,1,0,1,France
456,Albert Gemmrich,0,79.0,0,0,0,1,1,Luxembourg
457,Albert Guðmundsson,0,176.0,0,2,2,1,3,Turkey
458,Albert Luque,0,128.0,0,0,2,0,2,Spain
459,Albert Meyong,2,310.0,0,0,4,0,4,Cameroon
460,Albert Mpinganjira,0,71.0,0,0,1,0,1,Malawi
461,Albert Nađ,0,77.0,0,0,0,2,2,Malta
462,Albert Niyonkuru,0,89.0,0,1,0,1,1,Algeria
463,Albert Onyeanwuna,1,89.0,0,0,0,1,1,Egypt
464,Albert Riera,0,179.0,0,0,0,2,2,Denmark
465,Albert Rusnák,0,107.0,0,0,1,2,3,Slovakia
466,Albert Sarkisyan,0,157.0,0,2,1,2,3,Armenia
467,Alberth Elis,0,255.0,0,0,2,4,6,El Salvador
468,Alberto Acosta,1,81.0,0,0,1,0,1,Argentina
469,Alberto Aquilani,0,127.0,0,0,2,1,3,Italy
470,Alberto Bica,0,4.0,0,0,1,0,1,Uruguay
471,Alberto Blanco,0,89.0,0,0,0,1,1,Saint Lucia
472,Alberto Carvalhal,0,172.0,0,0,1,1,2,Macau
473,Alberto Doesburg,0,80.0,0,0,1,0,1,Suriname
474,Alberto Fonseca,0,118.0,0,0,1,1,2,Austria
475,Alberto Fouilloux,0,164.0,0,0,3,0,3,Chile
476,Alberto Galateo,1,48.0,0,0,1,0,1,Argentina
477,Alberto Gallardo,5,347.0,0,0,1,6,7,Argentina
478,Alberto García Aspe,5,411.0,0,5,5,5,10,El Salvador
479,Alberto Gilardino,1,601.0,0,0,8,2,10,Italy
480,Alberto Gómez,0,37.0,0,0,1,0,1,Cuba
481,Alberto Górriz,1,38.0,0,0,0,1,1,Belgium
482,Alberto Jiménez,0,94.0,0,0,2,0,2,Dominican Republic
483,Alberto Marcovecchio,0,148.0,0,0,2,0,2,Argentina
484,Alberto Medina,1,19.0,0,0,1,0,1,Mexico
485,Alberto Montaño,0,51.0,0,0,1,0,1,Ecuador
486,Alberto Montellanos,0,48.0,0,0,2,0,2,Peru
487,Alberto Ohaco,2,191.0,0,2,4,0,4,Argentina
488,Alberto Orlando,0,171.0,0,0,4,0,4,Italy
489,Alberto Quintero,2,202.0,0,0,4,0,4,Panama
490,Alberto Rendo,0,89.0,0,0,1,0,1,Argentina
491,Alberto Santelli,0,74.0,0,0,0,1,1,Venezuela
492,Alberto Spencer,0,148.0,0,0,3,1,4,Ecuador
493,Alberto Tarantini,0,43.0,0,0,1,0,1,Argentina
494,Alberto Terry,1,308.0,0,1,7,1,8,Peru
495,Alberto Valencia,1,37.0,0,0,0,1,1,Argentina
496,Alberto Zozaya,0,313.0,0,0,5,0,5,Argentina
497,Albino Rodríguez,1,75.0,0,0,1,0,1,Paraguay
498,Alcides Ghiggia,3,234.0,0,0,0,4,4,Bolivia
499,Alcides Peña,0,9.0,0,0,1,0,1,Bolivia
500,Alcides Silveira,2,65.0,0,3,0,3,3,Ecuador
501,Alcides Sosa,0,53.0,0,0,0,1,1,Venezuela
502,Aldair,2,60.0,0,0,1,1,2,United States
503,Alderman Lesmond,0,7.0,0,0,1,0,1,United States Virgin Islands
504,Aldo Donelli,4,278.0,0,0,0,5,5,Mexico
505,Aldo Junior Simoncini,0,26.0,1,0,1,0,1,Sweden
506,Aldo Serena,0,155.0,0,0,1,2,3,Italy
507,Aldo de Nigris,4,312.0,0,0,2,3,5,Mexico
508,Alejandrino Genés,4,212.0,0,0,2,3,5,Bolivia
509,Alejandro Alpízar,0,133.0,0,0,1,1,2,Costa Rica
510,Alejandro Carrillo,1,83.0,0,0,0,1,1,Chile
511,Alejandro Chumacero,0,113.0,0,0,2,0,2,Bolivia
512,Alejandro Cichero,0,50.0,1,0,2,0,2,Bolivia
513,Alejandro Guerra,0,81.0,0,0,1,0,1,Venezuela
514,Alejandro Hisis,0,49.0,0,0,2,0,2,Chile
515,Alejandro Luces,0,63.0,0,0,1,0,1,Peru
516,Alejandro Madrigal,0,48.0,0,0,0,1,1,Barbados
517,Alejandro Moreno,0,56.0,0,0,1,0,1,Venezuela
518,Alejandro Romero Gamarra,1,180.0,0,0,3,0,3,Paraguay
519,Alejandro Scopelli,1,115.0,0,0,3,0,3,Argentina
520,Alejandro Villanueva,1,61.0,0,0,1,1,2,Peru
521,Alekos Alexandris,0,54.0,0,0,0,1,1,Slovenia
522,Alekos Alexiadis,0,125.0,0,0,2,0,2,Greece
523,Aleksandar Dragović,0,30.0,0,0,1,0,1,Austria
524,Aleksandar Kolarov,1,410.0,0,1,3,5,8,Serbia
525,Aleksandar Luković,0,90.0,1,0,0,1,1,Serbia
526,Aleksandar Mitrović,3,1383.0,0,0,18,10,28,Serbia
527,Aleksandar Petaković,2,89.0,0,0,1,2,3,Yugoslavia
528,Aleksandar Prijović,0,74.0,0,0,1,0,1,Serbia
529,Aleksandar Radosavljević,0,39.0,0,0,1,0,1,Slovenia
530,Aleksandar Tirnanić,1,21.0,0,0,0,1,1,Brazil
531,Aleksandar Tonev,0,202.0,0,0,4,0,4,Bulgaria
532,Aleksandar Trajkovski,0,602.0,0,1,7,4,11,North Macedonia
533,Aleksandar Trifunović,0,79.0,0,0,0,1,1,Romania
534,Aleksandar Tunchev,0,26.0,0,0,0,1,1,Luxembourg
535,Aleksandar Vasoski,0,70.0,0,0,0,1,1,Romania
536,Aleksandar Đurić,0,213.0,0,0,6,1,7,Singapore
537,Aleksandar Šofranac,0,66.0,1,0,1,0,1,England
538,Aleksander Knavs,0,110.0,0,0,1,2,3,Georgia
539,Aleksander Rodić,0,44.0,0,0,1,0,1,Slovenia
540,Aleksandr Amisulashvili,0,13.0,0,0,1,0,1,Georgia
541,Aleksandr Borodiuk,0,89.0,0,0,0,1,1,Hungary
542,Aleksandr Golovin,0,263.0,0,0,2,1,3,Russia
543,Aleksandr Gorshkov,0,118.0,0,0,2,0,2,Ukraine
544,Aleksandr Iashvili,0,499.0,0,1,7,5,12,Georgia
545,Aleksandr Ivanov,1,56.0,0,0,0,1,1,England
546,Aleksandr Kerzhakov,1,828.0,0,0,12,9,21,Russia
547,Aleksandr Khapsalis,0,28.0,0,0,0,1,1,Finland
548,Aleksandr Kokorin,1,200.0,0,2,4,4,8,Israel
549,Aleksandr Kuchma,0,150.0,1,0,2,0,2,Kazakhstan
550,Aleksandr Merzlikin,2,38.0,0,0,1,1,2,Kyrgyzstan
551,Aleksandr Mostovoi,1,287.0,0,1,5,2,7,Russia
552,Aleksandr Panov,0,115.0,0,0,0,2,2,France
553,Aleksandr Samedov,0,124.0,0,0,2,1,3,Russia
554,Aleksandr Shadrin,0,53.0,0,0,0,1,1,Japan
555,Aleksandr Shirko,0,88.0,0,0,0,1,1,Faroe Islands
556,Aleksandr Sobolev,0,90.0,0,0,0,1,1,Malta
557,Aleksandr Yerokhin,0,97.0,0,0,2,1,3,Cyprus
558,Aleksandre Chivadze,2,63.0,0,0,2,0,2,Russia
559,Aleksandre Karapetian,0,37.0,0,0,2,1,3,Armenia
560,Aleksandrs Cauņa,0,464.0,0,2,5,4,9,Luxembourg
561,Aleksandrs Jeļisejevs,0,89.0,0,0,0,2,2,Estonia
562,Aleksei Ionov,0,94.0,0,0,1,1,2,Russia
563,Aleksei Mamykin,1,56.0,0,0,1,1,2,Turkey
564,Aleksei Miranchuk,0,94.0,0,0,1,1,2,San Marino
565,Aleksei Sutormin,0,62.0,0,0,1,0,1,Russia
566,Aleksejs Višņakovs,0,273.0,0,0,3,2,5,Latvia
567,Aleksey Dionisiev,0,21.0,0,0,1,0,1,Uzbekistan
568,Aleksey Shchotkin,0,28.0,0,0,0,2,2,Cyprus
569,Alen Bokšić,2,366.0,0,0,4,4,8,Croatia
570,Alessandro Altobelli,6,609.0,0,2,9,5,14,Italy
571,Alessandro Costacurta,0,19.0,0,0,0,1,1,Slovenia
572,Alessandro Del Piero,2,1047.0,0,3,11,6,17,Italy
573,Alessandro Della Valle,0,112.0,2,0,2,1,3,San Marino
574,Alessandro Diamanti,1,73.0,0,0,0,1,1,Uruguay
575,Alessandro Florenzi,0,97.0,0,0,2,0,2,Italy
576,Alessandro Frigerio,0,76.0,0,0,0,1,1,Yugoslavia
577,Alessandro Schöpf,1,60.0,0,0,0,1,1,Iceland
578,Alessio Romagnoli,0,149.0,0,0,1,1,2,Liechtenstein
579,"Alex ""Didí"" Valverde",0,53.0,0,0,1,0,1,Colombia
580,Alex Brosque,0,204.0,0,0,3,0,3,Australia
581,Alex Bunbury,1,458.0,0,0,9,3,12,Canada
582,Alex Chola,0,32.0,0,0,2,0,2,Zambia
583,Alex Greive,2,53.0,0,0,2,0,2,New Zealand
584,Alex Iwobi,1,172.0,0,0,2,1,3,Zambia
585,Alex Král,0,71.0,0,0,1,0,1,Czech Republic
586,Alex Moucketou-Moussounda,0,84.0,0,0,1,0,1,Gabon
587,Alex Nyarko,1,8.0,0,0,1,0,1,Ghana
588,Alex Oxlade-Chamberlain,0,249.0,0,0,2,3,5,England
589,Alex Pineda Chacón,1,100.0,0,0,2,1,3,Canada
590,Alex Roldan,1,171.0,0,0,2,0,2,El Salvador
591,Alex Sandro,0,12.0,0,0,1,0,1,Brazil
592,Alex Scott,0,70.0,0,0,1,0,1,Scotland
593,Alex Tobin,0,59.0,1,0,1,0,1,Argentina
594,Alex Valderrama,0,75.0,0,0,1,1,2,Bolivia
595,Alex Young,0,20.0,0,0,0,2,2,Republic of Ireland
596,Alexander Cruzata,0,94.0,1,0,1,1,2,Cayman Islands
597,Alexander Djiku,1,77.0,0,0,1,0,1,Ghana
598,Alexander Frei,2,997.0,0,2,13,11,24,Switzerland
599,Alexander Gerndt,0,88.0,0,0,0,1,1,Moldova
600,Alexander Geynrikh,7,803.0,0,1,11,5,16,Uzbekistan
601,Alexander Hleb,0,48.0,0,0,0,1,1,Kazakhstan
602,Alexander Horváth,0,116.0,0,0,2,0,2,Czechoslovakia
603,Alexander Isak,0,280.0,0,0,4,3,7,Sweden
604,Alexander Kačaniklić,0,107.0,0,0,1,1,2,Faroe Islands
605,Alexander Khatskevich,0,81.0,0,0,3,0,3,Belarus
606,Alexander Kobakhidze,0,71.0,0,0,0,1,1,France
607,Alexander Larín,0,36.0,0,1,1,1,2,Curaçao
608,Alexander Linwood,0,78.0,0,0,1,0,1,Scotland
609,Alexander López,1,108.0,0,1,0,3,3,Trinidad and Tobago
610,Alexander Riley,0,8.0,1,0,1,0,1,Trinidad and Tobago
611,Alexander Ring,0,8.0,0,0,1,0,1,Finland
612,Alexander Rondón,0,197.0,0,0,3,0,3,Venezuela
613,Alexander Satariano,0,20.0,0,0,0,1,1,Slovakia
614,Alexander Saununu,0,2.0,0,0,0,1,1,Singapore
615,Alexander Søderlund,0,107.0,0,1,2,0,2,Norway
616,Alexander Sørloth,0,416.0,0,0,3,4,7,Romania
617,Alexander Tettey,0,122.0,0,0,1,2,3,Croatia
618,Alexander Viveros,0,27.0,0,0,1,0,1,Colombia
619,Alexander Ødegaard,0,89.0,0,0,1,0,1,Norway
620,Alexandr Korzanov,1,4.0,0,0,1,0,1,Kyrgyzstan
621,Alexandre Alphonse,1,64.0,0,0,1,0,1,Guadeloupe
622,Alexandre Boucicaut,1,71.0,0,0,1,0,1,Haiti
623,Alexandre Czerniatynski,1,183.0,0,0,2,1,3,Belgium
624,Alexandre Martínez Palau,0,90.0,0,0,1,0,1,Andorra
625,Alexandre Pato,2,89.0,0,0,2,0,2,Brazil
626,Alexandre Rey,0,144.0,0,0,3,1,4,Wales
627,Alexandros Garpozis,0,16.0,0,0,1,0,1,Cyprus
628,Alexandros Tziolis,0,26.0,0,0,0,1,1,Cyprus
629,Alexandru Antoniuc,0,117.0,0,0,0,2,2,Montenegro
630,Alexandru Badea,0,43.0,0,0,1,0,1,Romania
631,Alexandru Chipciu,0,184.0,0,0,0,3,3,Hungary
632,Alexandru Cicâldău,0,134.0,0,0,0,2,2,Armenia
633,Alexandru Curtianu,0,22.0,0,0,2,0,2,Moldova
634,Alexandru Dedov,0,63.0,0,1,2,0,2,Moldova
635,Alexandru Ene,0,175.0,0,0,2,1,3,Romania
636,Alexandru Epureanu,0,237.0,0,0,1,2,3,Moldova
637,Alexandru Gațcan,0,154.0,0,0,0,2,2,Italy
638,Alexandru Guzun,0,6.0,0,0,1,0,1,Moldova
639,Alexandru Maxim,0,326.0,0,1,2,2,4,Romania
640,Alexandru Mitriță,0,171.0,0,0,2,1,3,Faroe Islands
641,Alexandru Neagu,2,167.0,0,0,1,2,3,Czechoslovakia
642,Alexandru Suvorov,0,384.0,0,0,2,3,5,Moldova
643,Alexei Eremenko,0,482.0,0,0,6,4,10,Romania
644,Alexei Klishin,0,73.0,0,0,0,2,2,Iraq
645,Alexei Kosolapov,0,38.0,0,0,1,0,1,Russia
646,Alexei Rios,0,47.0,0,0,0,1,1,Netherlands
647,Alexi Lalas,2,97.0,0,0,2,1,3,United States
648,Alexis Alexandris,0,235.0,0,0,1,3,4,Faroe Islands
649,Alexis Mac Allister,1,46.0,0,0,0,1,1,Poland
650,Alexis Mendoza,0,66.0,0,0,1,0,1,Colombia
651,Alexis Saddler,0,141.0,0,1,3,0,3,Saint Kitts and Nevis
652,Alexis Saelemaekers,0,65.0,0,0,1,0,1,Belgium
653,Alexis Sánchez,8,1392.0,0,0,14,16,30,Peru
654,Alexis Tumahai,1,90.0,0,0,0,1,1,New Caledonia
655,Alexis Vega,1,207.0,0,0,2,1,3,Mexico
656,Alexsandro de Souza,8,521.0,0,1,8,1,9,Brazil
657,Alf Martinsen,1,127.0,0,0,1,1,2,Norway
658,Alf Ringstead,0,3.0,0,0,1,0,1,Republic of Ireland
659,Alfa Potowabawi,0,29.0,0,0,0,1,1,Angola
660,Alfaz Ahmed,3,191.0,0,0,0,3,3,Taiwan
661,Alfonso Cañón,0,72.0,0,0,0,1,1,Chile
662,Alfonso Domínguez,2,148.0,1,0,2,2,4,Peru
663,Alfonso Pérez,3,652.0,0,0,5,5,10,Spain
664,Alfonso Rodríguez Salas,0,21.0,0,0,0,1,1,Wales
665,Alfonso Yáñez,1,35.0,0,1,0,1,1,Argentina
666,Alfred Aston,0,3.0,0,0,0,1,1,Luxembourg
667,Alfred Bickel,1,64.0,0,0,0,1,1,Germany
668,Alfred Effiong,0,85.0,0,0,2,0,2,Malta
669,Alfred Heiß,0,30.0,0,0,0,1,1,Cyprus
670,Alfred Körner,1,131.0,0,0,1,2,3,Switzerland
671,Alfred Pfaff,1,25.0,0,0,1,0,1,Germany
672,Alfred Scheiwiler,0,29.0,0,0,1,0,1,Switzerland
673,Alfred Wabealo,2,134.0,0,0,0,2,2,New Zealand
674,Alfredo Carricaberry,2,94.0,0,0,2,1,3,Argentina
675,Alfredo Di Stéfano,6,624.0,0,0,8,5,13,Argentina
676,Alfredo Esteves,1,35.0,1,0,0,1,1,Timor-Leste
677,Alfredo France,1,33.0,0,0,0,1,1,Argentina
678,Alfredo Garasini,0,72.0,0,0,1,0,1,Argentina
679,Alfredo Hernández,0,140.0,0,0,0,3,3,United States
680,Alfredo Megido,0,67.0,0,0,1,0,1,Spain
681,Alfredo Mejía,1,90.0,0,0,0,1,1,Grenada
682,Alfredo Mendoza,2,320.0,0,0,3,4,7,Paraguay
683,Alfredo Mosquera,3,120.0,0,0,1,2,3,Chile
684,Alfredo Pacheco,1,179.0,0,1,1,3,4,Costa Rica
685,Alfredo Pérez,1,81.0,0,0,0,1,1,Uruguay
686,Alfredo Quaresma,0,48.0,0,0,1,0,1,Portugal
687,Alfredo Torres,0,149.0,0,0,2,0,2,Mexico
688,Alfredo del Águila,1,29.0,0,0,0,1,1,Czechoslovakia
689,Alfredo dos Santos,0,3.0,0,0,1,0,1,Brazil
690,Alfreð Finnbogason,1,270.0,0,1,4,2,6,Iceland
691,Alhaji Kamara,2,160.0,0,0,1,1,2,Sierra Leone
692,Alhassan Kamara,0,142.0,0,0,1,1,2,Tunisia
693,Alhassane Bangoura,0,88.0,0,0,1,0,1,Guinea
694,Alhassane Issoufou,0,153.0,0,0,2,0,2,Niger
695,Ali Abo Greisha,3,260.0,0,0,6,1,7,Egypt
696,Ali Aboud Awad,0,82.0,0,0,0,1,1,Brunei
697,Ali Adnan Kadhim,4,323.0,0,2,5,0,5,Iraq
698,Ali Afif,0,53.0,0,1,0,1,1,Japan
699,Ali Al Saadi,0,93.0,0,0,3,0,3,Lebanon
700,Ali Al-Beshari,0,247.0,0,0,4,0,4,Libya
701,Ali Al-Hadyah,0,120.0,0,0,2,0,2,Kuwait
702,Ali Al-Hassan,0,52.0,0,0,1,0,1,Saudi Arabia
703,Ali Al-Nono,0,428.0,0,0,4,3,7,Brunei
704,Ali Al-Wehaibi,0,110.0,0,0,1,1,2,India
705,Ali Asel,1,61.0,0,0,0,1,1,Kyrgyzstan
706,Ali Asghar Modir Roosta,0,404.0,0,0,6,1,7,Iran
707,Ali Ashfaq,1,860.0,0,2,10,4,14,Maldives
708,Ali Assadalla,1,164.0,0,0,3,1,4,Qatar
709,Ali Bala,1,75.0,0,0,0,1,1,Egypt
710,Ali Cheikh Dib,2,148.0,0,1,1,2,3,Syria
711,Ali Daei,23,2776.0,0,8,26,23,49,Iran
712,Ali Diab,1,30.0,1,0,1,0,1,Jordan
713,Ali Djabari,0,74.0,0,0,1,0,1,Iran
714,Ali Elkhattabi,1,40.0,0,0,1,0,1,Morocco
715,Ali Elmusrati,1,68.0,0,0,1,0,1,Libya
716,Ali Faez,1,24.0,1,0,0,1,1,Iraq
717,Ali Fasir,1,25.0,0,0,0,1,1,Philippines
718,Ali Fergani,1,125.0,0,0,3,0,3,Algeria
719,Ali Gagarin,3,225.0,0,1,4,2,6,Sudan
720,Ali Gerba,6,611.0,0,0,8,4,12,Canada
721,Ali Gholizadeh,2,202.0,0,0,1,2,3,Iran
722,Ali Hamam,0,68.0,1,0,1,1,2,Lebanon
723,Ali Hosni,1,59.0,0,0,1,0,1,Iraq
724,Ali Jabbari,1,391.0,0,0,2,3,5,Iran
725,Ali Kaabi,2,191.0,0,0,1,2,3,Tunisia
726,Ali Kadhim,2,46.0,0,0,2,0,2,Iraq
727,Ali Karimi,5,659.0,0,0,8,5,13,Iran
728,Ali Khalil,0,106.0,0,0,3,0,3,Egypt
729,Ali Mabkhout,6,1530.0,0,5,23,9,32,United Arab Emirates
730,Ali Madan,0,111.0,0,0,2,0,2,Bahrain
731,Ali Maher,1,133.0,0,0,3,1,4,Cameroon
732,Ali Maqseed,1,12.0,0,0,1,0,1,Kuwait
733,Ali Marwi,6,217.0,0,0,2,4,6,Macau
734,Ali Maâloul,0,43.0,0,0,1,0,1,Tunisia
735,Ali Meçabih,2,176.0,0,0,2,2,4,Algeria
736,Ali Mohammed Al-Saadah,0,90.0,0,0,1,0,1,Qatar
737,Ali Momin,0,50.0,1,0,0,1,1,Brunei
738,Ali Mousavi,1,82.0,0,0,0,1,1,Kyrgyzstan
739,Ali Nasseredine,0,183.0,0,0,2,2,4,Lebanon
740,Ali Parvin,0,163.0,0,0,2,1,3,Iran
741,Ali Saad,1,31.0,0,0,1,0,1,Bahrain
742,Ali Salama,0,27.0,0,0,1,0,1,Libya
743,Ali Salmeen,0,32.0,0,0,1,0,1,United Arab Emirates
744,Ali Samooh,0,23.0,0,0,1,0,1,Maldives
745,Ali Sharafat,0,81.0,0,0,1,0,1,Pakistan
746,Ali Shiham,0,68.0,0,0,1,0,1,Maldives
747,Ali Sulieman,0,65.0,0,0,1,0,1,Eritrea
748,Ali Sylla,0,11.0,0,0,0,1,1,Tunisia
749,Ali Thani Jumaa,2,43.0,0,0,0,2,2,Yugoslavia
750,Ali Umar,0,200.0,0,0,3,0,3,Maldives
751,Ali Zaid,1,47.0,0,0,1,0,1,Qatar
752,Ali Zitouni,2,449.0,0,0,4,4,8,South Africa
753,Ali'i Mitchell,1,57.0,0,0,1,0,1,American Samoa
754,Aliaksandr Kulchiy,0,49.0,0,0,0,1,1,Slovenia
755,Alicio Solalinde,0,77.0,0,0,0,1,1,Ecuador
756,Alick Maemae,0,208.0,0,0,3,0,3,Solomon Islands
757,Alick Saurei,1,90.0,0,0,0,1,1,Fiji
758,Alier Ashurmamadov,2,94.0,0,0,2,1,3,Vietnam
759,Alimardon Shukurov,1,136.0,0,0,2,1,3,Kyrgyzstan
760,Alin Toșca,0,11.0,0,0,1,0,1,Romania
761,Alireza Azizi,0,90.0,0,0,2,0,2,Iran
762,Alireza Jahanbakhsh,3,423.0,0,1,6,2,8,Iran
763,Alireza Khorshidi,0,145.0,0,0,2,0,2,Iran
764,Alireza Mansourian,0,91.0,0,0,4,0,4,Iran
765,Alireza Vahedi Nikbakht,0,153.0,0,0,3,2,5,Iran
766,Alirou Rachidou,0,87.0,0,0,1,0,1,Togo
767,Alisher Dzhalilov,0,91.0,0,0,2,0,2,Tajikistan
768,Alistair Johnston,1,44.0,0,0,0,1,1,Cayman Islands
769,Alivate Driu,0,1.0,0,0,0,1,1,Papua New Guinea
770,Aljaž Struna,0,35.0,0,0,1,0,1,Slovenia
771,Alkhaly Bangoura,0,90.0,0,0,1,0,1,Guinea
772,Allan Boath,0,19.0,0,0,1,0,1,New Zealand
773,Allan Brown,0,26.0,0,0,2,0,2,Scotland
774,Allan Clarke,1,159.0,0,3,2,1,3,Czechoslovakia
775,Allan Cruz,1,75.0,0,0,1,0,1,Costa Rica
776,Allan Hansen,0,156.0,0,1,2,0,2,Denmark
777,Allan Hunter,0,32.0,0,0,1,0,1,Northern Ireland
778,Allan Johnston,0,100.0,0,0,0,2,2,Faroe Islands
779,Allan Mørkøre,0,21.0,0,0,0,1,1,Denmark
780,Allan Nielsen,2,317.0,0,0,3,4,7,Armenia
781,Allan Oviedo,0,145.0,0,0,1,1,2,Costa Rica
782,Allan Simonsen,0,433.0,0,3,6,3,9,Cyprus
783,Allan Wanga,0,77.0,0,0,1,0,1,Kenya
784,Allean Richard Grant Velasquez,0,87.0,0,0,0,1,1,Bermuda
785,Allianni Urgelles,0,90.0,0,0,1,0,1,Cuba
786,Alloysius Atuegbu,0,65.0,0,0,2,0,2,Nigeria
787,Ally Abubakari,0,54.0,0,0,0,1,1,Ghana
788,Ally McCoist,1,604.0,0,0,10,3,13,Scotland
789,Almazbek Mirzaliev,0,90.0,0,0,1,0,1,Kyrgyzstan
790,Almedin Hota,0,89.0,0,0,0,1,1,Liechtenstein
791,Almir Da Silva,0,28.0,0,0,0,1,1,Bolivia
792,Almiro Lobo,1,143.0,0,1,2,1,3,Mozambique
793,Almoez Ali,13,898.0,0,2,10,10,20,Qatar
794,Alon Hazan,0,64.0,0,0,1,0,1,Israel
795,Alon Mizrahi,0,225.0,0,0,5,1,6,San Marino
796,Alonso Botero,1,72.0,0,0,1,1,2,Bolivia
797,Alonso Solís,0,188.0,0,0,1,2,3,Guatemala
798,Aloísio,0,46.0,0,0,0,1,1,Saudi Arabia
799,Alpaslan Eratlı,0,54.0,0,0,0,1,1,Switzerland
800,Alpay Özalan,0,176.0,0,0,3,0,3,Turkey
801,Alphonse Leweck,0,232.0,0,0,1,2,3,Luxembourg
802,Alphonse Tchami,3,374.0,0,0,6,5,11,Cameroon
803,Alphonso Davies,8,455.0,0,1,2,7,9,French Guiana
804,Alphonsus Brown,0,66.0,0,0,1,0,1,Saint Vincent and the Grenadines
805,Alphose Qorig,3,163.0,0,1,0,3,3,American Samoa
806,Alsény Diaby,0,14.0,0,0,1,0,1,Guinea
807,Altin Haxhi,1,122.0,0,0,2,0,2,Albania
808,Altin Lala,0,101.0,0,0,1,1,2,Albania
809,Altin Rraklli,0,304.0,0,0,5,1,6,Albania
810,Altino Marcondes,0,9.0,0,0,1,0,1,Brazil
811,Altymyrat Annadurdyýew,2,252.0,0,0,2,2,4,Oman
812,Aluísio Francisco da Luz,0,47.0,0,0,0,1,1,Peru
813,Alvaro José Rodrigues Valente,1,10.0,0,0,1,0,1,Brazil
814,Alvin Ceccoli,0,42.0,0,0,1,0,1,Australia
815,Alvin Corneal,0,28.0,0,0,1,0,1,Trinidad and Tobago
816,Alvin Jones,0,37.0,0,0,1,0,1,Trinidad and Tobago
817,Alvin Kieh,0,85.0,0,0,1,0,1,Liberia
818,Alvin Tehau,6,265.0,0,0,3,4,7,Samoa
819,Alvin Thomas,1,89.0,0,0,1,0,1,Trinidad and Tobago
820,Alwin Hou,3,144.0,0,0,2,1,3,Cook Islands
821,Alwin Komolong,1,24.0,0,0,0,1,1,Solomon Islands
822,Alwyn Guy,0,248.0,0,0,5,1,6,Honduras
823,Alyaksandr Martynovich,0,82.0,1,0,0,1,1,Belarus
824,Alyaksandr Taykow,0,57.0,0,0,1,0,1,Belarus
825,Amad Al-Hosni,3,423.0,0,1,8,2,10,Oman
826,Amad Ali,0,94.0,0,0,0,2,2,India
827,Amadeo Ortega,2,88.0,0,0,2,0,2,Paraguay
828,Amado Guevara,5,871.0,0,4,10,5,15,Honduras
829,Amadou Haidara,1,37.0,0,0,0,1,1,Angola
830,Amadou Pathé Diallo,1,46.0,0,0,0,1,1,Ivory Coast
831,Amadou Sabo,1,68.0,0,0,0,1,1,Djibouti
832,Amadou Touré,0,107.0,0,0,0,2,2,Ethiopia
833,Amancio Amaro,1,436.0,0,0,9,0,9,Spain
834,Amani Habimana,0,78.0,0,0,1,0,1,Burundi
835,Amar Ramadan,0,45.0,0,0,0,1,1,Benin
836,Amara Simba,0,41.0,0,0,1,0,1,France
837,Amara Touré,0,115.0,0,0,1,1,2,Guinea
838,Amarildo Tavares da Silveira,3,175.0,0,0,3,0,3,Brazil
839,Amaro,1,75.0,0,0,0,1,1,Senegal
840,Ambroise Oyongo,1,84.0,0,0,0,1,1,Mali
841,Amby Fogarty,0,164.0,0,0,2,1,3,Czechoslovakia
842,Amer Deeb,0,271.0,0,0,5,0,5,Jordan
843,Amer Gojak,0,205.0,0,0,2,2,4,Bosnia and Herzegovina
844,Amer Mushraf,1,54.0,0,0,1,0,1,Iraq
845,Amido Baldé,0,62.0,0,0,0,1,1,Liberia
846,Amilcar Ramos,0,36.0,0,0,1,0,1,São Tomé and Príncipe
847,Amin Dabo,0,82.0,0,0,1,0,1,Saudi Arabia
848,Amin Younes,1,128.0,0,0,2,0,2,Germany
849,Amine Chermiti,1,1.0,0,0,0,1,1,Cameroon
850,Amir Abrashi,0,90.0,0,0,0,1,1,Andorra
851,Amir Al-Ammari,1,86.0,0,1,1,0,1,Iraq
852,Amir Kamal,1,88.0,0,0,0,1,1,Guinea
853,Amir Rrahmani,1,108.0,0,0,2,1,3,Kosovo
854,Amir Waithe,0,115.0,0,0,0,2,2,Dominica
855,Amit Ben-Shushan,1,95.0,0,0,1,1,2,Israel
856,Amjad Al-Harthi,1,75.0,0,0,0,1,1,China PR
857,Amjad Attwan,0,57.0,0,0,0,1,1,Cambodia
858,Amjad Kalaf,1,42.0,0,0,1,0,1,Iraq
859,Amleto Frignani,1,182.0,0,0,1,2,3,Egypt
860,Ammar Jemal,0,6.0,0,0,0,1,1,Kenya
861,Ammar Merrichkou,0,13.0,0,0,0,1,1,Ethiopia
862,Ammar Rihawi,1,66.0,0,0,0,1,1,Maldives
863,Ammo Yousif,0,6.0,0,0,0,1,1,Thailand
864,Amnon Aharonskind,1,70.0,0,0,1,0,1,Israel
865,Amor Jebali,0,89.0,0,0,0,1,1,Algeria
866,Amr Zaki,4,756.0,0,0,13,4,17,Libya
867,Amran Al-Hidi,0,90.0,0,0,1,0,1,Oman
868,Amredin Sharifi,1,47.0,0,0,0,1,1,Bangladesh
869,Amri Kiemba,0,28.0,0,0,1,1,2,Morocco
870,Américo Gallego,0,14.0,0,0,1,0,1,Argentina
871,Américo Galván,1,69.0,0,0,0,3,3,Chile
872,Amílcar Barbuy,1,198.0,0,1,4,0,4,Brazil
873,An Chol-Hyok,0,171.0,0,0,0,2,2,Bahrain
874,An Se-Uk,1,30.0,0,0,1,0,1,North Korea
875,An Yong-hak,0,122.0,0,0,2,0,2,North Korea
876,Anani Afanou,0,58.0,0,0,0,1,1,Senegal
877,Anas Al Khouja,0,57.0,1,0,1,0,1,Kuwait
878,Anas Al-Zboun,1,90.0,0,0,1,0,1,Jordan
879,Anas Bani Yaseen,1,26.0,0,0,0,1,1,Australia
880,Anas Elnour,0,52.0,0,0,1,0,1,Sudan
881,Anas Farah Ali,1,32.0,0,0,1,0,1,Djibouti
882,Anastasios Bakasetas,0,209.0,0,2,1,2,3,Spain
883,Anastasios Donis,0,80.0,0,0,0,1,1,Liechtenstein
884,Anastasios Douvikas,0,45.0,0,0,0,1,1,Kosovo
885,Anatoli Banişevski,0,245.0,0,0,0,5,5,Greece
886,Anatoli Ilyin,3,312.0,0,0,2,4,6,Russia
887,Anatoli Isayev,0,32.0,0,0,0,2,2,Finland
888,Anatolie Doroș,0,160.0,0,1,1,1,2,Moldova
889,Anatoliy Banishevskiy,1,354.0,0,0,4,2,6,North Korea
890,Anatoliy Byshovets,5,422.0,0,0,3,5,8,Russia
891,Anatoliy Demyanenko,1,163.0,0,0,3,1,4,Russia
892,Anatoliy Konkov,2,92.0,0,0,2,1,3,Hungary
893,Anbar Bashir Abubakr,0,82.0,0,1,1,0,1,Qatar
894,Anders Grönhagen,0,166.0,0,0,1,2,3,France
895,Anders Limpar,0,37.0,0,0,0,1,1,Israel
896,Anders Svensson,1,578.0,0,0,9,3,12,Azerbaijan
897,Andi Herzog,0,239.0,0,1,4,0,4,Austria
898,Andi Lala,0,26.0,0,0,0,1,1,Singapore
899,Andile Jali,0,169.0,0,1,1,1,2,Angola
900,Andoni Goikoetxea,0,65.0,0,0,0,1,1,Scotland
901,Andoni Goikoetxea Olaskoaga,1,68.0,0,1,0,1,1,Denmark
902,Andoni Zubizarreta,1,73.0,1,0,0,1,1,Spain
903,Andranik Eskandarian,1,43.0,1,0,0,1,1,Iran
904,Andranik Teymourian,0,271.0,0,0,2,2,4,Malaysia
905,Andraž Kirm,0,65.0,0,0,1,1,2,Slovenia
906,Andraž Struna,0,50.0,0,0,1,0,1,Slovenia
907,Andraž Šporar,0,162.0,0,0,1,2,3,Israel
908,Andre Boucaud,1,42.0,0,0,1,0,1,Trinidad and Tobago
909,Andre Espinoza,0,3.0,0,0,0,1,1,Jamaica
910,Andre Gray,0,159.0,0,0,1,1,2,Panama
911,Andre Hinds,0,166.0,0,0,2,2,4,Puerto Rico
912,Andre Kona N'Gole,1,90.0,0,0,0,1,1,Morocco
913,Andre Schembri,0,143.0,0,0,3,0,3,Malta
914,Andre Sinedo,1,79.0,0,0,0,1,1,Fiji
915,Andre Wabealo,1,11.0,0,0,0,1,1,Australia
916,Andre de Jong,1,75.0,0,0,1,0,1,New Zealand
917,Andrea Belotti,0,414.0,0,1,1,8,9,North Macedonia
918,Andrea Dossena,1,45.0,1,0,0,1,1,Italy
919,Andrea Pirlo,4,406.0,0,3,6,4,10,Italy
920,Andreas Andersson,0,120.0,0,0,1,1,2,Sweden
921,Andreas Avraam,0,134.0,0,0,1,1,2,Portugal
922,Andreas Bjelland,0,28.0,0,0,1,0,1,Denmark
923,Andreas Bonovas,0,63.0,0,0,1,0,1,Greece
924,Andreas Brehme,4,295.0,0,1,5,1,6,Germany
925,Andreas Christensen,1,176.0,0,0,1,2,3,Republic of Ireland
926,Andreas Cornelius,0,204.0,0,0,3,1,4,Czech Republic
927,Andreas Granqvist,2,408.0,0,5,4,3,7,Sweden
928,Andreas Heraf,0,55.0,0,0,0,1,1,Latvia
929,Andreas Herzog,1,934.0,0,5,13,4,17,Austria
930,Andreas Ivanschitz,0,299.0,0,1,4,2,6,Austria
931,Andreas Jakobsson,0,48.0,0,0,1,0,1,Sweden
932,Andreas Krause,0,11.0,0,0,1,0,1,German DR
933,Andreas Lava Olsen,0,82.0,0,0,0,1,1,Austria
934,Andreas Malin,0,80.0,1,0,1,0,1,Bosnia and Herzegovina
935,Andreas Möller,2,354.0,0,0,9,0,9,Germany
936,Andreas Niniadis,0,37.0,0,1,1,0,1,Greece
937,Andreas Ogris,1,241.0,0,0,3,2,5,Austria
938,Andreas Papaemmanouil,0,178.0,0,0,3,1,4,Greece
939,Andreas Ravelli,0,114.0,1,0,2,0,2,Sweden
940,Andreas Samaris,1,42.0,0,0,1,0,1,Greece
941,Andreas Skov Olsen,0,214.0,0,0,2,3,5,Austria
942,Andreas Sotiriou,0,187.0,0,0,4,2,6,Faroe Islands
943,Andreas Thom,0,615.0,0,0,5,6,11,Yugoslavia
944,Andrei Agius,0,89.0,1,0,1,1,2,Malta
945,Andrei Finonchenko,0,118.0,0,0,1,1,2,Kazakhstan
946,Andrei Fyodorov,0,219.0,0,2,3,1,4,Uzbekistan
947,Andrei Kanchelskis,0,246.0,0,0,3,2,5,Russia
948,Andrei Karpovich,0,34.0,0,0,1,0,1,Kazakhstan
949,Andrei Karyaka,0,168.0,1,0,2,3,5,Russia
950,Andrei Mostovoy,0,56.0,0,0,1,0,1,Russia
951,Andrei Piatnitski,0,14.0,0,0,0,1,1,Hungary
952,Andrei Sidorenkov,0,66.0,1,0,0,1,1,Estonia
953,Andrei Stepanov,0,27.0,0,0,1,0,1,Estonia
954,Andrei Zygmantovich,1,29.0,0,0,0,1,1,Cameroon
955,Andrej Kramarić,2,575.0,0,0,7,4,11,Croatia
956,Andrej Kvašňák,2,438.0,0,2,6,4,10,Czechoslovakia
957,Andrejs Cigaņiks,0,89.0,0,0,1,0,1,Latvia
958,Andrejs Perepļotkins,0,86.0,0,0,0,1,1,Luxembourg
959,Andrejs Prohorenkovs,0,166.0,0,0,1,2,3,Latvia
960,Andrejs Rubins,0,97.0,0,0,2,1,3,Scotland
961,Andrejs Štolcers,0,185.0,0,0,1,3,4,Norway
962,Andres Oper,0,906.0,0,0,10,7,17,Estonia
963,Andrew Hainault,0,54.0,0,0,0,1,1,Honduras
964,Andrew Lepani,3,155.0,0,0,0,4,4,American Samoa
965,Andrew Mobberley,1,35.0,0,0,1,1,2,Samoa
966,Andrew Murunga,0,53.0,0,0,0,1,1,Malawi
967,Andrew Robertson,0,91.0,0,0,1,1,2,Lithuania
968,Andrew Sinkala,0,35.0,0,0,0,1,1,Angola
969,Andrew Tembo,1,157.0,0,0,1,1,2,Zambia
970,Andrey Akopyants,1,82.0,0,0,0,1,1,Turkmenistan
971,Andrey Arshavin,2,678.0,0,0,5,8,13,Luxembourg
972,Andrey Galabinov,0,6.0,0,0,1,0,1,Bulgaria
973,Andrey Krasnov,0,92.0,0,0,1,0,1,Kyrgyzstan
974,Andrey Movsisyan,0,67.0,0,0,1,0,1,Armenia
975,Andrey Tikhonov,0,34.0,0,0,0,1,1,Luxembourg
976,Andrey Zhelyazkov,0,111.0,0,0,3,0,3,Bulgaria
977,Andrezinho,0,16.0,0,0,1,0,1,Azerbaijan
978,Andri Guðjohnsen,0,173.0,0,0,2,0,2,Iceland
979,Andri Sigthórsson,0,66.0,0,0,1,0,1,Iceland
980,Andrija Delibašić,0,373.0,0,0,4,2,6,Montenegro
981,Andrius Gedgaudas,0,90.0,0,0,1,0,1,Lithuania
982,Andrius Skerla,0,89.0,0,0,0,1,1,Faroe Islands
983,Andriy Bal,1,34.0,0,0,0,1,1,Brazil
984,Andriy Husin,0,504.0,0,0,2,5,7,Lithuania
985,Andriy Polunin,0,18.0,0,0,0,1,1,Italy
986,Andriy Rusol,1,124.0,0,0,1,2,3,Albania
987,Andriy Shevchenko,2,2073.0,0,5,20,20,40,Ukraine
988,Andriy Vorobey,0,290.0,0,0,4,0,4,Ukraine
989,Andriy Voronin,0,183.0,0,0,4,0,4,Ukraine
990,Andriy Yarmolenko,3,1126.0,0,2,13,12,25,Ukraine
991,Andronikos Kakoullis,0,89.0,0,0,0,1,1,Slovenia
992,Andros Townsend,0,150.0,0,0,2,0,2,England
993,Andrzej Buncol,1,123.0,0,0,2,0,2,Poland
994,Andrzej Iwan,0,6.0,0,0,1,0,1,Poland
995,Andrzej Jarosik,0,247.0,0,1,4,1,5,Poland
996,Andrzej Juskowiak,0,445.0,0,1,5,6,11,Poland
997,Andrzej Niedzielan,0,73.0,0,0,0,2,2,Hungary
998,Andrzej Pałasz,0,80.0,0,0,1,0,1,Poland
999,Andrzej Szarmach,7,536.0,0,0,7,6,13,Poland
1000,András Schäfer,0,105.0,0,0,0,2,2,Germany
1001,András Tóth,1,81.0,0,1,1,0,1,Hungary
1002,András Törőcsik,0,96.0,0,0,1,2,3,Hungary
1003,André Abegglen,4,262.0,0,0,0,4,4,Netherlands
1004,André Ayew,13,861.0,0,4,8,8,16,Burkina Faso
1005,André Bikey,0,11.0,0,0,0,1,1,Mauritius
1006,André Biyogo Poko,0,11.0,0,0,0,1,1,Libya
1007,André Carrillo,5,446.0,1,0,3,6,9,Chile
1008,André De Nul,0,75.0,0,0,1,0,1,Belgium
1009,André Egli,0,98.0,0,1,2,1,3,Norway
1010,André Guy,0,80.0,0,0,0,2,2,Luxembourg
1011,André Halter,0,57.0,0,0,1,0,1,Switzerland
1012,André Kalonzo,1,70.0,0,0,1,0,1,DR Congo
1013,André Kana-Biyik,3,370.0,0,0,2,5,7,Zambia
1014,André Luiz Moreira,1,3.0,0,0,1,0,1,Brazil
1015,André Maschinot,2,130.0,0,0,2,0,2,France
1016,André Mbouta,1,81.0,0,0,1,0,1,Congo
1017,André Onana,0,43.0,1,0,0,1,1,Cameroon
1018,André Ooijer,0,64.0,0,0,2,0,2,Netherlands
1019,André Piters,0,11.0,0,0,1,0,1,Belgium
1020,André Schürrle,4,967.0,0,0,4,11,15,Azerbaijan
1021,André Silva,1,558.0,0,0,3,8,11,Portugal
1022,André van Herpe,0,9.0,0,0,0,1,1,Iceland
1023,André-Frank Zambo Anguissa,2,117.0,0,0,1,2,3,Cameroon
1024,André-Pierre Gignac,0,179.0,0,0,3,1,4,Faroe Islands
1025,Andrés Andrade,0,14.0,0,0,0,1,1,Jamaica
1026,Andrés Augusto Mendoza,0,86.0,0,0,0,1,1,Ecuador
1027,Andrés Aurelio González,0,53.0,0,0,1,0,1,Peru
1028,Andrés Cabrero,0,91.0,0,0,2,0,2,Puerto Rico
1029,Andrés D'Alessandro,1,140.0,0,0,2,0,2,Argentina
1030,Andrés Escobar,0,35.0,1,0,1,0,1,United States
1031,Andrés Guardado,13,1094.0,0,4,11,9,20,United States
1032,Andrés Iniesta,2,479.0,0,1,3,5,8,Spain
1033,Andrés Martínez,1,45.0,0,0,1,0,1,Uruguay
1034,Andrés Mendoza,0,171.0,0,0,2,1,3,Peru
1035,Andrés Prieto,2,82.0,0,0,2,0,2,Chile
1036,Andrés Scotti,0,77.0,0,0,1,0,1,Uruguay
1037,Andrėjus Tereškinas,0,85.0,0,0,0,1,1,Latvia
1038,Andualem Nigussie,0,118.0,0,0,2,0,2,Ethiopia
1039,Andy Aleong,0,83.0,0,0,2,0,2,Trinidad and Tobago
1040,Andy Baptiste,0,90.0,0,0,1,0,1,Saint Lucia
1041,Andy Carroll,1,23.0,0,0,0,1,1,Sweden
1042,Andy Cole,0,90.0,0,0,0,1,1,Albania
1043,Andy Egli,0,75.0,0,0,1,1,2,Switzerland
1044,Andy Furtado,0,107.0,0,0,2,0,2,Costa Rica
1045,Andy Gray,0,103.0,0,0,1,1,2,Austria
1046,Andy Herron,3,216.0,0,0,4,1,5,Costa Rica
1047,Andy Jones,0,86.0,0,0,1,0,1,Wales
1048,Andy Keogh,0,90.0,0,0,1,0,1,Republic of Ireland
1049,Andy McEvoy,0,122.0,0,0,1,2,3,Spain
1050,Andy Melville,0,181.0,1,0,1,3,4,Wales
1051,Andy Najar,2,131.0,0,0,2,0,2,Honduras
1052,Andy Reid,0,45.0,0,0,2,0,2,Republic of Ireland
1053,Andy Selva,0,380.0,0,1,6,1,7,San Marino
1054,Andy Sophie,0,134.0,0,1,1,1,2,Cape Verde
1055,Andy Townsend,0,143.0,0,0,1,3,4,Poland
1056,Andy Williams,3,381.0,0,3,2,6,8,Costa Rica
1057,Anel Ahmedhodžić,0,77.0,0,0,0,1,1,Ukraine
1058,Anfilogino Guarisi,0,40.0,0,0,1,0,1,Italy
1059,Anfilogino Marques,1,16.0,0,0,1,0,1,Brazil
1060,Angel Chiessa,1,10.0,0,0,1,0,1,Argentina
1061,Angel Mussenden,0,35.0,1,0,1,0,1,Saint Vincent and the Grenadines
1062,Angel Perucca,2,176.0,0,0,2,0,2,Argentina
1063,Angel Rambert,0,17.0,0,0,1,0,1,France
1064,Angelo Cijntje,0,90.0,0,0,1,0,1,Curaçao
1065,Angelo Costanzo,1,83.0,0,0,1,0,1,Australia
1066,Angelo Domenghini,1,358.0,0,0,6,1,7,Cyprus
1067,Angelo Martina,1,11.0,0,0,1,0,1,Curaçao
1068,Angelo Schiavio,0,206.0,0,0,4,0,4,Italy
1069,Angelo Sormani,0,86.0,0,0,0,1,1,Turkey
1070,Angelo Zimmerman,1,199.0,1,0,2,1,3,Curaçao
1071,Angelos Basinas,0,262.0,0,4,2,3,5,Portugal
1072,Angelos Charisteas,3,893.0,0,2,12,8,20,Greece
1073,Angelos Tsolakis,0,89.0,0,0,0,1,1,Hungary
1074,Anghel Iordănescu,0,349.0,0,2,4,3,7,Finland
1075,Angus Eve,1,722.0,0,0,9,3,12,Dominican Republic
1076,Ani Gome,1,7.0,0,0,0,1,1,Egypt
1077,Anice Badri,0,78.0,0,0,0,1,1,DR Congo
1078,Anicet Abel,1,86.0,0,0,1,1,2,Madagascar
1079,Anicet Adjamossi,1,147.0,1,0,1,1,2,Madagascar
1080,Anicet Yala Ngoukou,0,56.0,0,0,1,0,1,Gabon
1081,Anil Gurung,0,19.0,0,2,2,0,2,Nepal
1082,Anirudh Thapa,1,68.0,0,0,0,1,1,Thailand
1083,Anis Ben Slimane,0,90.0,0,0,0,1,1,Zambia
1084,Anjan Bista,1,69.0,0,1,1,2,3,Taiwan
1085,Anjas Asmara,1,71.0,0,0,0,2,2,Iraq
1086,Anon Nanok,0,30.0,0,0,1,0,1,Thailand
1087,Ansi Agolli,0,78.0,0,0,1,0,1,Albania
1088,Ansyari Lubis,0,58.0,0,0,2,0,2,Indonesia
1089,Antal Dunai,0,110.0,0,0,2,3,5,Hungary
1090,Antal Nagy,0,50.0,0,0,1,0,1,Hungary
1091,Antal Róth,0,49.0,0,0,0,1,1,Cyprus
1092,Antar Yahia,1,163.0,0,0,4,0,4,Algeria
1093,Ante Juric,1,36.0,0,0,1,0,1,Australia
1094,Ante Milicic,1,28.0,0,0,2,1,3,Australia
1095,Ante Razov,0,209.0,0,0,2,2,4,Guatemala
1096,Ante Rebić,1,66.0,0,0,0,2,2,Argentina
1097,Ante Žanetić,0,55.0,0,0,0,1,1,France
1098,Anteneh Alameraw,0,48.0,0,0,1,0,1,Ethiopia
1099,Anthonie van der Linden,0,11.0,0,0,1,0,1,Netherlands
1100,Anthony Abrams,0,73.0,0,0,0,1,1,Barbados
1101,Anthony Annan,0,83.0,0,0,1,0,1,Ghana
1102,Anthony Augustine,0,72.0,0,0,1,0,1,Grenada
1103,Anthony Contreras,0,89.0,0,0,1,1,2,El Salvador
1104,Anthony Dominique,0,8.0,0,0,1,0,1,Dominica
1105,Anthony Hernandez,1,30.0,0,0,1,0,1,Gibraltar
1106,Anthony Laffor,0,50.0,0,0,1,0,1,Liberia
1107,Anthony Lozano,0,147.0,0,0,1,2,3,El Salvador
1108,Anthony Martial,0,50.0,0,0,0,1,1,Ukraine
1109,Anthony Modeste,0,233.0,0,0,1,2,3,Barbados
1110,Anthony Rougier,0,21.0,0,0,2,0,2,Trinidad and Tobago
1111,Anthony Réveillère,0,66.0,0,0,1,0,1,France
1112,Anthony Straker,0,33.0,0,1,1,0,1,Grenada
1113,Anthony Yeboah,1,29.0,0,0,1,0,1,Ghana
1114,Anthony van den Hurk,0,17.0,0,0,1,0,1,Curaçao
1115,Antoine Griezmann,4,1142.0,0,6,18,6,24,France
1116,Antoine Kohn,0,6.0,0,0,1,0,1,Luxembourg
1117,Antoine Mocude,0,64.0,0,0,1,0,1,Mauritius
1118,Antolín Alcaraz,2,71.0,0,0,1,1,2,Italy
1119,Anton Allemann,0,124.0,0,0,2,0,2,Switzerland
1120,Anton Camilleri,0,20.0,0,0,1,0,1,Malta
1121,Anton Doboş,0,35.0,0,0,0,1,1,Liechtenstein
1122,Anton Haven,0,28.0,0,0,1,1,2,Anguilla
1123,Anton Jongsma,0,15.0,0,0,0,1,1,Nicaragua
1124,Anton Miranchuk,0,41.0,0,0,1,0,1,Russia
1125,Anton Moravčík,0,23.0,0,0,0,1,1,German DR
1126,Anton Ondruš,2,99.0,1,0,1,2,3,Portugal
1127,Anton Polster,0,138.0,0,0,2,0,2,Austria
1128,Anton Putsila,0,145.0,0,0,1,1,2,Belarus
1129,Anton Rogan,0,30.0,1,0,1,0,1,Spain
1130,Anton Saroka,0,44.0,0,0,0,1,1,France
1131,Anton Schall,1,93.0,0,0,1,0,1,Austria
1132,Anton Silva,1,14.0,0,0,1,0,1,Sri Lanka
1133,Anton Weibel,0,77.0,1,0,0,1,1,Switzerland
1134,Anton Zabolotny,0,82.0,0,0,1,0,1,Russia
1135,Anton Zemlianukhin,0,188.0,0,1,2,2,4,Bangladesh
1136,Anton Žlogar,0,83.0,0,0,1,0,1,Slovenia
1137,Antonee Robinson,0,100.0,0,0,1,1,2,Honduras
1138,Antonhy Stanton,0,43.0,0,0,1,0,1,Guyana
1139,Antoni Lima Solá,0,80.0,0,0,0,1,1,Bulgaria
1140,Antonio Alzamendi,3,271.0,0,0,1,4,5,Uruguay
1141,Antonio Angelillo,0,69.0,0,0,1,0,1,Italy
1142,Antonio Blanco,1,80.0,0,0,1,0,1,Argentina
1143,Antonio Cabrini,1,189.0,0,1,3,0,3,Italy
1144,Antonio Campolo,1,48.0,0,0,0,1,1,Brazil
1145,Antonio Candreva,0,183.0,0,2,1,4,5,Italy
1146,Antonio Cassano,3,373.0,0,0,7,2,9,Italy
1147,Antonio Cerroti,0,41.0,0,0,1,0,1,Argentina
1148,Antonio Conte,1,122.0,0,0,0,2,2,Denmark
1149,Antonio Di Natale,2,358.0,0,0,0,6,6,Ukraine
1150,Antonio Flores,0,78.0,0,0,2,0,2,Mexico
1151,Antonio González,1,11.0,0,0,0,1,1,Venezuela
1152,Antonio Gómez,0,89.0,0,0,0,1,1,Uruguay
1153,Antonio López Guerrero,0,1.0,0,0,0,1,1,San Marino
1154,Antonio Maceda,2,319.0,0,0,2,4,6,Republic of Ireland
1155,Antonio Martina,1,90.0,0,0,1,0,1,Curaçao
1156,Antonio Muñoz Gómez,0,18.0,0,0,0,1,1,Albania
1157,Antonio Pacheco D'Agosti,1,90.0,0,0,0,1,1,United Arab Emirates
1158,Antonio Rada,1,226.0,0,1,3,0,3,Colombia
1159,Antonio Ravelo,2,173.0,0,0,1,1,2,Bolivia
1160,Antonio Rüdiger,0,88.0,0,0,1,1,2,Germany
1161,Antonio Sacco,0,123.0,0,0,0,2,2,Peru
1162,Antonio Sanabria,0,130.0,0,0,1,1,2,Colombia
1163,Antonio Sardina,0,17.0,0,0,0,1,1,Gabon
1164,Antonio Sastre,1,53.0,0,0,1,0,1,Argentina
1165,Antonio Urdinarán,2,45.0,0,2,0,2,2,Brazil
1166,Antonio Valencia,2,353.0,0,0,6,2,8,Ecuador
1167,Antonio Valentín Angelillo,8,289.0,0,0,8,0,8,Argentina
1168,Antonio Zelaya,0,86.0,0,0,1,0,1,Honduras
1169,Antonio de Miguel,2,126.0,0,0,2,0,2,Argentina
1170,Antonio de Nigris,0,33.0,0,0,2,0,2,Mexico
1171,Antonio dos Santos,0,1.0,0,0,1,0,1,Cuba
1172,Antonis Antoniadis,0,139.0,0,1,2,2,4,Spain
1173,Antonis Migiakis,1,73.0,0,0,0,1,1,Israel
1174,Antony,0,176.0,0,0,1,1,2,Venezuela
1175,Antony de Ávila,4,363.0,0,0,4,3,7,Venezuela
1176,Antonín Barák,1,168.0,0,0,1,4,5,San Marino
1177,Antonín Panenka,3,449.0,0,5,9,2,11,Czechoslovakia
1178,Antonín Puč,1,121.0,0,0,1,1,2,Czechoslovakia
1179,Antti Sumiala,0,429.0,0,1,4,3,7,Finland
1180,Antwan Russell,0,52.0,0,0,1,0,1,Bermuda
1181,António Dias Teixeira,0,81.0,0,0,1,0,1,Portugal
1182,António Folha,0,148.0,0,0,1,1,2,Estonia
1183,António Luís Alves Ribeiro Oliveira,0,175.0,0,0,1,1,2,Finland
1184,António Mendonça,0,84.0,0,0,1,0,1,Angola
1185,António Neto,0,44.0,0,0,0,1,1,Zimbabwe
1186,António Nogueira,0,1.0,0,0,1,0,1,Portugal
1187,António Simões,1,104.0,0,0,1,1,2,Brazil
1188,António Sousa,1,52.0,0,0,1,0,1,Portugal
1189,Antônio Almeida,1,72.0,0,0,1,0,1,Brazil
1190,Antônio Carlos Zago,0,77.0,0,0,1,1,2,Brazil
1191,Anvarjon Soliev,0,306.0,0,0,4,0,4,Uzbekistan
1192,Anwar Ahmed,0,8.0,0,0,0,1,1,Brunei
1193,Anwar Jackaria,0,17.0,0,0,0,1,1,Kenya
1194,Anwar Shakunda,1,86.0,0,0,1,0,1,Somalia
1195,Anzur Ismailov,0,117.0,0,0,2,1,3,Uzbekistan
1196,Aníbal Ciocca,3,184.0,0,0,2,3,5,Chile
1197,Aníbal Godoy,1,225.0,1,0,3,1,4,Costa Rica
1198,Aníbal Médicis Candiota,1,46.0,0,0,1,0,1,Brazil
1199,Aníbal Tarabini,0,43.0,0,0,0,1,1,Bolivia
1200,Ao Tanaka,1,59.0,0,0,2,0,2,Japan
1201,Aples Tecuari,0,73.0,0,0,1,0,1,Indonesia
1202,Apostolos Giannou,1,90.0,0,0,0,1,1,Palestine
1203,Ara Hakobyan,0,177.0,0,0,1,2,3,Armenia
1204,Aram Ayrapetyan,0,80.0,1,0,0,1,1,Armenia
1205,Aram Hakobyan,0,52.0,0,0,0,1,1,Andorra
1206,Aras Özbiliz,0,139.0,0,0,2,1,3,Denmark
1207,Arash Afshin,1,67.0,0,0,0,1,1,United Arab Emirates
1208,Arash Borhani,0,147.0,0,0,1,1,2,Qatar
1209,Araz Abdullayev,0,24.0,0,0,1,0,1,Azerbaijan
1210,Arben Minga,0,86.0,0,0,1,0,1,Albania
1211,Arbër Zeneli,0,61.0,0,0,1,0,1,Kosovo
1212,Arcadia Martin Wesay Toe,0,54.0,0,0,0,1,1,Mali
1213,Archie Gemmill,2,417.0,0,3,4,2,6,Scotland
1214,Archie Robertson,0,29.0,0,0,1,0,1,Scotland
1215,Archie Thompson,1,1180.0,0,0,18,3,21,Australia
1216,Archil Arveladze,0,205.0,0,0,2,1,3,Georgia
1217,Arda Turan,1,697.0,0,0,8,3,11,Switzerland
1218,Ardian Kozniku,0,81.0,0,0,1,0,1,Croatia
1219,Aref Al Agha,2,74.0,0,0,0,2,2,Maldives
1220,Aref Al-Shewaier,1,73.0,0,0,0,1,1,Yemen
1221,Arfon Griffiths,0,234.0,0,0,3,1,4,Austria
1222,Argenis Tortolero,0,40.0,0,0,1,0,1,Venezuela
1223,Argjend Beqiri,0,75.0,0,0,1,0,1,North Macedonia
1224,Argo Arbeiter,0,90.0,0,0,0,1,1,Czech Republic
1225,Ari Hjelm,0,284.0,0,0,4,3,7,Turkey
1226,Ari Mäkynen,0,82.0,0,1,1,0,1,Finland
1227,Ari Valvee,0,209.0,0,0,2,1,3,Austria
1228,Ariagner Smith,2,53.0,0,0,0,2,2,Turks and Caicos Islands
1229,Arie Haan,2,120.0,0,0,1,2,3,Netherlands
1230,Ariel Francisco Rodríguez,1,4.0,0,0,1,0,1,Costa Rica
1231,Ariel Graziani,3,526.0,0,0,3,7,10,Ecuador
1232,Ariel Lassiter,1,21.0,0,0,1,0,1,Costa Rica
1233,Ariel Martínez,3,183.0,0,0,3,0,3,Cuba
1234,Ariel Ortega,3,338.0,0,0,5,5,10,Japan
1235,Ariel Álvarez,0,56.0,0,0,1,0,1,Cuba
1236,Arif Erdem,0,513.0,0,0,4,5,9,San Marino
1237,Arif Kocabıyık,0,86.0,0,0,1,0,1,Turkey
1238,Arif Mirzoyev,0,80.0,0,0,1,0,1,Turkmenistan
1239,Arijan Ademi,0,284.0,0,0,1,3,4,Slovakia
1240,Aristide Bancé,4,554.0,0,1,6,3,9,Burundi
1241,Aritatsu Ogi,1,68.0,1,0,0,1,1,Japan
1242,Aritz Aduriz,0,85.0,0,0,1,0,1,Spain
1243,Ariza Makukula,0,84.0,0,0,0,1,1,Kazakhstan
1244,Arj Changatamilman,0,31.0,0,0,1,0,1,Singapore
1245,Arjan Bellaj,0,25.0,0,0,0,1,1,Moldova
1246,Arjan Beqaj,0,42.0,1,0,1,0,1,Netherlands
1247,Arjen Robben,8,1010.0,0,1,12,10,22,Netherlands
1248,Arkadiusz Głowacki,0,57.0,1,0,0,1,1,Poland
1249,Arkadiusz Milik,1,594.0,0,0,8,2,10,Poland
1250,Arlindo Gomes Semedo,0,237.0,0,0,5,0,5,Cape Verde
1251,Arman Karamyan,0,27.0,0,0,0,1,1,Northern Ireland
1252,Armand Djerabe,0,47.0,0,0,1,0,1,Chad
1253,Armand Jurion,0,82.0,0,1,1,1,2,Yugoslavia
1254,Armand Muller,0,3.0,0,0,1,0,1,Luxembourg
1255,Armand Penverne,0,40.0,0,0,0,1,1,Republic of Ireland
1256,Armando Alonso,0,167.0,0,0,1,2,3,Grenada
1257,Armando Broja,0,228.0,0,0,2,1,3,Albania
1258,Armando Contreras,0,44.0,0,0,1,1,2,Chile
1259,Armando Cooper,1,103.0,0,0,2,1,3,Jamaica
1260,Armando Cruz,0,79.0,0,1,0,1,1,Haiti
1261,Armando Macamo,0,25.0,0,0,1,0,1,Mozambique
1262,Armando Sadiku,1,251.0,0,0,2,5,7,Albania
1263,Armando Tapia,1,77.0,0,0,1,0,1,Bolivia
1264,Armando Tobar,1,77.0,0,0,1,0,1,Chile
1265,Armands Zeiberliņš,0,230.0,0,0,2,1,3,Northern Ireland
1266,Armel Disney,0,222.0,0,0,4,0,4,Congo
1267,Armen Shahgeldyan,0,313.0,0,1,2,3,5,Armenia
1268,Armend Dallku,0,90.0,0,0,1,0,1,Albania
1269,Armin Hodžić,0,209.0,0,0,1,2,3,Bosnia and Herzegovina
1270,Armin Krings,0,28.0,0,0,0,1,1,Republic of Ireland
1271,Arminas Narbekovas,0,96.0,0,0,1,1,2,Northern Ireland
1272,Arnaldo Owanga,0,50.0,0,0,1,0,1,Mozambique
1273,Arnar Gunnlaugsson,0,3.0,0,0,0,1,1,Sweden
1274,Arnar Viðarsson,0,6.0,0,0,1,0,1,Iceland
1275,Arnaut Danjuma,0,75.0,0,0,1,0,1,Netherlands
1276,Arnbjørn Hansen,0,150.0,0,0,3,0,3,Faroe Islands
1277,Arne Brustad,1,83.0,0,0,0,1,1,Italy
1278,Arne Friedrich,1,169.0,2,0,1,2,3,Germany
1279,Arne Larsen Økland,0,205.0,0,0,1,3,4,Belgium
1280,Arne Nyberg,3,123.0,0,0,0,3,3,Cuba
1281,Arne Pedersen,0,16.0,0,0,1,0,1,Norway
1282,Arne Selmosson,0,26.0,0,0,1,0,1,Sweden
1283,Arno Bertogna,1,90.0,0,0,1,0,1,Australia
1284,Arnold Bouka Moutou,0,87.0,0,0,0,1,1,Egypt
1285,Arnold Cruz,0,19.0,0,0,1,0,1,Honduras
1286,Arnold Dwarika,2,491.0,0,2,6,3,9,United States
1287,Arnold Mühren,0,151.0,0,1,3,0,3,Netherlands
1288,Arnold Wetl,0,226.0,1,0,2,1,3,Austria
1289,Arnoldo Iguarán,8,701.0,0,0,8,6,14,Colombia
1290,Arnulfo Valentierra,0,67.0,0,0,0,1,1,Uruguay
1291,Arnór Guðjohnsen,0,317.0,0,0,5,1,6,Iceland
1292,Arnór Ingvi Traustason,1,90.0,0,0,1,0,1,Iceland
1293,Arnór Sigurðsson,0,38.0,0,0,1,0,1,Iceland
1294,Aron Gunnarsson,0,137.0,0,0,1,1,2,Latvia
1295,Aron Jóhannsson,0,122.0,0,0,1,1,2,Panama
1296,Aron Winter,1,270.0,0,0,2,2,4,Malta
1297,Arouna Koné,0,43.0,0,0,0,1,1,Egypt
1298,Arsen Avakov,0,131.0,0,0,3,1,4,Vietnam
1299,Arsenio Luzardo,0,68.0,0,0,1,0,1,Uruguay
1300,Arshad Al-Alawi,0,90.0,0,0,2,0,2,Oman
1301,Arslanmyrat Amanow,1,414.0,0,0,2,5,7,Indonesia
1302,Art Hughes,0,135.0,0,0,2,0,2,Canada
1303,Art Welch,0,70.0,0,0,1,0,1,Jamaica
1304,Artak Grigoryan,0,50.0,0,0,1,0,1,Armenia
1305,Artem Besyedin,0,165.0,0,0,0,2,2,Finland
1306,Artem Dovbyk,1,289.0,0,0,0,3,3,Sweden
1307,Artem Dzyuba,0,1377.0,0,4,14,10,24,Russia
1308,Artem Fedetskiy,0,158.0,0,0,1,1,2,Montenegro
1309,Artem Kontsevoy,0,87.0,0,0,0,1,1,Wales
1310,Artem Kravets,1,226.0,0,0,4,2,6,Ukraine
1311,Artem Milevskyi,0,135.0,0,1,2,0,2,Ukraine
1312,Arthur Fitzsimons,0,97.0,0,0,2,0,2,Republic of Ireland
1313,Arthur Friedenreich,2,308.0,0,0,6,1,7,Brazil
1314,Arthur Melo,0,33.0,0,0,0,1,1,Uruguay
1315,Arthur Minasyan,0,39.0,0,0,1,0,1,Armenia
1316,Arthur Moses,0,89.0,0,0,1,0,1,Ghana
1317,Artim Šakiri,0,352.0,0,1,6,3,9,North Macedonia
1318,Artiom Rudņev,0,83.0,0,0,1,0,1,Latvia
1319,Arto Tolsa,0,128.0,0,0,2,1,3,Yugoslavia
1320,Artur Correia,0,37.0,0,0,1,0,1,Portugal
1321,Artur Geworkýan,0,156.0,0,0,3,0,3,Turkmenistan
1322,Artur Ioniță,0,73.0,0,0,0,1,1,Montenegro
1323,Artur Jorge,0,46.0,0,0,1,0,1,Portugal
1324,Artur Petrosyan,0,454.0,0,0,5,4,9,Denmark
1325,Artur Sarkisov,0,250.0,0,0,1,2,3,Slovakia
1326,Artur Wichniarek,0,45.0,0,0,0,1,1,Luxembourg
1327,Arturo Arrieta,1,49.0,0,0,1,0,1,Argentina
1328,Arturo Carmona,2,78.0,0,0,1,1,2,Argentina
1329,Arturo Mendoza,1,52.0,0,0,0,1,1,Argentina
1330,Arturo Mina,1,128.0,1,0,2,0,2,Ecuador
1331,Arturo Norambuena,0,70.0,0,0,1,0,1,Chile
1332,Arturo Tardío,1,84.0,0,0,1,0,1,Bolivia
1333,Arturo Vidal,5,1299.0,1,6,15,10,25,Chile
1334,Arturo Vázquez Ayala,1,45.0,0,1,1,0,1,Mexico
1335,Arturo Álvarez,1,146.0,0,0,2,0,2,El Salvador
1336,Artyom Filiposyan,0,44.0,1,0,0,1,1,Uzbekistan
1337,Artýom Nazarow,0,70.0,0,0,0,1,1,Sri Lanka
1338,Artūras Fomenka,0,169.0,0,0,2,0,2,Lithuania
1339,Artūrs Zjuzins,0,182.0,0,0,2,1,3,Latvia
1340,Aruna Dindane,3,475.0,0,1,6,4,10,Ivory Coast
1341,Arvydas Novikovas,0,434.0,0,3,3,3,6,San Marino
1342,Ary Papel,0,56.0,0,0,1,0,1,Angola
1343,Arístides Rojas,0,165.0,0,0,2,1,3,Uruguay
1344,Arístides del Puerto,1,74.0,0,0,2,0,2,Paraguay
1345,Arūnas Šuika,0,124.0,0,0,3,0,3,Lithuania
1346,Asa Hartford,0,35.0,0,0,1,0,1,Scotland
1347,Asadhulla Abdulla,0,37.0,0,0,1,0,1,Maldives
1348,Asam Duraiban,1,16.0,0,0,1,0,1,Yemen
1349,Asamoah Gyan,12,1198.0,0,4,10,14,24,Ghana
1350,Aschalew Tamene,0,90.0,0,1,1,0,1,Ethiopia
1351,Asher Welch,0,11.0,0,0,1,0,1,Jamaica
1352,Ashish Bhadra,0,15.0,0,0,0,1,1,India
1353,Ashkan Dejagah,2,211.0,0,3,6,0,6,Iran
1354,Ashley Grimes,0,2.0,0,0,1,0,1,Republic of Ireland
1355,Ashley Rambanapasi,0,78.0,0,0,1,0,1,Zimbabwe
1356,Ashley Williams,1,79.0,1,0,1,1,2,Wales
1357,Ashley Young,0,136.0,0,0,2,2,4,England
1358,Ashraf Luthfy,0,82.0,0,0,1,0,1,Maldives
1359,Ashraf Uddin Ahmed Chunnu,1,213.0,0,0,2,1,3,North Korea
1360,Asier Illarramendi,0,76.0,0,0,0,1,1,Israel
1361,Asier del Horno,0,75.0,0,0,1,0,1,Spain
1362,Asimakis Krassas,0,95.0,0,0,0,1,1,Faroe Islands
1363,Askhat Kadyrkulov,1,82.0,0,0,0,1,1,Nepal
1364,Asmeron Germa,0,180.0,0,0,2,0,2,Ethiopia
1365,Asnake Tenkir,0,50.0,0,0,1,0,1,Ethiopia
1366,Asparuh Nikodimov,1,12.0,0,0,1,0,1,Bulgaria
1367,Assad Ghani,0,65.0,0,0,1,0,1,Maldives
1368,Assan Ceesay,0,65.0,0,0,0,1,1,Angola
1369,Assan Sarr,0,90.0,0,0,0,1,1,Libya
1370,Assani Bajope,0,17.0,0,0,1,0,1,Uganda
1371,Astrit Ziu,0,22.0,0,0,0,1,1,Turkey
1372,Asuquo Ekpe,1,78.0,0,0,0,1,1,Egypt
1373,Atanas Iliev,0,39.0,0,0,0,1,1,Italy
1374,Atanas Mihaylov,0,84.0,0,0,1,1,2,Bulgaria
1375,Atdhe Nuhiu,1,102.0,0,0,1,1,2,Kosovo
1376,Athanas Tendeng,1,50.0,0,0,1,0,1,Senegal
1377,Athuman Iddy,0,5.0,0,0,1,0,1,Tanzania
1378,Ati Kepo,2,133.0,0,0,0,2,2,Fiji
1379,Atiba Harris,0,87.0,0,0,1,1,2,Saint Kitts and Nevis
1380,Atiba Hutchinson,1,370.0,1,0,4,2,6,Honduras
1381,Atik Ismail,0,202.0,0,0,4,0,4,Finland
1382,Atilio Ancheta,0,76.0,0,0,1,0,1,Uruguay
1383,Atilio Cremaschi,8,453.0,0,0,6,2,8,Chile
1384,Atilio García,5,255.0,0,0,0,5,5,Ecuador
1385,Atilio López,4,103.0,0,0,2,2,4,Paraguay
1386,Atkin Kaua,1,32.0,0,0,1,1,2,Solomon Islands
1387,Atli Eðvaldsson,1,441.0,0,0,5,2,7,Iceland
1388,Atnesh Prasad,2,170.0,0,0,0,2,2,Samoa
1389,Ats Purje,0,167.0,0,0,1,1,2,Slovenia
1390,Atsuhiro Miura,1,77.0,0,0,0,1,1,Peru
1391,Atsushi Yanagisawa,3,105.0,0,0,1,2,3,Saudi Arabia
1392,Atsuto Uchida,1,140.0,1,0,2,0,2,Japan
1393,Attila Abonyi,2,235.0,0,1,4,2,6,Australia
1394,Attila Fiola,0,90.0,0,0,1,1,2,Andorra
1395,Attila Korsós,0,117.0,0,0,2,0,2,Hungary
1396,Attila Pinte,0,80.0,0,0,0,1,1,North Macedonia
1397,Attila Pintér,0,120.0,0,0,2,0,2,Hungary
1398,Attilio Lombardo,0,56.0,0,0,0,2,2,Cyprus
1399,Atusaye Nyondo,0,70.0,0,0,0,1,1,Djibouti
1400,Au Chi Yin,0,78.0,0,0,2,0,2,Hong Kong
1401,Au Wai Lun,1,166.0,0,0,2,1,3,Hong Kong
1402,Au-yeong Pak Kuan,0,90.0,0,0,1,0,1,Singapore
1403,Audel Laville,1,82.0,0,0,1,0,1,Dominica
1404,Audrius Kšanavičius,0,142.0,0,0,0,2,2,Georgia
1405,Audrius Žuta,0,87.0,0,0,0,1,1,Slovenia
1406,August Foe a Man,0,45.0,0,0,1,0,1,Suriname
1407,August Starek,0,177.0,0,0,0,4,4,Scotland
1408,Augustine Ahinful,0,109.0,0,0,2,0,2,Ghana
1409,Augustine Ofuokwu,0,90.0,0,0,0,1,1,Cameroon
1410,Augustine Peli,0,146.0,0,0,0,2,2,Tonga
1411,Augusto Espinoza,0,151.0,0,0,2,1,3,Guatemala
1412,Augusto da Costa,0,15.0,0,0,1,0,1,Brazil
1413,Aung Khin,1,80.0,0,0,1,0,1,Myanmar
1414,Aung Thu,1,171.0,0,0,2,1,3,Myanmar
1415,Aurel Ţicleanu,0,67.0,0,0,1,0,1,Romania
1416,Aurelien Bekogo,1,34.0,0,0,0,1,1,DR Congo
1417,Aurelijus Skarbalius,0,61.0,0,0,0,1,1,Ukraine
1418,Aurelio Domínguez,0,60.0,0,0,1,0,1,Chile
1419,Aurelio González,6,410.0,0,0,6,1,7,Paraguay
1420,Aurelio Martínez,0,57.0,0,0,0,1,1,Colombia
1421,Aurelio Vidmar,0,373.0,0,1,9,1,10,Australia
1422,Aurélien Chedjou,1,104.0,1,0,1,1,2,Cameroon
1423,Aurélien Joachim,0,454.0,0,1,3,4,7,Luxembourg
1424,Aurélien Tchouaméni,1,17.0,0,0,0,1,1,England
1425,Ausberto García,1,334.0,0,0,6,0,6,Bolivia
1426,Austin Berry,1,22.0,0,1,2,1,3,Costa Rica
1427,Austin Huggins,0,108.0,0,0,2,1,3,Saint Kitts and Nevis
1428,Austin Makacha,0,40.0,0,0,0,1,1,Namibia
1429,Avdija Vršajević,1,135.0,0,0,2,0,2,Bosnia and Herzegovina
1430,Avelino Salvador Maluana,1,57.0,0,0,0,1,1,Zambia
1431,Avi Cohen,0,54.0,0,0,1,1,2,Israel
1432,Avi Nimni,0,289.0,0,1,0,6,6,Austria
1433,Avi Yehiel,0,39.0,0,0,0,1,1,Republic of Ireland
1434,Aviram Baruchyan,0,15.0,0,0,1,0,1,Israel
1435,Avondale Williams,0,229.0,0,1,1,2,3,British Virgin Islands
1436,Avraam Papadopoulos,0,90.0,1,0,0,1,1,Greece
1437,Avraham Menchel,1,32.0,0,0,1,0,1,Israel
1438,Avraham Nudelmann,0,61.0,0,0,0,1,1,Egypt
1439,Awad Koka,0,70.0,0,0,1,0,1,Sudan
1440,Awad Ragheb,0,90.0,0,0,1,0,1,Jordan
1441,Awer Mabil,4,94.0,0,0,3,1,4,Palestine
1442,Axel Méyé,0,103.0,0,0,0,2,2,Ivory Coast
1443,Axel Temataua,3,120.0,0,0,3,0,3,Tahiti
1444,Axel Witsel,2,228.0,0,0,2,4,6,Austria
1445,Ayad Al-Qadi,0,70.0,0,1,1,0,1,Libya
1446,Ayad El-Ghadi,0,30.0,0,0,1,0,1,Libya
1447,Ayan Sadakov,0,87.0,0,0,0,2,2,Luxembourg
1448,Aydın Yelken,0,60.0,0,0,1,0,1,Turkey
1449,Ayedi Hamrouni,0,181.0,0,0,3,0,3,Tunisia
1450,Ayel Mayélé,0,43.0,0,0,1,1,2,Mozambique
1451,Ayhan Elmastaşoğlu,0,43.0,0,0,1,1,2,Czechoslovakia
1452,Ayila Yussuf,0,62.0,0,0,1,0,1,Nigeria
1453,Ayman Al Husaini,0,8.0,0,0,0,1,1,Malaysia
1454,Ayman Mansour,1,25.0,0,0,1,1,2,Togo
1455,Ayman Younes,1,58.0,0,0,1,0,1,Egypt
1456,Aymen Abdennour,0,58.0,0,0,1,0,1,Tunisia
1457,Aymen Barkok,0,20.0,0,0,1,0,1,Morocco
1458,Aymen Hussein,2,188.0,0,0,1,3,4,Iraq
1459,Aymeric Laporte,0,45.0,0,0,1,0,1,Spain
1460,Ayoub El Kaabi,0,223.0,0,0,5,0,5,Morocco
1461,Ayrton Preciado,2,84.0,0,0,1,1,2,Venezuela
1462,Aytec Genc,0,4.0,0,0,1,0,1,Australia
1463,Ayub Masika,0,23.0,0,0,0,1,1,Mauritius
1464,Azamat Ishenbaev,0,55.0,0,0,1,0,1,Kyrgyzstan
1465,Azinho Solomon,1,86.0,0,0,1,0,1,Saint Vincent and the Grenadines
1466,Aziz Behich,1,166.0,2,0,2,0,2,France
1467,Aziz Bouderbala,0,176.0,0,0,2,1,3,Morocco
1468,Aziz Bouhaddouz,2,104.0,1,0,1,1,2,Morocco
1469,Aziz Ibrahimov,0,147.0,0,0,0,2,2,Malaysia
1470,Aziz Mashaan,1,61.0,0,0,1,0,1,Kuwait
1471,Azizbek Haydarov,1,7.0,0,0,0,1,1,Yemen
1472,Azizol Abu Haniffah,2,183.0,0,0,3,1,4,Malaysia
1473,Azmahar Ariano,0,69.0,0,0,1,0,1,Panama
1474,Azman Adnan,2,249.0,0,0,5,2,7,Malaysia
1475,Azubuike Egwuekwe,0,89.0,0,0,0,1,1,Malawi
1476,Azzedine Ounahi,0,75.0,0,0,2,0,2,Morocco
1477,Azər Salahlı,0,82.0,0,0,1,0,1,Azerbaijan
1478,Aïssa Laïdouni,0,18.0,0,0,1,0,1,Tunisia
1479,Aïssa Mandi,1,83.0,1,0,0,2,2,Algeria
1480,Baba Adamu,1,90.0,0,0,1,0,1,Ghana
1481,Baba Otu Mohammed,3,129.0,0,0,2,1,3,Nigeria
1482,Babacar Gueye,0,21.0,0,0,1,0,1,Senegal
1483,Babatounde Bello,0,137.0,0,0,2,0,2,Benin
1484,Babiker Santo,0,170.0,0,0,1,2,3,Zambia
1485,Babkin Melikian,0,117.0,0,0,1,1,2,Lebanon
1486,Baboucar Sowe,0,22.0,0,0,1,0,1,Gambia
1487,Bachirou Osseni,0,12.0,0,0,0,1,1,Libya
1488,Bachirou Salou,0,29.0,0,0,2,0,2,Togo
1489,Backer Aloenouvo,0,90.0,0,0,1,0,1,Togo
1490,Badal Das,0,76.0,0,0,1,0,1,Bangladesh
1491,Badar Al-Mahrouqi,0,89.0,0,0,1,0,1,Oman
1492,Badar Al-Maimani,1,235.0,0,0,4,1,5,Oman
1493,Badawi Abdel Fattah,1,160.0,0,0,1,2,3,Egypt
1494,Baddrol Bakhtiar,0,59.0,0,0,1,0,1,Malaysia
1495,Bader Al-Mutawa,6,766.0,0,4,8,6,14,Malaysia
1496,Badr Abdul Hameed Bo Abbas,0,76.0,0,0,1,0,1,Kuwait
1497,Badr Haji,1,84.0,0,1,0,1,1,Indonesia
1498,Badran Al-Shagran,0,286.0,0,0,2,3,5,Uzbekistan
1499,Baghdad Bounedjah,2,130.0,0,2,2,2,4,Algeria
1500,Baha' Abdel-Rahman,2,130.0,0,0,3,0,3,Jordan
1501,Baha' Faisal,2,320.0,0,1,4,3,7,Jordan
1502,Bahodir Nasimov,0,290.0,0,0,2,2,4,Kyrgyzstan
1503,Bahtiyor Kambaraliev,0,30.0,0,0,1,0,1,Uzbekistan
1504,Bai He,0,87.0,0,0,1,0,1,Hong Kong
1505,Bai Malleh Wadda,0,81.0,0,0,1,0,1,Gambia
1506,Baichung Bhutia,0,88.0,0,1,2,0,2,India
1507,Baihakki Khaizan,0,62.0,1,0,1,0,1,Lebanon
1508,Bajram Franholli,0,57.0,0,0,1,0,1,Albania
1509,Bakalevu Moceimereke,0,209.0,0,0,3,0,3,Fiji
1510,Bakar Ibor,0,53.0,0,1,0,1,1,Madagascar
1511,Bakari Koné,3,433.0,0,0,3,4,7,Ivory Coast
1512,Bakary Koné,1,82.0,1,0,1,0,1,Ivory Coast
1513,Bakary Sako,1,37.0,0,0,1,1,2,Ivory Coast
1514,Bakary Traoré,1,10.0,0,0,1,0,1,Mali
1515,Bakaye Traoré,1,30.0,0,0,1,0,1,Mali
1516,Bakhit Alabadla,0,60.0,0,0,0,1,1,Uzbekistan
1517,Bakhtiyar Duyshobekov,0,7.0,0,0,1,0,1,Kyrgyzstan
1518,Bakhtiyar Zaynutdinov,0,181.0,0,0,1,3,4,Kazakhstan
1519,Bakhtiyor Ashurmatov,0,6.0,0,0,1,0,1,Uzbekistan
1520,Bako,1,76.0,0,0,0,1,1,Tahiti
1521,Bako Touré,2,117.0,0,0,2,0,2,Mali
1522,Bakri Almadina,0,2.0,0,0,1,0,1,Sudan
1523,Bakri Ibni,1,78.0,0,0,1,0,1,Malaysia
1524,Bal Gopal Maharjan,1,52.0,0,0,0,1,1,Macau
1525,Balal Arezou,0,63.0,0,0,0,1,1,Palestine
1526,Baltazar,4,567.0,0,0,8,3,11,Brazil
1527,Baltazar Maria de Morais Júnior,0,57.0,0,0,1,0,1,Brazil
1528,Balázs Dzsudzsák,2,641.0,0,3,7,3,10,Hungary
1529,Bamba Dieng,1,174.0,0,0,1,1,2,Senegal
1530,Bambang Nurdiansyah,0,149.0,0,0,3,1,4,Indonesia
1531,Bambang Pamungkas,0,262.0,0,0,3,1,4,Indonesia
1532,Banana Yaya,1,156.0,0,0,1,1,2,Zambia
1533,Banou Diawara,0,179.0,0,0,2,0,2,Burkina Faso
1534,Barak Yitzhaki,0,11.0,0,0,0,1,1,North Macedonia
1535,Barrios Zapata,0,3.0,0,0,1,0,1,Honduras
1536,Barry Ferguson,0,148.0,0,0,1,1,2,Faroe Islands
1537,Barry Hulshoff,0,149.0,0,0,2,1,3,Netherlands
1538,Barry Hunter,0,53.0,0,0,1,0,1,Northern Ireland
1539,Barry Opdam,0,38.0,0,0,0,1,1,Czech Republic
1540,Bart Goor,0,309.0,0,0,6,0,6,Belgium
1541,Bart McGhee,1,23.0,0,0,0,1,1,Belgium
1542,Bartosz Bosacki,2,98.0,0,0,0,2,2,Costa Rica
1543,Bartosz Kapustka,0,82.0,0,0,1,1,2,Poland
1544,Bartosz Karwan,0,250.0,0,0,2,1,3,Norway
1545,Basam Al-Khateeb,1,88.0,0,0,1,0,1,Jordan
1546,Basanta Thapa,2,121.0,0,0,1,1,2,Nepal
1547,Basaula Lemba,1,48.0,0,0,0,1,1,Mali
1548,Basel Abdul Rahim,1,84.0,0,1,0,1,1,Macau
1549,Basem Fathi,0,85.0,0,0,0,1,1,China PR
1550,Bashar Abdulaziz,0,154.0,0,0,1,2,3,Saudi Arabia
1551,Bashar Abdullah,3,542.0,0,0,8,2,10,Kuwait
1552,Bashar Bani Yaseen,1,112.0,0,0,0,2,2,Uzbekistan
1553,Bashar Rashid,1,10.0,0,0,1,0,1,Iraq
1554,Bashar Resan,2,42.0,0,0,1,1,2,Yemen
1555,Bashar Srour,0,365.0,0,1,8,0,8,Syria
1556,Basheer Saeed,1,308.0,1,0,4,1,5,Kuwait
1557,Bashir Abdel Samad,2,114.0,0,0,2,0,2,Egypt
1558,Basile Boli,0,25.0,0,0,0,1,1,Albania
1559,Basile de Carvalho,0,38.0,0,0,1,0,1,Guinea-Bissau
1560,Bassala Touré,0,84.0,0,0,2,0,2,Mali
1561,Bassam Al-Rawi,2,127.0,0,0,2,0,2,Qatar
1562,Bassam Jeridi,0,123.0,0,0,5,1,6,Benin
1563,Bastian Schweinsteiger,3,715.0,0,1,7,7,14,Germany
1564,Batman Furigi,0,88.0,0,0,1,0,1,Papua New Guinea
1565,Batram Suri,6,599.0,0,1,4,6,10,Tahiti
1566,Bauyrzhan Islamkhan,0,79.0,0,0,1,0,1,Kazakhstan
1567,Bauyrzhan Turysbek,0,144.0,0,0,1,1,2,Romania
1568,Bayarzorig Davaa,1,36.0,0,0,0,1,1,Bangladesh
1569,Bayazir al-Said,3,271.0,0,0,2,4,6,Syria
1570,Beat Sutter,0,28.0,0,0,0,1,1,Luxembourg
1571,Bebeto,5,1018.0,0,0,13,6,19,Brazil
1572,Bedel Moyimbouabeka,0,7.0,0,0,1,0,1,Congo
1573,Beder Caicedo,0,46.0,0,0,0,1,1,Bolivia
1574,Bedri Omuri,0,150.0,0,0,1,2,3,Belgium
1575,Begençmuhammet Kulyýew,2,497.0,0,0,5,3,8,Turkmenistan
1576,Behailu Assefa,0,57.0,0,0,1,0,1,Ethiopia
1577,Behtash Fariba,7,434.0,0,0,2,6,8,Kuwait
1578,Bekim Balaj,0,305.0,0,0,2,3,5,Portugal
1579,Bekuretsion Gebre-Hiwot,0,86.0,0,0,1,0,1,Ethiopia
1580,Ben Acheampong,3,97.0,0,0,1,2,3,DR Congo
1581,Ben Badi,1,14.0,0,0,0,1,1,Algeria
1582,Ben Brereton Díaz,1,173.0,0,0,4,0,4,Chile
1583,Ben Chilwell,0,17.0,0,0,0,1,1,Andorra
1584,Ben Davies,0,77.0,0,0,1,0,1,Wales
1585,Ben Federspiel,0,11.0,1,0,0,1,1,Luxembourg
1586,Ben Iroha,1,26.0,0,0,1,0,1,Nigeria
1587,Ben Lemana,2,88.0,0,1,1,1,2,American Samoa
1588,Ben Malango,0,236.0,0,0,1,2,3,Tanzania
1589,Ben Olsen,1,23.0,0,0,1,0,1,United States
1590,Ben Sahar,0,393.0,0,0,5,0,5,Israel
1591,Ben Sigmund,1,98.0,0,0,0,2,2,New Caledonia
1592,Ben Waine,1,75.0,0,0,0,1,1,Papua New Guinea
1593,Ben Wattman,0,90.0,0,0,0,1,1,Mexico
1594,Ben Wijnstekers,0,30.0,0,0,1,0,1,Netherlands
1595,Ben Woodburn,0,74.0,0,0,1,0,1,Wales
1596,Benas Šatkus,0,18.0,1,0,1,0,1,Northern Ireland
1597,Benedict Akwuegbu,0,50.0,0,0,2,0,2,Nigeria
1598,Benedicto Godoy Véizaga,2,87.0,0,0,2,0,2,Bolivia
1599,Bengally Sylla,3,89.0,0,1,2,1,3,Guinea
1600,Bengt Berndtsson,0,20.0,0,0,1,0,1,Sweden
1601,Benigno Apocada,1,173.0,0,0,0,2,2,Ecuador
1602,Benigno Gutiérrez,3,270.0,0,0,3,2,5,Ecuador
1603,Benito Armingol,1,42.0,0,0,1,0,1,Chile
1604,Benito Lorenzi,1,78.0,0,0,0,1,1,Belgium
1605,Benjamin Fischer,0,109.0,0,0,1,1,2,Liechtenstein
1606,Benjamin Huggel,0,22.0,0,0,0,1,1,Luxembourg
1607,Benjamin Kololli,0,16.0,1,0,1,0,1,North Macedonia
1608,Benjamin Källman,0,57.0,0,0,0,1,1,Liechtenstein
1609,Benjamin Moukandjo,2,101.0,0,0,2,2,4,Cameroon
1610,Benjamin Pavard,1,57.0,0,0,1,0,1,France
1611,Benjamin Totori,0,239.0,0,0,5,0,5,Solomon Islands
1612,Benjamin Verbič,0,262.0,0,0,3,1,4,Malta
1613,Benjamin Šeško,0,67.0,0,0,0,1,1,Malta
1614,Benjamín Delgado,3,125.0,0,0,3,0,3,Argentina
1615,Benjamín Galindo,5,589.0,0,6,11,2,13,Mexico
1616,Benjani Mwaruwari,1,299.0,0,0,3,2,5,Zimbabwe
1617,Benni McCarthy,9,453.0,0,1,7,5,12,South Africa
1618,Bennie Muller,0,52.0,0,0,1,0,1,Netherlands
1619,Benny Feilhaber,0,73.0,0,0,1,0,1,United States
1620,Benny Nielsen,0,150.0,0,1,3,0,3,Denmark
1621,Benny Tabak,0,54.0,0,0,3,0,3,Israel
1622,Bent Burgess,0,65.0,0,0,1,0,1,Belize
1623,Bent Christensen Arensøe,1,172.0,0,0,2,4,6,Yugoslavia
1624,Bent Hansen,0,19.0,0,0,1,0,1,Denmark
1625,Bent Jensen,0,84.0,0,1,0,1,1,Republic of Ireland
1626,Bep Bakhuys,0,291.0,0,0,2,2,4,Netherlands
1627,Berat Djimsiti,0,23.0,0,0,0,1,1,Armenia
1628,Berat Sadik,0,90.0,0,0,0,1,1,Northern Ireland
1629,Berdi Şamyradow,0,84.0,0,0,0,1,1,Indonesia
1630,Bernard Akue Adovi,0,57.0,0,0,0,1,1,Togo
1631,Bernard Blanchet,0,118.0,0,0,0,2,2,Norway
1632,Bernard Chanda,3,411.0,0,0,4,3,7,Zambia
1633,Bernard Genghini,3,260.0,0,0,3,1,4,France
1634,Bernard Lacombe,1,170.0,0,0,3,3,6,Bulgaria
1635,Bernard Leclézio,0,48.0,1,0,1,0,1,Malawi
1636,Bernard N'Guessan,0,129.0,0,1,2,0,2,Ivory Coast
1637,Bernard Parker,1,447.0,1,1,6,2,8,South Africa
1638,Bernard Rahis,0,59.0,0,0,0,1,1,Austria
1639,Bernard Tchoutang,1,358.0,0,0,5,0,5,Cameroon
1640,Bernard Voorhoof,2,162.0,0,0,3,1,4,Belgium
1641,Bernardo Añor,0,64.0,0,0,1,0,1,Venezuela
1642,Bernardo Redín,3,268.0,0,1,0,3,3,Chile
1643,Bernardo Silva,1,228.0,0,0,2,3,5,New Zealand
1644,Bernd Bransch,0,106.0,0,0,2,0,2,German DR
1645,Bernd Hölzenbein,2,244.0,0,0,1,2,3,Germany
1646,Bernd Krauss,0,30.0,1,0,1,0,1,Germany
1647,Bernd Schneider,1,180.0,0,1,1,1,2,Germany
1648,Bernd Schuster,0,80.0,0,0,0,2,2,Albania
1649,Bernhard Cullmann,0,129.0,0,0,1,2,3,Germany
1650,Bernhard Klodt,1,52.0,0,0,1,0,1,Germany
1651,Bernt Haas,0,10.0,0,0,1,0,1,Switzerland
1652,Bert Patenaude,4,144.0,0,0,0,4,4,Belgium
1653,Berthy Suárez,1,152.0,0,0,2,1,3,Bolivia
1654,Berti Vogts,1,141.0,1,0,2,0,2,Germany
1655,Bertil Ericsson,0,83.0,0,0,2,0,2,Sweden
1656,Bertrand Bouity,0,26.0,0,0,1,0,1,Congo
1657,Bertrand Crasson,0,24.0,0,0,0,1,1,Wales
1658,Bertrand Kaï,6,366.0,0,0,0,6,6,Vanuatu
1659,Bertrand St. Ange,0,44.0,0,0,0,1,1,Burkina Faso
1660,Bertrand Traoré,2,164.0,0,0,3,1,4,Burkina Faso
1661,Besar Halimi,0,70.0,0,0,0,1,1,Spain
1662,Besart Abdurahimi,0,90.0,0,0,1,0,1,North Macedonia
1663,Besnik Hasi,0,137.0,0,0,1,1,2,Albania
1664,Bessam,0,3.0,0,0,1,0,1,Mauritania
1665,Beto,1,39.0,0,0,0,1,1,United States
1666,Beto Gonçalves,0,49.0,0,0,2,0,2,Indonesia
1667,Bharat Khawas,0,80.0,0,0,1,0,1,Nepal
1668,Bhola Silwal,0,56.0,0,0,1,0,1,Nepal
1669,Bhupinder Thakur,3,143.0,0,0,2,1,3,India
1670,Bibiano Zapirain,0,95.0,0,0,3,0,3,Uruguay
1671,Bibras Natcho,0,166.0,0,0,0,3,3,Azerbaijan
1672,Bijou Kisombe Mundaba,1,77.0,0,0,0,1,1,Ghana
1673,Bikash Panji,0,120.0,0,0,1,1,2,Bangladesh
1674,Bilal Al-Laham,1,16.0,0,0,0,1,1,Taiwan
1675,Bilal Kısa,0,47.0,0,0,0,1,1,Latvia
1676,Bilal Mohammed,0,30.0,0,0,2,0,2,Qatar
1677,Bilal Sidibé,0,16.0,1,0,1,0,1,Tunisia
1678,Bill Looby,0,176.0,0,0,0,4,4,Mexico
1679,Bill Tchato,0,88.0,0,0,0,1,1,Egypt
1680,Bill Tuiloma,3,174.0,0,0,1,2,3,New Zealand
1681,Bill de Graaf,2,63.0,0,0,2,0,2,New Zealand
1682,Billel Dziri,3,204.0,0,0,1,2,3,Burkina Faso
1683,Billy Bingham,0,69.0,0,0,1,1,2,Portugal
1684,Billy Bremner,0,86.0,0,0,2,0,2,Scotland
1685,Billy Caskey,0,83.0,0,0,0,1,1,Bulgaria
1686,Billy Dodds,0,307.0,0,1,6,1,7,Scotland
1687,Billy Forbes,0,22.0,0,0,0,1,1,Saint Kitts and Nevis
1688,Billy Hamilton,2,200.0,0,0,1,3,4,Scotland
1689,Billy Humphries,0,54.0,0,0,0,1,1,Poland
1690,Billy McAdams,0,168.0,0,0,3,0,3,Northern Ireland
1691,Billy McClure,0,5.0,0,1,1,0,1,New Zealand
1692,Billy McKinlay,0,101.0,0,0,1,2,3,Malta
1693,Billy McNeill,0,33.0,0,0,2,0,2,Scotland
1694,Billy Simpson,0,60.0,0,0,1,0,1,Northern Ireland
1695,Billy Steel,0,23.0,0,0,0,1,1,Northern Ireland
1696,Billy Wright,0,212.0,0,0,6,0,6,New Zealand
1697,Bima Sakti,0,51.0,0,0,1,0,1,Indonesia
1698,Biplu Ahmed,0,81.0,0,0,0,1,1,Oman
1699,Biram Kayal,0,81.0,0,0,1,0,1,Israel
1700,Biren Basnet,0,90.0,0,0,1,0,1,Bhutan
1701,Birkir Bjarnason,1,488.0,0,0,3,9,12,Albania
1702,Birkir Már Sævarsson,1,100.0,1,0,0,2,2,Iceland
1703,Bixente Lizarazu,0,174.0,0,0,2,0,2,France
1704,Bizwell Phiri,1,166.0,0,0,1,1,2,Burkina Faso
1705,Bjarni Guðjónsson,0,73.0,0,0,1,0,1,Iceland
1706,Björn Andersson,0,27.0,0,0,1,0,1,Sweden
1707,Björn Bergmann Sigurðarson,1,25.0,0,0,0,1,1,Kosovo
1708,Bjørn Borgen,1,64.0,0,0,0,1,1,Russia
1709,Bjørn Helge Riise,0,74.0,0,0,0,1,1,Bosnia and Herzegovina
1710,Bjørn Maars Johnsen,0,173.0,0,0,1,2,3,Norway
1711,Blagoje Marjanović,1,187.0,0,0,2,1,3,Bolivia
1712,Blagoy Georgiev,0,171.0,0,0,0,2,2,Slovenia
1713,Blaise Matuidi,1,21.0,0,0,0,2,2,Switzerland
1714,Blaise Nkufo,0,269.0,0,0,3,2,5,Israel
1715,Blas Pérez,10,1315.0,0,0,16,8,24,Panama
1716,Blas Saruppo,2,165.0,0,0,3,0,3,Argentina
1717,Blati Touré,1,82.0,0,0,1,0,1,Burkina Faso
1718,Blaž Slišković,0,50.0,0,0,1,0,1,Yugoslavia
1719,Bledar Kola,2,252.0,0,1,3,1,4,Albania
1720,Blerim Džemaili,2,250.0,0,1,3,2,5,Switzerland
1721,Blessing Makunike,0,43.0,0,0,1,0,1,Zimbabwe
1722,Bo Börjesson,0,137.0,0,0,2,1,3,Switzerland
1723,Bo Larsson,1,380.0,0,3,4,4,8,Cyprus
1724,Boaz Kofman,0,31.0,0,0,0,1,1,Cyprus
1725,Bob Latchford,0,167.0,0,0,2,2,4,Denmark
1726,Bob Peeters,0,261.0,0,0,3,1,4,Latvia
1727,Boban Babunski,0,53.0,1,1,1,1,2,North Macedonia
1728,Boban Grnčarov,0,79.0,0,0,0,1,1,Norway
1729,Boban Nikolov,0,162.0,0,0,1,2,3,Liechtenstein
1730,Bobby Brennan,0,75.0,0,0,0,1,1,England
1731,Bobby Chalmers,2,117.0,0,0,2,0,2,Zimbabwe
1732,Bobby Charlton,2,703.0,0,0,9,5,14,Luxembourg
1733,Bobby Collins,1,74.0,0,0,0,1,1,Paraguay
1734,Bobby Convey,0,67.0,0,0,1,0,1,United States
1735,Bobby Decordova-Reid,1,26.0,0,0,1,0,1,Jamaica
1736,Bobby Despotovski,5,296.0,0,1,5,0,5,Australia
1737,Bobby Hogg,0,86.0,1,0,0,1,1,Australia
1738,Bobby Johnstone,0,42.0,0,0,1,0,1,Scotland
1739,Bobby Lennox,0,113.0,0,0,1,1,2,Scotland
1740,Bobby Murdoch,0,143.0,0,0,2,1,3,Scotland
1741,Bobby Smith,0,132.0,0,0,0,3,3,Luxembourg
1742,Bobby Sookram,0,90.0,0,0,0,1,1,Suriname
1743,Bobby Tambling,0,74.0,0,0,0,1,1,France
1744,Bobby Wood,0,278.0,0,0,4,2,6,United States
1745,Bobo Bola,0,81.0,0,0,0,1,1,Mauritania
1746,Bodunha,0,99.0,0,0,2,0,2,Angola
1747,Bogdan Stancu,1,453.0,0,3,2,7,9,Romania
1748,Bogi Løkin,0,47.0,0,0,1,0,1,Faroe Islands
1749,Bohdan Masztaler,0,27.0,0,0,1,0,1,Poland
1750,Bohumil Veselý,0,201.0,0,0,3,0,3,Czechoslovakia
1751,Boitumelo Mafoko,0,80.0,0,0,0,1,1,Mozambique
1752,Bokang Mothoana,0,22.0,0,0,0,1,1,Burundi
1753,Boldyn Buman-Uchral,1,90.0,0,0,0,1,1,Bangladesh
1754,Bolombo Tokala,0,34.0,0,0,0,1,1,Ivory Coast
1755,Bonaventure Djonkep,1,143.0,0,0,2,1,3,Cameroon
1756,Bonaventure Kalou,1,191.0,0,1,3,1,4,Ghana
1757,Bongani Khumalo,0,20.0,0,0,1,0,1,South Africa
1758,Bongani Zungu,2,139.0,0,0,1,1,2,South Africa
1759,Bongokuhle Hlongwane,0,83.0,0,0,1,0,1,South Africa
1760,Boniek García,0,62.0,0,0,2,0,2,Honduras
1761,Boniface Simutowe,0,62.0,0,1,1,0,1,Zambia
1762,Bora Kostić,0,268.0,0,0,3,1,4,Portugal
1763,Boraî Bashir,0,58.0,0,0,1,0,1,Sudan
1764,Boris Cebotari,0,14.0,0,0,0,1,1,Belarus
1765,Boris Céspedes,0,45.0,0,0,0,1,1,Paraguay
1766,Boris Kazakov,1,14.0,0,0,1,0,1,Russia
1767,Boris Kopitović,0,49.0,1,0,1,0,1,Czech Republic
1768,Boris Tatushin,1,9.0,0,0,1,0,1,Russia
1769,Borislav Dimitrov,0,2.0,0,0,1,0,1,Bulgaria
1770,Borna Barišić,0,44.0,0,0,1,0,1,Croatia
1771,Borče Jovanovski,0,35.0,0,0,0,1,1,Cyprus
1772,Boualem Amirouche,0,97.0,0,1,1,1,2,Ethiopia
1773,Boualem Khoukhi,1,362.0,0,0,5,2,7,Qatar
1774,Boubacar Bagili,0,64.0,0,0,1,1,2,South Sudan
1775,Boubacar Sanogo,1,255.0,0,0,4,2,6,Ivory Coast
1776,Bouchaib El Moubarki,0,63.0,0,0,0,1,1,Gambia
1777,Boudewijn Zenden,1,174.0,0,0,4,0,4,Netherlands
1778,Boujemaa Benkhrif,0,72.0,0,0,1,0,1,Morocco
1779,Boukari Adamou,0,17.0,0,0,0,1,1,Sierra Leone
1780,Boulat Esmagambetov,0,92.0,0,0,2,1,3,Kazakhstan
1781,Boulaye Dia,0,71.0,0,0,1,2,3,Congo
1782,Boureima Zongo,1,83.0,0,0,1,0,1,Burkina Faso
1783,Boycho Velichkov,0,44.0,0,0,2,0,2,Bulgaria
1784,Bozhidar Iskrenov,0,107.0,0,0,1,1,2,Yugoslavia
1785,Bozhil Kolev,0,253.0,0,1,4,1,5,Bulgaria
1786,Bořek Dočkal,0,199.0,0,0,1,4,5,Bulgaria
1787,Boško Balaban,0,343.0,0,0,5,3,8,Croatia
1788,Boško Gjurovski,0,129.0,0,0,3,0,3,North Macedonia
1789,Boško Janković,0,81.0,0,0,1,2,3,Serbia
1790,Boštjan Cesar,0,365.0,0,0,2,5,7,Slovenia
1791,Božidar Senčar,0,44.0,0,0,1,0,1,Yugoslavia
1792,Brad Evans,0,90.0,0,0,0,1,1,Jamaica
1793,Brad Maloney,0,106.0,0,0,2,0,2,Australia
1794,Bradley August,0,54.0,0,0,1,0,1,South Africa
1795,Bradley Woods-Garness,0,83.0,0,0,1,0,1,Montserrat
1796,Brahim Kerrit,1,89.0,0,0,0,1,1,Morocco
1797,Brahim Zafour,1,52.0,0,0,0,1,1,Cameroon
1798,Brahima Korbeogo,0,83.0,0,0,1,0,1,Burkina Faso
1799,Brahima Traore,0,81.0,0,0,1,0,1,Burkina Faso
1800,Braian Samudio,1,33.0,0,0,0,1,1,Chile
1801,Branco,4,214.0,0,1,1,4,5,Venezuela
1802,Brandley Kuwas,1,7.0,0,0,0,1,1,British Virgin Islands
1803,Brandon Beresford,0,27.0,0,0,0,1,1,Saint Vincent and the Grenadines
1804,Brandon McDonald,0,37.0,0,0,1,0,1,Guam
1805,Brandur Olsen,0,70.0,0,0,1,0,1,Faroe Islands
1806,Branimir Subašić,0,6.0,0,0,1,0,1,Azerbaijan
1807,Branislav Ivanović,0,371.0,0,0,3,4,7,Portugal
1808,Branko Bošković,0,89.0,1,0,1,1,2,Azerbaijan
1809,Branko Brnovic,0,2.0,0,0,0,1,1,Hungary
1810,Branko Buljevic,0,55.0,0,0,1,1,2,Australia
1811,Branko Ilić,0,88.0,0,0,1,0,1,Slovenia
1812,Branko Oblak,1,100.0,0,0,3,0,3,Yugoslavia
1813,Branko Zebec,1,128.0,0,0,0,2,2,Israel
1814,Braulio Luna,0,75.0,0,0,0,1,1,Saudi Arabia
1815,Brayan Moya,0,86.0,0,0,2,0,2,Honduras
1816,Brede Hangeland,0,185.0,0,0,0,3,3,Iceland
1817,Breel Embolo,2,404.0,0,1,4,5,9,Switzerland
1818,Brehima Traoré,0,125.0,0,0,2,0,2,Mali
1819,Brek Shea,0,151.0,0,0,2,0,2,United States
1820,Brendan Augustine,1,39.0,0,0,1,0,1,South Africa
1821,Brendan Gan,0,26.0,0,0,1,0,1,Malaysia
1822,Brenden Aaronson,0,141.0,0,0,1,1,2,United States
1823,Brent Fisher,4,137.0,0,0,4,0,4,New Zealand
1824,Brent Sancho,1,25.0,1,0,1,0,1,Paraguay
1825,Brett Emerton,1,834.0,0,1,8,7,15,New Zealand
1826,Brett Holman,3,299.0,0,0,3,3,6,Ghana
1827,Brian Brendell,2,104.0,0,0,1,1,2,Namibia
1828,Brian Ching,0,431.0,0,0,7,1,8,Jamaica
1829,Brian Flynn,0,219.0,0,1,2,3,5,Wales
1830,Brian Hardman,0,90.0,0,0,1,0,1,New Zealand
1831,Brian Haynes,0,41.0,0,0,0,1,1,Jamaica
1832,Brian Kaltak,2,120.0,0,1,1,1,2,Vanuatu
1833,Brian Laudrup,5,805.0,0,0,9,7,16,Bulgaria
1834,Brian McBride,5,889.0,0,1,19,4,23,United States
1835,Brian McClair,1,34.0,0,0,2,0,2,Scotland
1836,Brian Mwila,0,102.0,0,0,3,0,3,Zambia
1837,Brian Onyango,0,19.0,0,0,1,0,1,Kenya
1838,Brian Philley,0,44.0,0,0,1,1,2,Canada
1839,Brian Quinn,0,46.0,0,0,1,0,1,United States
1840,Brian Said,0,241.0,2,0,3,2,5,Malta
1841,Brian Steen Nielsen,0,87.0,0,0,1,1,2,Israel
1842,Brian Turner,0,504.0,0,1,5,6,11,New Zealand
1843,Brice Dahité,1,89.0,0,1,1,0,1,New Caledonia
1844,Brice Jovial,2,143.0,0,0,0,2,2,Panama
1845,Brice Mackaya,2,65.0,0,1,2,1,3,DR Congo
1846,Briel Thomas,2,31.0,1,0,1,1,2,Dominica
1847,Brighton Sinyangwe,1,299.0,0,0,3,1,4,Zambia
1848,Britt Assombalonga,1,78.0,0,0,0,1,1,Zimbabwe
1849,Bronisław Bula,0,90.0,0,0,1,1,2,Luxembourg
1850,Bror Mellberg,1,33.0,0,0,0,1,1,Spain
1851,Brown Ideye,1,30.0,0,0,0,1,1,Mali
1852,Bruce Murray,3,329.0,0,0,4,1,5,Austria
1853,Bruce Rioch,0,93.0,0,0,2,0,2,Scotland
1854,Brunel Fucien,0,90.0,0,0,1,0,1,Haiti
1855,Bruno Akrapović,0,48.0,0,0,0,1,1,Israel
1856,Bruno Alves,0,397.0,0,0,3,5,8,Azerbaijan
1857,Bruno Bellone,0,99.0,0,0,1,1,2,Republic of Ireland
1858,Bruno Conti,1,154.0,0,0,3,0,3,Italy
1859,Bruno Coutinho,1,85.0,0,0,1,0,1,India
1860,Bruno Ecuele Manga,1,162.0,1,0,3,1,4,Libya
1861,Bruno Fernandes,2,298.0,0,1,5,1,6,Luxembourg
1862,Bruno Guimarães,0,66.0,0,0,0,1,1,Bolivia
1863,Bruno Martins Indi,0,48.0,0,0,0,2,2,Hungary
1864,Bruno Mauro,0,106.0,0,0,1,1,2,Chad
1865,Bruno Michaud,0,33.0,1,0,0,1,1,Switzerland
1866,Bruno Miranda,0,38.0,0,0,0,1,1,Venezuela
1867,Bruno Mora,1,170.0,0,0,3,0,3,Italy
1868,Bruno Petković,1,315.0,0,0,4,1,5,Slovakia
1869,Bruno Pezzey,1,154.0,0,0,4,1,5,Norway
1870,Bruno Valdez,0,11.0,0,0,1,0,1,Paraguay
1871,Bruno Versavel,0,74.0,0,0,1,2,3,Belgium
1872,Bruno Zita Mbanangoyé,2,351.0,0,0,2,2,4,Algeria
1873,Brutil Hosé,2,123.0,0,0,2,0,2,Curaçao
1874,Bryan Acosta,1,75.0,0,0,1,0,1,Honduras
1875,Bryan Hamilton,0,76.0,0,0,2,0,2,Northern Ireland
1876,Bryan Joseph,0,13.0,0,0,1,0,1,Guyana
1877,Bryan Oviedo,1,7.0,0,0,1,0,1,Costa Rica
1878,Bryan Robson,3,582.0,0,0,6,8,14,Norway
1879,Bryan Roy,1,139.0,0,0,1,3,4,Morocco
1880,Bryan Ruiz,6,1014.0,0,1,11,9,20,Honduras
1881,Brynjar Gunnarsson,0,168.0,0,0,2,2,4,Liechtenstein
1882,Brynjar Ingi Bjarnason,0,78.0,0,0,1,0,1,Iceland
1883,Budi Johannis,0,90.0,0,0,1,0,1,Indonesia
1884,Budi Sudarsono,1,109.0,0,0,2,2,4,Turkmenistan
1885,Buenaventura Ferreira,2,180.0,0,0,2,1,3,Colombia
1886,Bukayo Saka,3,366.0,0,0,4,2,6,England
1887,Burak Yılmaz,2,1012.0,0,4,12,10,22,Belgium
1888,Burhan Sargın,4,212.0,0,0,2,3,5,Turkey
1889,Burton Mugala,0,47.0,0,0,1,0,1,Zambia
1890,Bushara Abdel-Nadief,1,49.0,0,0,0,1,1,Morocco
1891,Byron Bonilla,0,46.0,0,0,1,0,1,Nicaragua
1892,Byron Bubb,0,169.0,0,0,1,1,2,Guyana
1893,Byron Tenorio,0,5.0,0,0,0,1,1,Venezuela
1894,Byun Byung-joo,2,163.0,0,0,3,1,4,South Korea
1895,Bálint Vécsei,0,88.0,0,0,1,0,1,Hungary
1896,Bård Borgersen,0,129.0,0,0,0,2,2,Armenia
1897,Béla Illés,0,489.0,0,1,5,2,7,Hungary
1898,Béla Várady,0,227.0,0,0,3,1,4,Hungary
1899,Bülent Eken,0,44.0,0,0,1,0,1,Turkey
1900,Bülent Korkmaz,1,148.0,0,0,2,1,3,Turkey
1901,Bănel Nicoliţă,0,69.0,0,0,0,1,1,Slovenia
1902,Cacau,1,70.0,0,0,1,0,1,Germany
1903,Caetano Izzo,1,21.0,0,0,1,0,1,Brazil
1904,Cai Jinbiao,1,27.0,0,0,1,0,1,China PR
1905,Cai Sheng,3,285.0,0,0,0,4,4,Pakistan
1906,Cain Attard,0,98.0,0,0,2,0,2,Malta
1907,Caio Canedo,1,148.0,0,0,4,0,4,United Arab Emirates
1908,Caio Ribeiro Decoussau,3,97.0,0,0,1,2,3,Brazil
1909,Callum McGregor,0,121.0,0,0,2,0,2,Scotland
1910,Callum Robinson,0,134.0,0,0,0,3,3,Azerbaijan
1911,Calum Willock,0,51.0,0,0,2,0,2,Saint Kitts and Nevis
1912,Camara Toure,0,49.0,0,0,1,0,1,Guinea
1913,Cameron Hepple,0,36.0,0,1,0,1,1,Turks and Caicos Islands
1914,Camille Dimmer,0,160.0,0,0,0,3,3,England
1915,Camille Libar,0,4.0,0,0,1,0,1,Luxembourg
1916,Camille Wagner,0,3.0,0,0,0,1,1,Switzerland
1917,Camillo Gonsalves,0,54.0,0,0,1,0,1,India
1918,Camillo Jerusalem,0,15.0,0,0,1,0,1,Austria
1919,Camilo Romero,1,59.0,1,0,1,0,1,Brazil
1920,Campbell Best,0,119.0,0,0,0,2,2,Samoa
1921,Capucho,0,64.0,0,0,1,0,1,Portugal
1922,Careca,8,698.0,0,1,12,2,14,Brazil
1923,Carey Harris,0,29.0,0,0,1,0,1,Guyana
1924,Carl Bertelsen,1,209.0,0,0,1,2,3,Denmark
1925,Carl Emil Christiansen,0,42.0,0,0,0,1,1,Malta
1926,Carl Fister,0,58.0,0,0,1,0,1,United States
1927,Carl Fletcher,0,47.0,0,0,0,1,1,Costa Rica
1928,Carl Harris,0,67.0,0,0,0,1,1,Turkey
1929,Carl Medjani,0,140.0,0,0,1,1,2,Burkina Faso
1930,Carl Robinson,0,37.0,0,0,0,1,1,Northern Ireland
1931,Carl Valeri,1,82.0,0,0,0,1,1,Uzbekistan
1932,Carl Veart,1,233.0,0,0,4,2,6,Solomon Islands
1933,Carles Puyol,2,152.0,1,0,0,3,3,Spain
1934,Carles Rexach,0,127.0,0,0,1,1,2,Spain
1935,Carlo Corazzin,5,379.0,0,2,4,3,7,Canada
1936,Carlo Costly,9,1202.0,0,0,15,7,22,Panama
1937,Carlo Galli,1,48.0,0,0,0,1,1,Belgium
1938,Carlo Valentini,0,89.0,1,0,0,1,1,San Marino
1939,Carlos Aguilera,0,324.0,0,0,2,3,5,Venezuela
1940,Carlos Alberto Raffo,5,497.0,0,0,6,4,10,Ecuador
1941,Carlos Alberto Torres,1,86.0,0,0,1,0,1,Brazil
1942,Carlos Alonso,0,86.0,1,0,1,0,1,Saint Vincent and the Grenadines
1943,Carlos Andrés Sánchez,0,30.0,0,0,0,1,1,Peru
1944,Carlos Aragonés,0,459.0,0,3,7,1,8,Bolivia
1945,Carlos Arango,3,216.0,0,1,3,2,5,Colombia
1946,Carlos Astondoa,0,43.0,0,0,0,1,1,Aruba
1947,Carlos Babington,1,66.0,0,0,0,1,1,Poland
1948,Carlos Bacca,1,166.0,0,0,3,2,5,Bolivia
1949,Carlos Bernárdez,2,93.0,0,0,2,0,2,Belize
1950,Carlos Bocanegra,0,314.0,0,0,6,2,8,United States
1951,Carlos Borges,7,311.0,0,0,1,7,8,Scotland
1952,Carlos Bueno,3,583.0,0,1,6,3,9,Uruguay
1953,Carlos Báez,0,21.0,0,0,1,0,1,Paraguay
1954,Carlos Campillo,2,31.0,0,0,1,1,2,Argentina
1955,Carlos Campos Sánchez,0,104.0,0,0,2,1,3,Chile
1956,Carlos Castro Borja,0,157.0,0,1,4,1,5,Nicaragua
1957,Carlos Caszely,0,290.0,0,0,5,2,7,Chile
1958,Carlos Cecconato,2,95.0,0,0,2,0,2,Argentina
1959,Carlos Chavarría,1,190.0,0,0,1,3,4,Nicaragua
1960,Carlos Chimomole,0,62.0,0,0,1,0,1,Mozambique
1961,Carlos Discua,0,69.0,0,0,0,1,1,United States
1962,Carlos Dunga,0,54.0,0,0,1,0,1,Brazil
1963,Carlos Eduardo Gallardo,1,157.0,0,1,2,1,3,Trinidad and Tobago
1964,Carlos Edwards,0,68.0,0,0,1,2,3,Guatemala
1965,Carlos Elizeche,1,7.0,0,0,1,0,1,Paraguay
1966,Carlos Figueroa,0,15.0,0,0,1,0,1,Guatemala
1967,Carlos Fumo Gonçalves,1,54.0,0,0,1,0,1,Mozambique
1968,Carlos Gabriel Rodríguez,1,68.0,0,0,1,0,1,Panama
1969,Carlos Gamarra,3,255.0,1,0,7,1,8,Paraguay
1970,Carlos Geerman,0,19.0,1,0,1,0,1,Puerto Rico
1971,Carlos Giudice,1,54.0,0,0,1,0,1,Chile
1972,Carlos González,0,77.0,0,0,2,0,2,Mexico
1973,Carlos Gruezo,0,88.0,0,1,0,1,1,Bolivia
1974,Carlos Guerini,0,89.0,0,0,1,0,1,Argentina
1975,Carlos Guirland,1,38.0,0,0,1,0,1,Paraguay
1976,Carlos Gómez Sánchez,5,290.0,0,0,2,3,5,Argentina
1977,Carlos Hermosillo,3,863.0,0,0,15,3,18,Mexico
1978,Carlos Hernández,0,288.0,0,0,4,1,5,Costa Rica
1979,Carlos Humberto Paredes,0,333.0,0,0,7,1,8,Paraguay
1980,Carlos Humberto Suazo,0,69.0,0,0,2,0,2,Honduras
1981,Carlos Izaguirre,2,112.0,0,0,2,1,3,Argentina
1982,Carlos Jara Saguier,0,116.0,0,0,1,1,2,Colombia
1983,Carlos José Báez,0,54.0,0,0,0,1,1,Brazil
1984,Carlos Lapetra,0,63.0,0,0,1,0,1,Spain
1985,Carlos Lobatón,1,101.0,0,0,0,1,1,Colombia
1986,Carlos Loswijk,0,14.0,0,0,1,0,1,Suriname
1987,Carlos Maldonado,3,253.0,0,0,2,2,4,Brazil
1988,Carlos Manuel,1,241.0,0,0,3,3,6,Portugal
1989,Carlos Marchena,0,90.0,0,0,1,0,1,Spain
1990,Carlos María Morales,1,53.0,0,0,1,0,1,Uruguay
1991,Carlos Mejía,0,90.0,0,0,1,0,1,Guatemala
1992,Carlos Miguel da Silva Júnior,1,57.0,0,0,1,0,1,Brazil
1993,Carlos Monteagudo,1,22.0,0,0,0,1,1,Anguilla
1994,Carlos Morais Caló,0,159.0,0,0,0,3,3,Burkina Faso
1995,Carlos Muñoz,1,54.0,0,0,2,1,3,Brazil
1996,Carlos Muñoz Cobo,0,206.0,0,0,3,1,4,Spain
1997,Carlos Ochoa,1,90.0,0,0,1,0,1,Mexico
1998,Carlos Pavón,9,1553.0,0,5,23,11,34,Honduras
1999,Carlos Pedro Silva Morais,0,145.0,0,0,1,1,2,Eswatini
2000,Carlos Peucelle,2,191.0,0,0,3,1,4,Argentina
2001,Carlos Peña,0,87.0,0,0,0,1,1,New Zealand
2002,Carlos Pineda Alvarado,1,32.0,0,0,0,1,1,Argentina
2003,Carlos Reinoso,0,76.0,0,0,0,1,1,Peru
2004,Carlos Reyes,0,44.0,0,0,1,0,1,Dominican Republic
2005,Carlos Rivas,0,112.0,0,1,4,0,4,Chile
2006,Carlos Rivera,1,33.0,0,0,1,0,1,Panama
2007,Carlos Rojas,1,4.0,0,0,1,0,1,Chile
2008,Carlos Romero,2,245.0,0,0,0,3,3,Bolivia
2009,Carlos Ruiz,10,2115.0,0,4,32,15,47,Guatemala
2010,Carlos Salcido,2,318.0,0,0,3,3,6,Mexico
2011,Carlos Saucedo,0,109.0,0,0,3,0,3,Bolivia
2012,Carlos Scarone,2,235.0,0,1,3,3,6,Uruguay
2013,Carlos Secretário,0,19.0,0,0,1,0,1,Portugal
2014,Carlos Septién,0,85.0,0,0,1,0,1,Mexico
2015,Carlos Soler,1,120.0,0,0,2,1,3,Sweden
2016,Carlos Soto,1,15.0,0,0,1,0,1,Bolivia
2017,Carlos Sánchez,1,6.0,1,0,1,0,1,Bolivia
2018,Carlos Tenorio,2,163.0,0,0,2,2,4,Ecuador
2019,Carlos Tevez,5,386.0,0,0,6,1,7,Peru
2020,Carlos Torres Garcés,0,64.0,0,1,1,0,1,Ecuador
2021,Carlos Valderrama,3,217.0,0,1,3,3,6,Bolivia
2022,Carlos Valdés,0,49.0,0,0,1,0,1,Colombia
2023,Carlos Varela,1,25.0,0,0,1,0,1,Chile
2024,Carlos Vela,4,454.0,0,1,5,5,10,Belize
2025,Carlos Verdejo,2,105.0,0,0,2,0,2,Chile
2026,Carlos Vidal,2,68.0,0,0,2,0,2,Chile
2027,Carlos Villanueva,1,86.0,0,0,0,1,1,Ecuador
2028,Carlos Vivo Goban,0,51.0,0,0,1,0,1,Costa Rica
2029,Carlos Zambrano,0,107.0,0,0,1,1,2,Peru
2030,Carlos Ángel López,0,5.0,0,0,0,1,1,Bolivia
2031,Carlton Chapman,1,39.0,0,0,0,1,1,Sri Lanka
2032,Carlton Palmer,0,78.0,0,0,1,0,1,England
2033,Carlyle Mitchell,0,110.0,1,0,1,1,2,Honduras
2034,Carmel Busuttil,0,526.0,0,1,6,4,10,Malta
2035,Carmelo Micciche,0,38.0,0,0,1,0,1,France
2036,Carnejy Antoine,1,181.0,0,0,0,4,4,Turks and Caicos Islands
2037,Carol Creiniceanu,0,75.0,0,0,1,0,1,Romania
2038,Carolus Andriamatsinoro,2,108.0,0,0,1,1,2,Guinea
2039,Carsten Jancker,1,124.0,0,0,2,1,3,Finland
2040,Carsten Ramelow,0,7.0,0,0,1,0,1,Germany
2041,Carvalho Leite,3,101.0,0,0,3,0,3,Brazil
2042,Casemiro,1,191.0,0,0,3,1,4,Brazil
2043,Casiano Mba,0,67.0,0,0,0,1,1,Congo
2044,Cassim Langaigne,0,76.0,0,0,0,1,1,Saint Vincent and the Grenadines
2045,Catalino Rivarola,0,129.0,0,0,3,0,3,Paraguay
2046,Catilina Aubameyang,0,56.0,0,0,0,1,1,Algeria
2047,Cavafe,1,80.0,0,0,1,0,1,Cuba
2048,Cayetano Ré,4,117.0,0,0,1,3,4,Paraguay
2049,Cecil Jones Attuquayefio,2,173.0,0,0,0,2,2,DR Congo
2050,Cecilio Martínez,3,119.0,0,0,2,1,3,Colombia
2051,Cecilio Waterman,0,440.0,0,0,5,2,7,Panama
2052,Cedric Itten,0,243.0,0,0,2,2,4,Switzerland
2053,Cees Schapendonk,0,48.0,0,0,1,0,1,Netherlands
2054,Ceferino Ramírez,3,228.0,0,0,0,3,3,Bolivia
2055,Celino Mora,2,136.0,0,0,2,3,5,Bolivia
2056,Celso Ayala,1,36.0,0,0,1,1,2,Nigeria
2057,Celso Borges,6,767.0,0,1,10,7,17,Costa Rica
2058,Celso Pontes,0,59.0,0,0,1,0,1,São Tomé and Príncipe
2059,Cemil Turan,0,348.0,0,1,5,2,7,Turkey
2060,Cengiz Ünder,1,170.0,0,0,2,2,4,Kosovo
2061,Cenk Tosun,0,522.0,0,0,6,4,10,Turkey
2062,Cesc Fàbregas,4,327.0,0,0,4,2,6,Spain
2063,Cesáreo Onzari,1,11.0,0,0,1,0,1,Argentina
2064,Cha Bum-kun,1,467.0,0,1,4,4,8,Cambodia
2065,Cha Du-ri,1,77.0,0,0,2,0,2,South Korea
2066,Chaabane Merzekane,1,85.0,0,0,1,0,1,Algeria
2067,Chad Bertrand,1,34.0,0,0,1,0,1,Dominica
2068,Chadi Hammami,0,142.0,0,0,2,0,2,Tunisia
2069,Chadrac Akolo,0,35.0,0,0,1,0,1,DR Congo
2070,Chalwe Kunda,0,65.0,0,0,0,1,1,Togo
2071,Chaminda Steinwall,1,28.0,0,0,0,1,1,Philippines
2072,Chan Fat Chi,0,79.0,0,0,0,1,1,South Korea
2073,Chan Ho Man,0,72.0,0,0,1,0,1,Hong Kong
2074,Chan Siu Ki,0,257.0,0,0,3,1,4,Hong Kong
2075,Chan Vathanaka,0,143.0,0,0,2,0,2,Cambodia
2076,Chanathip Songkrasin,1,65.0,0,0,0,2,2,Bahrain
2077,Chancel Mbemba,1,100.0,0,0,1,1,2,DR Congo
2078,Chandradasa Karunaratne,0,82.0,0,0,1,0,1,Sri Lanka
2079,Chang Han,0,31.0,0,0,1,0,1,Taiwan
2080,Chang Kuo Chi,1,69.0,0,0,1,1,2,Taiwan
2081,Chang Wu-yeh,0,57.0,0,0,1,0,1,Taiwan
2082,Channa Ediri Bandanage,2,118.0,0,0,2,1,3,Pakistan
2083,Chaouki Ben Saada,2,139.0,0,1,3,1,4,Tunisia
2084,Charles Akonnor,3,321.0,0,0,4,1,5,Algeria
2085,Charles Alerte,1,44.0,0,0,0,1,1,Ecuador
2086,Charles Amoah,0,112.0,0,0,2,1,3,Ghana
2087,Charles Antenen,2,277.0,0,0,2,4,6,Mexico
2088,Charles Aránguiz,2,251.0,0,0,2,4,6,Bolivia
2089,Charles Ashley,0,6.0,0,0,0,1,1,Australia
2090,Charles Galinie,1,90.0,0,0,0,1,1,New Caledonia
2091,Charles Hambira,2,81.0,1,0,1,1,2,Namibia
2092,Charles Hertig,0,42.0,0,0,0,1,1,Netherlands
2093,Charles Imboula,0,85.0,0,0,0,1,1,Ivory Coast
2094,Charles Jumanne,0,44.0,0,0,1,0,1,Tanzania
2095,Charles Kaboré,0,97.0,0,0,2,0,2,Burkina Faso
2096,Charles Lota,0,70.0,0,0,2,0,2,Zambia
2097,Charles Pollard,1,155.0,1,0,1,1,2,Guyana
2098,Charles Scerri,0,48.0,1,0,1,0,1,Portugal
2099,Charles Spiteri,0,77.0,1,0,0,1,1,Malta
2100,Charles Vatú,0,26.0,0,0,1,0,1,Vanuatu
2101,Charlie Davies,1,174.0,0,0,1,3,4,Trinidad and Tobago
2102,Charlie Eliazar,0,58.0,0,0,2,0,2,Haiti
2103,Charlie Fleming,0,116.0,0,0,0,2,2,Northern Ireland
2104,Charlie Nicholas,0,204.0,0,0,3,0,3,Scotland
2105,Charlie Yankos,0,227.0,0,1,3,1,4,Australia
2106,Charlison Benschop,3,84.0,0,1,0,3,3,Cuba
2107,Charlton Vicento,0,89.0,0,0,0,1,1,Montserrat
2108,Charly Loubet,0,272.0,0,0,4,1,5,France
2109,Charly Musonda,0,44.0,0,1,2,0,2,Zambia
2110,Chaswe Nsofwa,0,164.0,0,0,2,1,3,Zambia
2111,Chathura Gunaratne,0,43.0,0,0,1,0,1,Sri Lanka
2112,Chavdar Tsvetkov,0,395.0,0,0,4,1,5,France
2113,Chavdar Yankov,0,195.0,0,0,2,1,3,Bulgaria
2114,Che Bunce,2,73.0,0,0,1,1,2,New Zealand
2115,Che Chi Man,1,78.0,0,0,1,0,1,Macau
2116,Chea Makara,0,90.0,0,0,1,1,2,Cambodia
2117,Cheang Chon Man,1,13.0,0,0,0,1,1,Nepal
2118,Chedly Laaouini,1,53.0,0,0,1,0,1,Tunisia
2119,Cheick Diabaté,2,267.0,0,1,2,3,5,Gabon
2120,Cheick Fantamady Diarra,1,75.0,0,0,1,0,1,Mali
2121,Cheick Tioté,1,50.0,0,0,1,0,1,Ivory Coast
2122,Cheikh Ba,0,63.0,0,0,1,0,1,Senegal
2123,Cheikh Gueye,0,205.0,1,0,1,2,3,Liberia
2124,Cheikh Moulaye Ahmed,0,71.0,0,0,0,1,1,Tunisia
2125,Cheikh N'Doye,0,90.0,0,0,0,1,1,Cape Verde
2126,Cheikh Ndour,0,66.0,0,0,1,0,1,Gambia
2127,Cheikhou Kouyaté,1,88.0,0,0,2,0,2,Senegal
2128,Chen Fu-Yuan,1,78.0,0,0,0,1,1,Oman
2129,Chen Jingang,2,226.0,0,0,1,2,3,China PR
2130,Chen Jiunn-ming,0,90.0,0,0,0,1,1,Syria
2131,Chen Jui-te,0,135.0,0,0,1,2,3,Taiwan
2132,Chen Kuei-jen,1,78.0,0,0,0,1,1,Bangladesh
2133,Chen Po-liang,0,120.0,0,1,1,1,2,Malaysia
2134,Chen Sing-an,0,41.0,0,0,0,1,1,New Zealand
2135,Chen Tao,0,140.0,0,0,2,0,2,China PR
2136,Chen Wei-chuan,0,77.0,1,0,1,0,1,Kuwait
2137,Chen Xirong,1,55.0,0,0,0,1,1,North Korea
2138,Chen Yi-wei,0,21.0,0,0,1,0,1,Taiwan
2139,Chencho Gyeltshen,0,191.0,0,0,3,1,4,Bhutan
2140,Cheng Sin Siu,0,48.0,0,0,1,0,1,Hong Kong
2141,Cheng Siu Kwan,0,85.0,0,0,0,1,1,Iran
2142,Cheng Siu Wai,2,212.0,0,0,2,2,4,Timor-Leste
2143,Cherdsak Chaiyabutr,1,27.0,0,0,1,0,1,Thailand
2144,Cherkaoui Hafnaoui,1,60.0,0,0,1,0,1,Morocco
2145,Chernor Mansaray,0,78.0,0,0,2,0,2,Sierra Leone
2146,Cheung Chi Tak,0,26.0,0,0,0,1,1,China PR
2147,Cheung Ka-Ping,0,88.0,0,0,0,1,1,Macau
2148,Cheung Kam Wa,1,39.0,0,0,1,1,2,Hong Kong
2149,Cheung Sai Ho,0,49.0,0,0,1,0,1,Hong Kong
2150,Cheung Yiu Kwok,1,39.0,0,0,1,0,1,Hong Kong
2151,Chhin Chhoeun,0,45.0,0,0,0,1,1,Laos
2152,Chiang Shih-lu,0,66.0,0,0,0,1,1,Macau
2153,Chico,2,346.0,0,0,6,0,6,Brazil
2154,Chico Faria,0,36.0,0,0,0,1,1,Cyprus
2155,Chidi Odiah,0,51.0,0,0,1,0,1,Nigeria
2156,Chiedozie Ogbene,0,165.0,0,0,0,2,2,Azerbaijan
2157,Chinedu Obasi,1,12.0,0,0,0,1,1,Egypt
2158,Chinesinho,1,35.0,0,0,1,0,1,Brazil
2159,Chiukepo Msowoya,0,410.0,0,0,4,2,6,Malawi
2160,Cho Byung-kuk,0,51.0,0,0,1,0,1,South Korea
2161,Cho Gue-sung,2,164.0,0,0,2,1,3,Lebanon
2162,Cho In-Chol,2,104.0,0,0,2,0,2,North Korea
2163,Cho Kwang-Rae,1,82.0,1,0,0,1,1,South Korea
2164,Cho Min-Kook,1,189.0,0,0,2,1,3,South Korea
2165,Cho Yoon-ok,0,163.0,0,0,4,0,4,South Korea
2166,Cho Young-cheol,1,45.0,0,0,1,0,1,South Korea
2167,Choe Chol-Man,0,28.0,0,0,0,1,1,Bahrain
2168,Choe Kum-chol,0,144.0,0,0,1,1,2,North Korea
2169,Choe Yong-Son,3,302.0,0,0,3,2,5,North Korea
2170,Choi Chung-min,2,337.0,0,0,3,2,5,Japan
2171,Choi Jae-pil,2,89.0,0,0,2,0,2,North Korea
2172,Choi Jin-cheul,1,89.0,0,0,0,2,2,Costa Rica
2173,Choi Jong-duk,1,203.0,0,0,2,1,3,South Korea
2174,Choi Kwang-seok,0,62.0,0,0,0,1,1,Hong Kong
2175,Choi Kwang-suk,0,77.0,0,0,0,2,2,Japan
2176,Choi Moon-Sik,2,316.0,0,0,1,4,5,India
2177,Choi Sang-Kuk,0,72.0,0,0,2,0,2,South Korea
2178,Choi Soon-ho,8,583.0,0,1,7,5,12,Malaysia
2179,Choi Sung-kuk,1,66.0,0,0,1,0,1,South Korea
2180,Choi Won-nam,3,203.0,0,0,2,2,4,North Korea
2181,Choi Yong-soo,0,356.0,0,0,6,3,9,South Korea
2182,Choi York Yee,0,55.0,0,0,1,0,1,Hong Kong
2183,Cholponbek Esenkul Uulu,0,45.0,0,0,1,0,1,Kyrgyzstan
2184,Chris Armas,0,51.0,0,0,1,0,1,United States
2185,Chris Baird,0,56.0,1,0,1,0,1,Latvia
2186,Chris Birchall,1,104.0,0,0,2,0,2,Trinidad and Tobago
2187,Chris Brunt,0,258.0,1,0,3,1,4,San Marino
2188,Chris Coleman,0,62.0,0,0,2,0,2,Wales
2189,Chris Henderson,1,70.0,0,0,2,0,2,United States
2190,Chris Hughton,0,65.0,0,0,1,0,1,Republic of Ireland
2191,Chris Ikonomidis,1,54.0,0,0,1,0,1,Australia
2192,Chris Jackson,0,270.0,0,1,3,2,5,Fiji
2193,Chris James,0,165.0,0,1,1,1,2,Mexico
2194,Chris Killen,2,404.0,0,0,10,0,10,New Zealand
2195,Chris Lawler,0,74.0,0,0,1,0,1,England
2196,Chris Malonga,0,116.0,0,0,1,1,2,São Tomé and Príncipe
2197,Chris Martin,1,166.0,0,0,1,2,3,Gibraltar
2198,Chris McGrath,0,129.0,0,0,2,1,3,Netherlands
2199,Chris Megaloudis,0,32.0,0,0,1,0,1,Puerto Rico
2200,Chris Nicholl,0,23.0,0,0,1,1,2,Sweden
2201,Chris Nurse,0,149.0,0,0,1,1,2,Barbados
2202,Chris Sagramola,0,68.0,0,0,1,0,1,Luxembourg
2203,Chris Waddle,0,204.0,0,0,3,1,4,England
2204,Chris Wondolowski,0,241.0,0,0,5,0,5,United States
2205,Chris Wood,11,929.0,0,2,10,11,21,Papua New Guinea
2206,Chris Zoricich,1,90.0,0,0,1,0,1,New Zealand
2207,Christ Bongo,0,46.0,0,0,1,1,2,DR Congo
2208,Christian Annan,0,23.0,0,0,1,0,1,Hong Kong
2209,Christian Atsu,2,153.0,0,0,3,0,3,Ghana
2210,Christian Atsu Twasam,1,109.0,0,0,1,1,2,Ghana
2211,Christian Bassogog,3,262.0,0,0,1,2,3,Cameroon
2212,Christian Benteke,3,481.0,0,0,7,4,11,Serbia
2213,Christian Benítez,1,455.0,0,0,7,1,8,Ecuador
2214,Christian Bolaños,1,332.0,0,0,4,2,6,Honduras
2215,Christian Callejas,1,90.0,0,0,1,0,1,Uruguay
2216,Christian Chukwu,1,41.0,0,0,2,0,2,Nigeria
2217,Christian Coste,0,16.0,0,0,0,1,1,Belgium
2218,Christian Cueva,2,477.0,0,2,6,5,11,Brazil
2219,Christian Dailly,0,104.0,0,0,1,2,3,Iceland
2220,Christian Dalger,0,89.0,0,0,1,0,1,France
2221,Christian Eriksen,1,918.0,0,6,9,9,18,Iceland
2222,Christian Fassnacht,0,147.0,0,0,1,1,2,Gibraltar
2223,Christian Gytkjær,0,286.0,0,0,1,3,4,Switzerland
2224,Christian Holst,0,101.0,0,0,2,0,2,Faroe Islands
2225,Christian Høgni Jacobsen,0,78.0,0,0,0,1,1,Luxembourg
2226,Christian Javier Bautista,0,112.0,0,0,1,1,2,El Salvador
2227,Christian Karembeu,0,29.0,0,0,0,1,1,Romania
2228,Christian Lara,0,53.0,0,0,1,0,1,Ecuador
2229,Christian Lopez,1,23.0,0,0,1,0,1,France
2230,Christian M'Wokozhi,0,79.0,0,0,0,1,1,Tanzania
2231,Christian Matthey,0,54.0,0,0,1,0,1,Switzerland
2232,Christian Mayrleb,0,200.0,0,0,2,2,4,San Marino
2233,Christian Mouritsen,0,90.0,0,0,0,1,1,Slovenia
2234,Christian Noboa,1,209.0,0,0,3,0,3,Ecuador
2235,Christian Nørgaard,0,39.0,0,0,0,1,1,Moldova
2236,Christian Obodo,1,159.0,0,0,2,1,3,Algeria
2237,Christian Panucci,1,166.0,0,0,1,2,3,Estonia
2238,Christian Perez,0,3.0,0,0,0,1,1,Yugoslavia
2239,Christian Poulsen,0,231.0,0,0,3,1,4,Denmark
2240,Christian Pulisic,1,894.0,0,2,12,4,16,Saint Vincent and the Grenadines
2241,Christian Ramos,0,114.0,0,0,1,1,2,Paraguay
2242,Christian Santamaría,0,117.0,0,0,0,3,3,Saint Vincent and the Grenadines
2243,Christian Santos,0,64.0,0,0,0,1,1,Brazil
2244,Christian Stumpf,0,70.0,0,0,0,1,1,Northern Ireland
2245,Christian Vieri,9,679.0,0,0,15,3,18,Italy
2246,Christian Wilhelmsson,0,382.0,0,0,1,6,7,Iceland
2247,Christian Ziege,1,177.0,0,0,5,0,5,Germany
2248,Christoffer Nyman,0,24.0,0,0,0,1,1,Belarus
2249,Christoph Baumgartner,1,145.0,0,0,1,3,4,Austria
2250,Christoph Metzelder,0,20.0,1,0,0,1,1,Germany
2251,Christophe Berra,0,9.0,0,0,1,0,1,Scotland
2252,Christophe Bonvin,0,54.0,0,0,1,0,1,Switzerland
2253,Christophe Cocard,0,90.0,0,0,1,0,1,France
2254,Christophe Dugarry,1,215.0,0,0,3,3,6,France
2255,Christophe Jallet,0,68.0,0,0,1,0,1,France
2256,Christophe Ohrel,0,297.0,0,0,4,2,6,Switzerland
2257,Christopher Harry,0,82.0,0,1,1,0,1,Saint Vincent and the Grenadines
2258,Christopher Katongo,6,683.0,0,2,5,5,10,Zambia
2259,Christopher Samba,0,61.0,0,0,1,0,1,Congo
2260,Christopher Trimmel,0,22.0,0,0,1,0,1,Austria
2261,Christopher Wreh,0,51.0,0,0,2,0,2,Liberia
2262,Christos Aravidis,0,87.0,0,0,0,1,1,Northern Ireland
2263,Christos Ardizoglou,0,71.0,0,0,1,0,1,Greece
2264,Christos Kolliandris,0,57.0,0,0,1,1,2,Cyprus
2265,Christos Patsatzoglou,0,82.0,0,0,0,1,1,Bosnia and Herzegovina
2266,Chrysis Michael,0,93.0,0,1,1,1,2,Cyprus
2267,Chu Gyong-Sik,1,162.0,0,0,3,0,3,North Korea
2268,Chu Siu Kei,0,89.0,0,0,1,1,2,Malaysia
2269,Chu Wing Wah,0,59.0,0,1,1,0,1,Hong Kong
2270,Chuan Tan Teng,0,58.0,0,1,1,0,1,Singapore
2271,Chuang Yao-tsung,0,23.0,0,0,1,0,1,Taiwan
2272,Chun Keui Chiang,0,13.0,1,0,1,0,1,Australia
2273,Chung Chor Wai,2,231.0,0,1,3,1,4,Hong Kong
2274,Chung Hae-won,3,424.0,0,0,4,2,6,South Korea
2275,Chung Jong-Soo,0,41.0,0,0,1,0,1,South Korea
2276,Chung Kyu-Poong,0,235.0,0,0,3,0,3,South Korea
2277,Chung Kyung-ho,0,55.0,0,0,0,1,1,Kuwait
2278,Chung Nam-sik,0,42.0,0,0,0,2,2,Japan
2279,Chung Soon-cheon,0,183.0,0,0,2,2,4,South Korea
2280,Chung Yong-Hwan,0,1.0,0,0,1,0,1,South Korea
2281,Chuni Goswami,1,77.0,0,0,0,1,1,Hong Kong
2282,Chus Pereda,0,182.0,0,0,5,0,5,Spain
2283,Ché Adams,0,211.0,0,0,2,1,3,Scotland
2284,Chérif Fetoui,1,61.0,0,0,2,0,2,Morocco
2285,Chérif Oudjani,0,120.0,0,0,2,0,2,Algeria
2286,Chérif Souleymane,1,233.0,0,0,3,1,4,Guinea
2287,Chérif Touré Mamam,1,271.0,0,0,2,2,4,Mali
2288,Ciaran Clark,1,71.0,1,0,0,1,1,Republic of Ireland
2289,Cicerone Manolache,0,8.0,0,0,1,0,1,Romania
2290,Ciprian Deac,0,114.0,0,0,1,1,2,Denmark
2291,Ciprian Marica,0,765.0,0,3,11,6,17,Armenia
2292,Cipriano Co,0,60.0,0,1,1,0,1,Guinea-Bissau
2293,Ciriaco Sforza,0,298.0,0,0,3,2,5,Estonia
2294,Ciro Immobile,0,768.0,0,1,7,6,13,Israel
2295,Clarence Goodson,0,151.0,1,0,3,1,4,United States
2296,Clarence Seedorf,0,493.0,0,0,4,5,9,Netherlands
2297,Claude Barthélemy,0,44.0,0,0,0,1,1,El Salvador
2298,Claude Carrara,1,90.0,0,0,0,1,1,Fiji
2299,Claude Nahimana,0,107.0,0,0,1,1,2,Seychelles
2300,Claude Reiter,0,52.0,0,1,0,1,1,Russia
2301,Claudio Caniggia,7,635.0,0,0,8,4,12,Argentina
2302,Claudio Canti,0,29.0,1,0,1,0,1,Netherlands
2303,Claudio García,1,57.0,0,0,1,0,1,Argentina
2304,Claudio Gentile,0,8.0,0,0,0,1,1,Finland
2305,Claudio Husaín,0,89.0,0,0,0,1,1,Chile
2306,Claudio Jara,0,33.0,0,0,0,1,1,United States
2307,Claudio López,1,412.0,0,0,4,4,8,Colombia
2308,Claudio Marchisio,1,36.0,0,0,0,2,2,Serbia
2309,Claudio Pizarro,3,438.0,0,1,7,3,10,Peru
2310,Claudio Reyna,0,5.0,0,0,0,1,1,Canada
2311,Claudio Sulser,0,188.0,0,0,5,0,5,Switzerland
2312,Claudio Suárez,0,119.0,0,0,1,1,2,Saint Vincent and the Grenadines
2313,Claudiu Keșerü,0,514.0,0,0,4,5,9,Andorra
2314,Claus Bech Jørgensen,0,21.0,0,0,0,1,1,Cyprus
2315,Claus Jensen,0,128.0,0,0,1,3,4,Malta
2316,Claus Lundekvam,0,30.0,0,0,1,1,2,Norway
2317,Clayton Blackmore,0,71.0,0,0,1,0,1,Wales
2318,Clayton Donaldson,0,62.0,0,0,0,1,1,Haiti
2319,Clayton Failla,0,87.0,0,1,1,1,2,Malta
2320,Clayton Lewis,1,90.0,0,1,1,0,1,New Zealand
2321,Clayton Zane,6,366.0,0,0,4,2,6,Australia
2322,Cle Kooiman,0,103.0,0,0,1,0,1,United States
2323,Clemens Fritz,0,69.0,0,0,2,0,2,Germany
2324,Clement Temile,2,122.0,0,0,0,3,3,Malawi
2325,Clemente Rolón,0,97.0,0,0,2,0,2,Paraguay
2326,Cleon Wondel,1,44.0,0,0,0,1,1,Montserrat
2327,Clevon Hill,0,15.0,0,0,0,1,1,Montserrat
2328,Cliff Jones,0,145.0,0,1,3,0,3,Wales
2329,Cliff Magnam Valcin,0,204.0,0,0,1,2,3,Aruba
2330,Clifford Odame,0,72.0,0,1,1,0,1,Ghana
2331,Clifton Msiya,1,35.0,0,0,1,0,1,Malawi
2332,Clifton Sandvliet,0,178.0,0,0,3,1,4,Suriname
2333,Climaco Cañarte,0,74.0,0,0,1,0,1,Ecuador
2334,Clint Dempsey,7,1684.0,0,4,30,11,41,United States
2335,Clint Marcelle,1,59.0,0,0,1,0,1,Trinidad and Tobago
2336,Clint Mathis,0,174.0,0,0,0,3,3,Barbados
2337,Clinton Morrison,0,160.0,0,0,1,3,4,Russia
2338,Clinton N'Jie,1,69.0,0,0,1,1,2,Cameroon
2339,Clive Campbell,0,16.0,0,0,1,0,1,New Zealand
2340,Clive Murray,1,190.0,0,0,2,1,3,Grenada
2341,Clodoaldo,1,44.0,0,0,1,0,1,Brazil
2342,Cloudious Zviripayi,0,52.0,0,0,1,0,1,Zimbabwe
2343,Clyde Best,0,51.0,0,0,0,1,1,United States
2344,Cláudio Christovam de Pinho,2,303.0,0,1,5,0,5,Brazil
2345,Cláudio Ibrahim Vaz Leal,0,107.0,0,0,1,1,2,Venezuela
2346,Cléber Chalá,1,213.0,0,0,4,0,4,Ecuador
2347,Clément Lenglet,0,52.0,0,0,1,0,1,France
2348,Clésio,0,6.0,0,0,1,0,1,Mozambique
2349,Clésio Baúque,0,84.0,0,0,1,0,1,Mozambique
2350,Cobi Jones,1,436.0,0,0,3,3,6,United States
2351,Cody Gakpo,2,192.0,0,0,2,2,4,Netherlands
2352,Coen Dillen,0,72.0,0,0,1,0,1,Netherlands
2353,Coffi Agbessi,0,81.0,0,0,1,0,1,Benin
2354,Colin Bell,0,198.0,0,0,2,1,3,Wales
2355,Colin Bennett,0,85.0,0,0,0,1,1,Hong Kong
2356,Colin Calderwood,0,85.0,0,0,0,1,1,San Marino
2357,Colin Cameron,0,152.0,0,0,2,0,2,Scotland
2358,Colin Clarke,4,414.0,0,1,6,4,10,Northern Ireland
2359,Colin Curran,1,58.0,1,0,1,0,1,German DR
2360,Colin Hendry,0,129.0,0,0,2,1,3,Malta
2361,Colin Hill,0,44.0,0,0,0,1,1,Yugoslavia
2362,Colin Latimour,0,90.0,0,0,1,0,1,New Zealand
2363,Colin Miller,1,153.0,0,0,1,2,3,Jamaica
2364,Colin Murdock,0,58.0,0,0,1,0,1,Northern Ireland
2365,Colin Stein,0,269.0,0,0,4,2,6,Cyprus
2366,Colin Walker,0,214.0,0,1,4,0,4,New Zealand
2367,Collen Salelwako,0,72.0,0,0,1,0,1,Eswatini
2368,Collin Samuel,0,63.0,0,0,1,0,1,Trinidad and Tobago
2369,Collins Mbesuma,1,540.0,0,0,5,5,10,Congo
2370,Comlan Lambert Sossa,0,21.0,0,0,0,1,1,Ethiopia
2371,Commins Menapi,10,624.0,0,0,5,7,12,Solomon Islands
2372,Con Boutsianis,0,231.0,0,0,4,0,4,Australia
2373,Con Martin,0,173.0,0,2,3,0,3,Republic of Ireland
2374,Connor Roberts,1,179.0,0,0,1,1,2,Turkey
2375,Conny Torstensson,1,140.0,0,0,1,1,2,Sweden
2376,Conor Casey,0,121.0,0,0,0,2,2,Honduras
2377,Conor Hourihane,0,36.0,0,0,1,0,1,Republic of Ireland
2378,Conor McLaughlin,0,66.0,0,0,1,0,1,Northern Ireland
2379,Conor Washington,0,199.0,0,1,1,3,4,Northern Ireland
2380,Constantin Barbu,0,53.0,0,0,0,1,1,Liechtenstein
2381,Constantin Budescu,0,120.0,0,1,2,2,4,Faroe Islands
2382,Constantin Dinulescu,0,81.0,0,0,1,0,1,Romania
2383,Constantin Frățilă,0,213.0,0,0,3,2,5,Romania
2384,Constantin Gâlcă,0,182.0,0,0,3,0,3,Romania
2385,Constantin Pană,0,55.0,0,0,1,0,1,Romania
2386,Constantin Stanciu,1,79.0,0,0,0,1,1,Peru
2387,Constantinos Charalambides,0,277.0,0,0,6,0,6,Cyprus
2388,Constantinos Makrides,0,152.0,0,0,3,1,4,Cyprus
2389,Cor van der Gijp,0,57.0,0,0,2,0,2,Netherlands
2390,Cordell Cato,1,14.0,0,0,1,0,1,Trinidad and Tobago
2391,Corentin Tolisso,0,9.0,0,0,0,1,1,Albania
2392,Cornel Cacoveanu,0,67.0,0,0,1,0,1,Romania
2393,Cornel Dinu,0,85.0,0,0,1,0,1,Romania
2394,Cornelio Heredia,1,140.0,0,2,0,2,2,Bolivia
2395,Cornelius Casey,0,20.0,0,0,0,1,1,Haiti
2396,Cornelius Stewart,0,134.0,0,0,2,1,3,Saint Vincent and the Grenadines
2397,Cornell Glen,1,234.0,0,0,2,2,4,Trinidad and Tobago
2398,Corriolan Wadson,1,71.0,0,0,1,0,1,Haiti
2399,Corry Evans,0,70.0,0,0,0,1,1,Slovenia
2400,Cory Burke,1,14.0,0,0,0,1,1,Guadeloupe
2401,Cosme da Silva Campos,0,114.0,0,0,1,1,2,Brazil
2402,Cosmin Contra,0,522.0,1,0,3,5,8,Georgia
2403,Costa Khaiseb,0,89.0,0,0,1,0,1,Namibia
2404,Costakis Pierides,0,31.0,0,0,1,0,1,Cyprus
2405,Costas Costa,0,63.0,0,0,0,1,1,Austria
2406,Costas Fasouliotis,0,87.0,0,0,1,0,1,Cyprus
2407,Costin Lazăr,0,129.0,0,0,1,1,2,Romania
2408,Costinha,1,90.0,0,0,0,1,1,Romania
2409,Covi Adé,1,81.0,0,0,0,1,1,Mali
2410,Craig Beattie,0,89.0,0,0,1,0,1,Scotland
2411,Craig Bellamy,0,348.0,0,0,2,5,7,Denmark
2412,Craig Burley,1,87.0,0,0,2,0,2,Scotland
2413,Craig Cathcart,0,31.0,0,0,0,1,1,Finland
2414,Craig Foster,5,404.0,0,0,6,1,7,Australia
2415,Craig Goodwin,1,81.0,0,0,1,1,2,Australia
2416,Craig Mackail-Smith,0,32.0,0,0,0,1,1,Liechtenstein
2417,Craig Moore,1,38.0,0,1,0,1,1,Croatia
2418,Crescencio Gutiérrez,0,209.0,0,0,5,1,6,Mexico
2419,Cris,0,84.0,1,0,1,0,1,Argentina
2420,Cristhian Stuani,0,122.0,0,0,1,1,2,Uruguay
2421,Cristian Arrieta,0,4.0,0,0,1,0,1,Puerto Rico
2422,Cristian Brolli,0,85.0,3,0,2,1,3,San Marino
2423,Cristian Castillo,0,104.0,0,0,1,1,2,El Salvador
2424,Cristian Chivu,1,29.0,0,0,0,2,2,England
2425,Cristian Gamboa,0,85.0,1,0,2,1,3,Costa Rica
2426,Cristian Gil,0,31.0,0,0,1,0,1,El Salvador
2427,Cristian Gonzáles,0,90.0,0,0,4,0,4,Indonesia
2428,Cristian Manea,0,18.0,0,0,1,0,1,Romania
2429,Cristian Martínez,0,111.0,0,0,0,3,3,Republic of Ireland
2430,Cristian Montecinos,3,240.0,0,0,1,2,3,Ecuador
2431,Cristian Queliz,0,87.0,0,0,0,1,1,Aruba
2432,Cristian Ramírez,0,23.0,0,0,1,0,1,Ecuador
2433,Cristian Riveros,2,450.0,0,0,6,2,8,Paraguay
2434,Cristian Rodríguez,1,414.0,0,0,4,4,8,Argentina
2435,Cristian Romero,0,3.0,0,0,0,1,1,Colombia
2436,Cristian Tănase,0,112.0,0,0,1,1,2,Austria
2437,Cristian Zaccardo,1,105.0,1,0,1,1,2,Italy
2438,Cristiano Ronaldo,18,4901.0,0,16,50,41,91,Portugal
2439,Cristián Zapata,0,8.0,0,0,0,1,1,United States
2440,Cristóbal Parralo,0,5.0,0,0,1,0,1,Spain
2441,Csaba Vidáts,0,111.0,0,0,2,0,2,Hungary
2442,Cuauhtémoc Blanco,14,1983.0,0,11,23,11,34,Mexico
2443,Curtis Joseph,0,64.0,0,0,2,0,2,Saint Vincent and the Grenadines
2444,Custódio Pinto,0,19.0,0,0,0,1,1,Sweden
2445,Cuthbert Malajila,0,83.0,0,0,0,1,1,Namibia
2446,Cyle Larin,9,784.0,0,2,13,7,20,Dominica
2447,Cyril Mourgine,0,32.0,0,0,1,0,1,Mauritius
2448,Cyrille Bayala,1,25.0,0,0,1,0,1,Burkina Faso
2449,Cyrille Makanaky,0,78.0,0,0,0,1,1,Morocco
2450,Cyrille Mubiala Kitambala,0,21.0,0,0,1,0,1,DR Congo
2451,Cyrus Christie,1,27.0,0,0,0,1,1,Gibraltar
2452,Cédric Amissi,0,231.0,0,0,4,0,4,Burundi
2453,Cédric Bakambu,4,213.0,0,1,0,5,5,Tunisia
2454,Cédric Soares,1,86.0,0,0,1,0,1,Portugal
2455,Cédrick Fiston,1,54.0,0,0,1,0,1,Guadeloupe
2456,Célestin Oliver,0,17.0,0,0,2,0,2,France
2457,César Augusto Freire,1,47.0,0,0,0,1,1,Argentina
2458,César Azpilicueta,1,57.0,0,0,0,1,1,Croatia
2459,César Brito,0,22.0,0,0,1,0,1,Portugal
2460,César Cabrera,3,135.0,0,0,1,2,3,Ecuador
2461,César Cueto,1,151.0,0,0,3,0,3,Peru
2462,César Delgado,1,119.0,0,0,1,1,2,Venezuela
2463,César Eduardo González,1,120.0,0,1,2,0,2,Venezuela
2464,César García Peralta,0,41.0,0,0,0,1,1,Cayman Islands
2465,César Garnica,0,51.0,0,0,1,0,1,Ecuador
2466,César Larios,0,58.0,0,0,1,0,1,El Salvador
2467,César Lolohea,0,271.0,0,0,3,1,4,New Caledonia
2468,César López Fretes,4,234.0,0,0,2,2,4,Colombia
2469,César Martín,0,119.0,0,0,2,0,2,Spain
2470,César Obando,0,330.0,0,1,4,1,5,Honduras
2471,César Rostrán,0,65.0,0,0,0,1,1,El Salvador
2472,César Sampaio,3,107.0,0,0,3,1,4,Saudi Arabia
2473,César Socarraz,1,53.0,0,0,0,1,1,Argentina
2474,César Yanis,1,126.0,0,0,1,1,2,Panama
2475,César Zeoula,1,38.0,0,1,1,0,1,New Caledonia
2476,Cătălin Carp,0,29.0,0,0,1,0,1,Moldova
2477,Cătălin Munteanu,0,30.0,0,0,1,0,1,Romania
2478,D'Andre Bishop,1,45.0,0,0,1,0,1,Antigua and Barbuda
2479,DaMarcus Beasley,1,755.0,0,0,11,2,13,United States
2480,Daan Schrijvers,0,48.0,0,1,1,0,1,Netherlands
2481,Dadley Fichite,0,105.0,0,0,0,2,2,Libya
2482,Dado Pršo,1,351.0,0,0,7,1,8,Croatia
2483,Dag Szepanski,0,57.0,0,1,1,0,1,Sweden
2484,Dagne Tesfaye,0,37.0,0,0,1,0,1,Ethiopia
2485,Dagoberto Moll,2,107.0,0,0,0,2,2,Bolivia
2486,Dahi Al Naemi,1,151.0,0,0,2,2,4,China PR
2487,Dahiru Sadi,0,18.0,0,0,1,0,1,Nigeria
2488,Dahmed Ould Teguedi,0,68.0,0,0,0,1,1,Morocco
2489,Dai Davies,0,24.0,1,0,1,0,1,Czechoslovakia
2490,Daichi Kamada,0,192.0,0,0,3,0,3,Japan
2491,Dairon Reyes,1,90.0,0,0,1,0,1,Cuba
2492,Daizen Maeda,1,43.0,0,0,1,0,1,Japan
2493,Dale Mitchell,3,389.0,0,0,4,2,6,Canada
2494,Daler Kuzyayev,0,3.0,0,0,0,1,1,San Marino
2495,Daley Blind,1,62.0,0,0,1,1,2,Brazil
2496,Dalibor Stevanović,0,68.0,0,0,0,1,1,San Marino
2497,Dalton Eiley,1,49.0,1,0,1,0,1,Costa Rica
2498,Damani Horton,0,66.0,0,0,1,0,1,Bahamas
2499,Damani Ralph,0,77.0,0,0,1,0,1,Jamaica
2500,Dame N'Doye,1,144.0,0,0,2,0,2,Senegal
2501,Damian Kądzior,0,84.0,0,0,1,0,1,Poland
2502,Damian Mori,5,928.0,0,0,23,2,25,Tahiti
2503,Damian Szymański,0,90.0,0,0,1,0,1,Poland
2504,Damien Duff,1,140.0,0,0,1,2,3,Saudi Arabia
2505,Damien Kamilou,0,90.0,0,0,0,1,1,Ghana
2506,Damion Lowe,0,56.0,0,0,1,0,1,Jamaica
2507,Damion Stewart,1,45.0,0,0,1,0,1,Jamaica
2508,Damir Desnica,0,90.0,0,0,0,1,1,Romania
2509,Damir Kojašević,0,36.0,0,0,0,1,1,Armenia
2510,Damián Ariel Álvarez,0,89.0,0,0,0,1,1,Saint Vincent and the Grenadines
2511,Damon Ming,0,151.0,0,0,3,1,4,Bermuda
2512,Dan Brzokoupil,0,61.0,0,0,0,1,1,Republic of Ireland
2513,Dan Coe,0,23.0,0,0,0,1,1,Czechoslovakia
2514,Dan Corneliusson,0,215.0,0,0,4,2,6,Cyprus
2515,Dan Eggen,1,126.0,0,0,1,1,2,Norway
2516,Dan Einbinder,0,66.0,0,0,0,1,1,Albania
2517,Dan Petrescu,1,485.0,0,0,6,2,8,Romania
2518,Dan Wagalauka,0,75.0,0,0,1,0,1,Uganda
2519,Dane Richards,0,165.0,0,0,2,0,2,Jamaica
2520,Dangelo Bautista,0,62.0,1,0,1,0,1,Canada
2521,Dango Ouattara,1,45.0,0,0,1,0,1,Burkina Faso
2522,Dani Alves,1,312.0,0,0,2,3,5,Brazil
2523,Dani Güiza,2,338.0,0,0,0,4,4,Greece
2524,Dani Olmo,1,204.0,0,0,3,1,4,Spain
2525,Dani Osvaldo,0,186.0,0,0,0,4,4,Bulgaria
2526,Daniar Kenzhekhanov,0,23.0,0,0,1,0,1,Kazakhstan
2527,Daniel Addo,0,64.0,0,0,1,0,1,Ghana
2528,Daniel Agger,1,304.0,1,5,6,1,7,Denmark
2529,Daniel Alejandro Lembo,1,22.0,0,0,1,0,1,Uruguay
2530,Daniel Amokachi,4,598.0,0,0,7,3,10,Nigeria
2531,Daniel Anyanzwa,0,44.0,0,0,1,0,1,Kenya
2532,Daniel Arismendi,0,139.0,0,0,3,0,3,Venezuela
2533,Daniel Arudhi Nicodémus,1,60.0,0,0,1,0,1,Kenya
2534,Daniel Ballard,0,20.0,0,0,0,1,1,Lithuania
2535,Daniel Batista Lima,0,125.0,0,0,2,0,2,Greece
2536,Daniel Bertoni,2,278.0,0,0,4,0,4,Argentina
2537,Daniel Borimirov,1,132.0,0,0,3,0,3,Bulgaria
2538,Daniel Braaten,0,87.0,0,0,2,0,2,Norway
2539,Daniel Chitsulo,0,47.0,0,0,1,1,2,Malawi
2540,Daniel Cousin,1,297.0,0,0,3,2,5,Gabon
2541,Daniel Díaz,0,56.0,0,0,1,0,1,Argentina
2542,Daniel Ebomoa,0,19.0,0,0,0,1,1,Cameroon
2543,Daniel Fonseca,1,258.0,0,0,4,1,5,South Korea
2544,Daniel Gygax,0,84.0,0,0,0,1,1,Cyprus
2545,Daniel Hasler,0,123.0,1,0,0,2,2,Northern Ireland
2546,Daniel Imbert,2,228.0,0,0,2,2,4,Mauritius
2547,Daniel James,0,156.0,0,0,2,1,3,Wales
2548,Daniel Jeandupeux,0,10.0,0,0,1,0,1,Switzerland
2549,Daniel Jensen,0,119.0,0,0,0,2,2,Liechtenstein
2550,Daniel Jimenez,1,23.0,0,0,1,0,1,Belize
2551,Daniel Johnson,0,50.0,0,0,1,0,1,Jamaica
2552,Daniel Kaufmann,0,20.0,1,0,1,0,1,Germany
2553,Daniel Killer,0,111.0,0,0,3,0,3,Argentina
2554,Daniel Kolář,0,90.0,0,0,0,1,1,Armenia
2555,Daniel Majstorović,0,52.0,0,0,1,0,1,Sweden
2556,Daniel Niculae,0,127.0,0,0,2,0,2,Romania
2557,Daniel Noriega,0,45.0,0,0,1,1,2,Uruguay
2558,Daniel O'Shaughnessy,0,73.0,0,0,0,1,1,Bosnia and Herzegovina
2559,Daniel Osorno,3,360.0,0,0,4,2,6,Mexico
2560,Daniel Pancu,0,215.0,0,0,2,3,5,Romania
2561,Daniel Passarella,2,231.0,0,2,4,2,6,Argentina
2562,Daniel Pinto,1,166.0,0,0,1,1,2,Brunei
2563,Daniel Prodan,0,82.0,0,0,1,0,1,Romania
2564,Daniel Pudil,0,79.0,0,0,0,2,2,Cyprus
2565,Daniel Reyes,0,88.0,0,0,0,1,1,Panama
2566,Daniel Ruiz,2,198.0,0,1,1,3,4,Austria
2567,Daniel Shepherd,1,55.0,0,0,0,1,1,Solomon Islands
2568,Daniel Sjölund,0,53.0,0,0,1,0,1,Finland
2569,Daniel Sosah,0,114.0,0,0,1,1,2,Algeria
2570,Daniel Sturridge,2,339.0,0,1,5,1,6,San Marino
2571,Daniel Ulloa,0,49.0,1,0,0,1,1,Peru
2572,Daniel Van Buyten,0,465.0,0,0,1,6,7,Scotland
2573,Daniel Velasquez,0,3.0,0,0,0,1,1,Saint Vincent and the Grenadines
2574,Daniel Veyt,1,59.0,0,0,0,1,1,Paraguay
2575,Daniel Wass,0,14.0,0,0,1,0,1,Denmark
2576,Daniel Xuereb,0,44.0,0,0,0,1,1,Cyprus
2577,Daniel da Mota,0,159.0,0,0,2,1,3,Luxembourg
2578,Daniel Šmejkal,0,5.0,0,1,1,0,1,Czech Republic
2579,Daniele De Rossi,4,621.0,0,3,11,4,15,Italy
2580,Daniele Massaro,1,48.0,0,0,1,0,1,Italy
2581,Danijel Ljuboja,0,88.0,0,0,0,1,1,Wales
2582,Danijel Pranjić,0,90.0,0,0,1,0,1,Croatia
2583,Danilo Alvim,0,79.0,0,0,1,0,1,Brazil
2584,Danilo Menezes,0,61.0,0,0,1,0,1,Uruguay
2585,Danilo Montero Campos,1,108.0,0,0,0,2,2,Guatemala
2586,Danilo Pereira,0,42.0,0,0,1,0,1,Portugal
2587,Danilo Popivoda,0,76.0,0,0,2,0,2,Yugoslavia
2588,Danilo Turcios,1,264.0,0,0,3,2,5,El Salvador
2589,Danival,0,132.0,0,0,1,2,3,Venezuela
2590,Danko Lazović,0,301.0,0,0,2,3,5,Poland
2591,Danny,0,140.0,0,0,1,1,2,Portugal
2592,Danny Blind,0,87.0,0,0,0,1,1,Greece
2593,Danny Halligan,0,200.0,0,1,2,1,3,New Zealand
2594,Danny Hay,1,88.0,0,0,1,0,1,New Zealand
2595,Danny Koevermans,0,43.0,0,0,1,0,1,Netherlands
2596,Danny Moulis,2,270.0,0,0,2,1,3,New Caledonia
2597,Danny Mrwanda,0,148.0,0,0,1,1,2,Tanzania
2598,Danny Tiatto,1,24.0,0,0,1,0,1,Australia
2599,Danny Wabo,0,37.0,0,0,1,0,1,Solomon Islands
2600,Danny Ward,0,49.0,1,0,1,0,1,Czech Republic
2601,Danny Welbeck,1,752.0,0,0,8,4,12,Sweden
2602,Dante,0,45.0,0,0,1,0,1,Brazil
2603,Dante Leverock,2,106.0,0,0,1,2,3,Bahamas
2604,Danylo Sikan,0,90.0,0,0,0,1,1,Kazakhstan
2605,Daoud Midtadi,0,6.0,0,0,0,1,1,Madagascar
2606,Dare Vršič,0,135.0,0,0,2,0,2,Slovenia
2607,Darijo Srna,2,538.0,0,2,8,5,13,Croatia
2608,Darimosuvito Devaraj,0,121.0,0,0,2,0,2,Singapore
2609,Darimosuvito Tokijan,0,125.0,0,0,4,0,4,Singapore
2610,Dario Khan,2,67.0,2,0,1,1,2,Mozambique
2611,Dario Pereyra,0,72.0,0,0,2,0,2,Uruguay
2612,Dario Sierra,0,40.0,1,0,0,1,1,Aruba
2613,Dario Zuffi,0,64.0,0,0,0,1,1,Portugal
2614,Dario Đumić,0,82.0,0,0,1,0,1,Bosnia and Herzegovina
2615,Dario Šimić,0,91.0,0,0,0,2,2,Malta
2616,Darius Maciulevičius,0,129.0,0,0,2,2,4,Estonia
2617,Darius Miceika,0,85.0,0,0,1,0,1,Lithuania
2618,Darius Vassell,0,75.0,0,0,1,0,1,England
2619,Dariusz Adamczuk,0,36.0,0,0,1,0,1,Poland
2620,Dariusz Dudka,0,6.0,0,0,1,0,1,Poland
2621,Dariusz Dziekanowski,0,427.0,0,0,6,3,9,Poland
2622,Dariusz Marciniak,0,26.0,0,0,0,1,1,Hungary
2623,Darko Churlinov,0,83.0,0,0,0,1,1,Liechtenstein
2624,Darko Kovačević,1,129.0,0,0,2,0,2,Serbia
2625,Darko Maletić,0,90.0,0,0,1,0,1,Bosnia and Herzegovina
2626,Darko Pančev,3,651.0,0,0,11,2,13,Cyprus
2627,Darko Velkovski,0,205.0,2,0,2,3,5,Spain
2628,Darren Anderton,1,20.0,0,0,0,1,1,Colombia
2629,Darren Bent,0,134.0,0,0,0,3,3,Switzerland
2630,Darren Debono,0,37.0,1,0,1,0,1,Slovenia
2631,Darren Fletcher,0,163.0,0,0,3,1,4,Scotland
2632,Darren Jackson,0,80.0,0,0,0,1,1,Latvia
2633,Darren Mattocks,4,401.0,0,2,4,3,7,United States
2634,Darren McClennan,0,297.0,0,0,6,2,8,New Zealand
2635,Darren O'Dea,0,88.0,0,0,0,1,1,Faroe Islands
2636,Darryl Gomez,0,16.0,0,0,1,0,1,Saint Kitts and Nevis
2637,Darryl Lachman,0,41.0,0,0,0,1,1,Montserrat
2638,Darryl Roberts,0,76.0,0,0,0,2,2,Bermuda
2639,Darvydas Šernas,0,166.0,0,1,1,3,4,Czech Republic
2640,Darwin Cerén,0,157.0,0,1,1,2,3,El Salvador
2641,Darwin Lom,1,23.0,0,0,1,1,2,British Virgin Islands
2642,Darwin Machís,2,209.0,0,0,3,2,5,Bolivia
2643,Darwin Núñez,0,73.0,0,0,0,1,1,Colombia
2644,Daryl Dike,0,73.0,0,0,2,0,2,United States
2645,Daryl Ferguson,0,86.0,1,0,1,0,1,United States
2646,Daryl Murphy,0,101.0,0,0,2,1,3,Serbia
2647,Darío Franco,2,40.0,0,0,2,0,2,Argentina
2648,Darío Lezcano,0,198.0,0,0,2,2,4,Paraguay
2649,Darío Muchotrigo,0,22.0,0,0,1,0,1,Peru
2650,Darío Rodríguez,1,137.0,0,0,3,0,3,Uruguay
2651,Darío Silva,4,445.0,0,0,7,5,12,Paraguay
2652,Darío Verón,0,57.0,0,0,1,0,1,Paraguay
2653,Datsakorn Thonglao,0,327.0,0,0,1,4,5,Thailand
2654,Dave Bowen,0,63.0,0,0,0,1,1,Israel
2655,Dave Clements,0,69.0,0,0,1,0,1,Northern Ireland
2656,Dave Gibson,0,42.0,0,0,1,0,1,Scotland
2657,Dave Mitchell,0,449.0,0,0,7,1,8,Australia
2658,Dave Taylor,0,222.0,0,0,3,0,3,New Zealand
2659,Davi Banda,1,48.0,0,0,1,0,1,Malawi
2660,David Abdul,0,85.0,0,0,1,0,1,Aruba
2661,David Alaba,0,510.0,0,5,6,5,11,Austria
2662,David Arellano,1,382.0,0,0,8,0,8,Chile
2663,David Ayo,0,90.0,0,0,1,0,1,Cameroon
2664,David Beckham,3,780.0,0,3,7,6,13,Colombia
2665,David Ben Dayan,0,65.0,0,0,1,0,1,Israel
2666,David Brooks,0,77.0,0,0,0,1,1,Croatia
2667,David Carabott,1,273.0,0,2,1,4,5,Belarus
2668,David Carney,1,153.0,0,0,1,1,2,Australia
2669,David Connolly,0,179.0,0,0,4,1,5,Republic of Ireland
2670,David Cotterill,0,13.0,0,0,1,0,1,Wales
2671,David Edgar,0,168.0,0,0,2,0,2,Canada
2672,David Edwards,0,84.0,0,0,1,1,2,Wales
2673,David Embé,1,76.0,0,0,1,1,2,Guinea
2674,David Firisua,1,84.0,0,0,1,0,1,Solomon Islands
2675,David Fleurival,2,80.0,0,0,0,2,2,Canada
2676,David Giles,0,63.0,0,0,1,1,2,Iceland
2677,David Ginola,0,85.0,0,0,2,0,2,France
2678,David Goodwillie,0,66.0,0,1,0,1,1,Spain
2679,David Healy,0,1175.0,0,3,15,7,22,Northern Ireland
2680,David Henry,0,61.0,0,0,0,1,1,Antigua and Barbuda
2681,David Herd,0,144.0,0,0,2,0,2,Scotland
2682,David Hopkin,0,142.0,0,0,2,0,2,Scotland
2683,David Jarolím,0,49.0,0,0,1,0,1,Czech Republic
2684,David Kelly,0,78.0,0,0,0,1,1,North Macedonia
2685,David Kipiani,1,165.0,0,0,1,1,2,Russia
2686,David Lafata,0,242.0,0,0,2,2,4,Czech Republic
2687,David Limberský,0,13.0,0,0,0,1,1,Latvia
2688,David Lowery,0,31.0,0,0,1,0,1,Turks and Caicos Islands
2689,David Luiz,0,87.0,0,0,2,0,2,Brazil
2690,David Martínez,0,7.0,0,0,1,0,1,Paraguay
2691,David McCaulay,0,28.0,0,0,1,0,1,Belize
2692,David McGoldrick,0,85.0,0,0,1,0,1,Republic of Ireland
2693,David Muchineripi,0,29.0,0,0,1,0,1,Zimbabwe
2694,David Mulligan,0,188.0,0,0,2,1,3,Vanuatu
2695,David Nakhid,1,52.0,0,0,1,0,1,Trinidad and Tobago
2696,David Narey,1,18.0,0,0,0,1,1,Brazil
2697,David Nugent,1,90.0,0,0,0,1,1,Andorra
2698,David Nyathi,1,79.0,0,0,0,1,1,Morocco
2699,David O'Leary,0,40.0,0,0,1,0,1,Republic of Ireland
2700,David Obua,0,328.0,0,1,2,3,5,Uganda
2701,David Ospina,0,77.0,1,0,1,0,1,Peru
2702,David Oteo,0,59.0,0,0,1,0,1,Mexico
2703,David Owino,0,6.0,0,0,1,0,1,Kenya
2704,David Paniagua,0,46.0,0,0,0,1,1,Peru
2705,David Patiño,2,63.0,0,0,0,2,2,Argentina
2706,David Phillips,0,63.0,0,0,1,0,1,Wales
2707,David Platt,2,568.0,0,0,7,5,12,England
2708,David Powell,0,83.0,0,0,1,0,1,Wales
2709,David Provan,0,54.0,0,0,1,0,1,Scotland
2710,David Ramírez,2,120.0,0,0,2,0,2,Costa Rica
2711,David Ratcliffe,0,32.0,0,0,1,0,1,Australia
2712,David Rugamas,1,398.0,0,0,2,6,8,El Salvador
2713,David Silva,5,916.0,0,0,13,7,20,Russia
2714,David Siradze,0,340.0,0,0,4,1,5,Georgia
2715,David Stokes,0,30.0,0,0,1,0,1,Guatemala
2716,David Strelec,0,123.0,0,0,2,0,2,Slovakia
2717,David Suazo,2,569.0,0,0,6,5,11,El Salvador
2718,David Targamadze,0,19.0,0,0,1,0,1,Georgia
2719,David Trezeguet,3,763.0,0,0,9,5,14,France
2720,David Turpel,0,219.0,0,0,2,2,4,North Macedonia
2721,David Vaughan,0,16.0,0,0,0,1,1,Liechtenstein
2722,David Villa,18,2063.0,0,4,26,15,41,Slovakia
2723,David Watson,0,111.0,0,0,2,1,3,England
2724,David Weir,0,53.0,0,0,1,0,1,Scotland
2725,David Wotherspoon,1,25.0,0,0,0,1,1,Cayman Islands
2726,David Zdrilic,2,908.0,0,0,17,0,17,Australia
2727,David Zeman,0,16.0,1,0,1,0,1,Israel
2728,Davide Astori,1,24.0,0,0,0,1,1,Uruguay
2729,Davide Gualtieri,1,1.0,0,0,1,0,1,San Marino
2730,Davide Simoncini,0,24.0,2,0,2,0,2,Sweden
2731,Davie Cooper,0,195.0,0,2,3,1,4,Wales
2732,Davie Wilson,0,37.0,0,0,0,1,1,Finland
2733,Davit Janashia,0,66.0,0,0,0,1,1,Moldova
2734,Davit Mujiri,0,16.0,0,0,0,1,1,Faroe Islands
2735,Davor Jozić,2,130.0,0,0,1,1,2,Germany
2736,Davor Vugrinec,0,319.0,0,0,2,2,4,Malta
2737,Davor Šuker,8,1774.0,0,6,15,17,32,Yugoslavia
2738,Davron Ergashev,0,81.0,0,0,0,1,1,Mongolia
2739,Davy Arnaud,0,6.0,0,0,1,0,1,United States
2740,Davy Klaassen,1,278.0,0,0,2,4,6,Netherlands
2741,Davy Pröpper,0,112.0,0,0,2,1,3,Netherlands
2742,Davy Walsh,0,92.0,0,0,1,1,2,Sweden
2743,Dawa Hotessa,0,4.0,0,0,0,1,1,Cameroon
2744,Dawit Fekadu,0,83.0,0,0,2,0,2,Ethiopia
2745,Dawood Ali,0,54.0,0,0,1,0,1,United Arab Emirates
2746,Dayro Moreno,0,82.0,0,0,1,0,1,Colombia
2747,Dean Furman,0,125.0,0,0,1,1,2,South Africa
2748,Dean Saunders,0,637.0,0,1,8,7,15,Wales
2749,Dean Shiels,0,14.0,0,0,1,0,1,Northern Ireland
2750,Debatik Curri,0,67.0,0,0,0,1,1,Netherlands
2751,Declan Edge,0,13.0,0,0,1,0,1,New Zealand
2752,Declan Rice,0,87.0,0,0,0,1,1,Hungary
2753,Deco,2,202.0,0,1,3,1,4,Portugal
2754,Dede Sulaiman,0,248.0,0,0,3,1,4,Indonesia
2755,Deepak Amatya,1,19.0,0,0,0,1,1,Macau
2756,Deepak Lama,1,67.0,0,0,0,1,1,Macau
2757,Deividas Česnauskis,0,41.0,0,0,0,1,1,San Marino
2758,Deivydas Matulevičius,0,67.0,0,0,1,2,3,Latvia
2759,Dejan Damjanović,0,409.0,0,1,1,6,7,Cyprus
2760,Dejan Govedarica,1,101.0,1,0,2,0,2,Serbia
2761,Dejan Jakovic,1,28.0,0,0,0,1,1,French Guiana
2762,Dejan Lazarević,0,73.0,0,0,1,0,1,Slovenia
2763,Dejan Ljubičić,0,83.0,0,0,1,0,1,Austria
2764,Dejan Lovren,0,234.0,0,0,0,3,3,Malta
2765,Dejan Savićević,6,642.0,0,1,10,4,14,Yugoslavia
2766,Dejan Stanković,2,338.0,0,1,3,6,9,Republic of Ireland
2767,Dejo Fayemi,0,125.0,0,1,1,1,2,Ghana
2768,Dejvi Glavevski,0,80.0,0,0,0,3,3,Liechtenstein
2769,Dele Alli,1,97.0,0,0,1,1,2,England
2770,Delfín Benítez Cáceres,1,44.0,0,0,0,1,1,Bolivia
2771,"Delio ""Maravilla"" Gamboa",3,122.0,0,1,2,1,3,Argentina
2772,Delio Gamboa,2,238.0,0,0,1,2,3,Brazil
2773,Delio Toledo,0,10.0,0,0,1,0,1,Paraguay
2774,Delron Buckley,0,102.0,0,0,0,3,3,Zimbabwe
2775,Delvin N'Dinga,0,75.0,0,0,0,1,1,Ethiopia
2776,Demar Phillips,3,300.0,0,0,6,0,6,Jamaica
2777,Demba Camara,0,23.0,0,0,1,0,1,Guinea
2778,Demba Malick,0,45.0,0,0,0,1,1,Madagascar
2779,Deme N'Diaye,1,10.0,0,0,0,1,1,Libya
2780,Demetrio Albertini,0,88.0,0,0,1,1,2,Italy
2781,Demetrio Angola,1,75.0,0,0,0,1,1,Argentina
2782,Demetrio Neyra,0,31.0,0,0,1,0,1,Peru
2783,Demetris Christofi,0,326.0,0,1,3,2,5,Cyprus
2784,Demis Nikolaidis,0,359.0,0,0,5,3,8,Finland
2785,Demont Mitchell,0,52.0,0,0,1,0,1,Bahamas
2786,Demóstenes Correia de Syllos,1,29.0,0,0,1,0,1,Brazil
2787,Deng Chyan,0,90.0,0,0,1,0,1,Taiwan
2788,Deng Zhuoxiang,1,216.0,0,0,0,3,3,Kuwait
2789,Deni Milošević,0,80.0,0,0,1,0,1,Bosnia and Herzegovina
2790,Denijal Pirić,0,60.0,0,0,0,1,1,Finland
2791,Denil Maldonado,0,10.0,1,0,0,1,1,Honduras
2792,Denis Calincov,0,90.0,0,0,0,1,1,Israel
2793,Denis Caniza,0,19.0,1,0,1,0,1,Chile
2794,Denis Cheryshev,0,425.0,1,0,4,6,10,Russia
2795,Denis Glushakov,1,258.0,0,0,3,1,4,Russia
2796,Denis Houf,0,16.0,0,0,0,1,1,France
2797,Denis Irwin,0,11.0,0,1,2,0,2,Republic of Ireland
2798,Denis Knitel,1,20.0,0,0,1,0,1,Tajikistan
2799,Denis Kovba,0,18.0,0,0,1,0,1,Belarus
2800,Denis Law,0,344.0,0,0,4,3,7,Scotland
2801,Denis Obua,2,185.0,0,0,0,3,3,Ivory Coast
2802,Denis Zakaria,1,125.0,1,0,1,2,3,Georgia
2803,Denis Zmeu,0,30.0,0,0,1,0,1,Moldova
2804,Deniss Ivanovs,0,71.0,0,0,0,1,1,Switzerland
2805,Deniz Bozkurt,0,16.0,0,0,1,0,1,Puerto Rico
2806,Deniz Türüç,0,57.0,0,0,0,1,1,Moldova
2807,Denmark Casey,0,60.0,0,0,0,1,1,Panama
2808,Dennis Alas,1,81.0,0,0,1,0,1,El Salvador
2809,Dennis Bergkamp,10,1398.0,0,1,15,12,27,Netherlands
2810,Dennis Bryce,0,12.0,0,0,1,0,1,Samoa
2811,Dennis Lawrence,0,120.0,0,0,1,1,2,Trinidad and Tobago
2812,Dennis Lota,4,297.0,0,0,5,2,7,Burkina Faso
2813,Dennis López,0,123.0,0,0,1,1,2,Guatemala
2814,Dennis Man,0,145.0,0,0,0,3,3,Malta
2815,Dennis Marshall,1,56.0,0,0,1,0,1,Costa Rica
2816,Dennis Mizzi,0,23.0,0,0,0,1,1,Portugal
2817,Dennis Oliech,1,694.0,0,0,11,5,16,Kenya
2818,Dennis Praet,1,82.0,0,0,1,1,2,Belgium
2819,Dennis Purperhart,0,14.0,0,0,1,0,1,Suriname
2820,Dennis Rennie,0,90.0,0,0,1,0,1,Grenada
2821,Dennis Rommedahl,2,488.0,0,0,4,11,15,Northern Ireland
2822,Dennis Salanović,0,85.0,0,0,0,1,1,Greece
2823,Dennis Tindall,0,50.0,0,0,0,1,1,Australia
2824,Dennis Tueart,0,4.0,0,0,1,0,1,England
2825,Dennis Viollet,0,37.0,0,0,1,0,1,England
2826,Dennis Wilshaw,0,163.0,0,0,0,3,3,Wales
2827,Dennis Wise,0,32.0,0,0,0,1,1,Turkey
2828,Densill Theobald,0,73.0,0,0,1,0,1,Trinidad and Tobago
2829,Denys Harmash,0,108.0,0,0,1,1,2,Montenegro
2830,Denzel Dumfries,1,281.0,0,0,4,0,4,Netherlands
2831,Denílson de Oliveira Araújo,4,277.0,0,0,4,1,5,Brazil
2832,Denís Milar,0,116.0,0,1,2,0,2,Uruguay
2833,Deon Burton,0,439.0,0,0,5,3,8,Jamaica
2834,Deon Kavendji,0,77.0,0,0,1,0,1,Namibia
2835,Deon McCaulay,7,962.0,0,1,8,10,18,Belize
2836,Derby Makinka,0,98.0,0,0,2,0,2,Zambia
2837,Dereck Somanje,0,53.0,0,0,1,0,1,Malawi
2838,Derek Dougan,0,139.0,0,0,2,2,4,Poland
2839,Derek Kevan,2,140.0,0,0,1,1,2,England
2840,Derek Malas,1,137.0,0,0,2,0,2,Vanuatu
2841,Derek Spence,0,151.0,0,0,1,1,2,Netherlands
2842,Derlis González,2,229.0,0,1,1,3,4,Brazil
2843,Derlis Soto,0,165.0,0,0,2,0,2,Paraguay
2844,Dermot Curtis,0,144.0,0,0,1,2,3,Republic of Ireland
2845,Derrick Edwards,0,328.0,0,0,4,2,6,Antigua and Barbuda
2846,Derrick Etienne,0,63.0,0,0,1,0,1,Haiti
2847,Derrik Garden,0,81.0,1,0,1,0,1,El Salvador
2848,Des Palmer,0,155.0,0,0,3,0,3,Wales
2849,Deshawon Nembhard,1,81.0,0,0,1,0,1,Belize
2850,Desiderio Medina,0,59.0,0,0,3,0,3,Chile
2851,Desmond Armstrong,0,31.0,1,0,1,0,1,Mexico
2852,Desmond Bleau,0,60.0,0,0,0,1,1,Guatemala
2853,Desmond Fa'aiuaso,5,254.0,0,0,1,4,5,American Samoa
2854,Devarr Boyles,0,6.0,0,0,1,0,1,Bermuda
2855,Devaughn Elliott,0,44.0,0,0,0,1,1,Saint Lucia
2856,Devaun DeGraff,0,43.0,0,0,0,2,2,Cayman Islands
2857,Dever Orgill,0,56.0,0,0,2,0,2,Jamaica
2858,Devi Muka,0,90.0,0,0,1,0,1,Albania
2859,Devin Vega,0,62.0,0,0,1,0,1,Puerto Rico
2860,Devon Jarrett,2,117.0,0,0,1,1,2,Honduras
2861,Dewan Chand,2,49.0,0,0,2,0,2,Fiji
2862,Dexter Blackstock,0,25.0,0,0,1,0,1,Antigua and Barbuda
2863,Dexter Walker,0,88.0,0,0,1,0,1,Mexico
2864,Dezső Molnár,0,70.0,0,0,0,1,1,Netherlands
2865,Dezső Novák,2,270.0,0,1,3,0,3,Hungary
2866,Dhurgham Ismail,1,135.0,0,1,0,2,2,Iran
2867,Diadie Samassékou,1,60.0,0,0,0,1,1,Tunisia
2868,Diafra Sakho,0,93.0,0,0,0,2,2,Cape Verde
2869,Diamantino Miranda,1,151.0,0,0,3,0,3,Portugal
2870,Dick Kauma,1,89.0,0,0,0,1,1,Tahiti
2871,Dick Nanninga,0,300.0,0,0,1,3,4,Argentina
2872,Dick Schneider,0,48.0,0,1,1,0,1,Netherlands
2873,Dick Schoenaker,2,251.0,0,0,3,3,6,Iceland
2874,Dick van Dijk,0,35.0,0,0,1,0,1,Netherlands
2875,Dickson Makwaza,0,83.0,0,0,1,0,1,Zambia
2876,Didargylyç Urazow,0,90.0,0,0,1,0,1,Turkmenistan
2877,Didi,13,761.0,0,1,12,2,14,Brazil
2878,Didi Torrico,0,87.0,0,0,1,0,1,Bolivia
2879,Didier Deschamps,0,51.0,0,0,2,0,2,France
2880,Didier Drogba,11,1529.0,0,6,20,11,31,Ivory Coast
2881,Didier Six,2,401.0,0,0,5,2,7,France
2882,Didier Ya Konan,1,90.0,0,0,1,0,1,Ivory Coast
2883,Didier Zokora,0,21.0,0,0,1,0,1,Ivory Coast
2884,Diego,1,184.0,0,1,1,1,2,Brazil
2885,Diego Antonio Reyes,1,38.0,0,0,1,0,1,Mexico
2886,Diego Bejarano,0,105.0,0,0,1,1,2,Peru
2887,Diego Calvo,0,82.0,0,0,1,0,1,Costa Rica
2888,Diego Costa,3,411.0,0,0,3,6,9,Luxembourg
2889,Diego Forlán,9,1436.0,0,3,16,12,28,Senegal
2890,Diego Fuser,1,29.0,0,0,1,1,2,Wales
2891,Diego García,1,107.0,0,0,1,1,2,Argentina
2892,Diego Gavilán,0,77.0,0,0,0,1,1,Colombia
2893,Diego Godín,2,400.0,2,0,2,5,7,Uruguay
2894,Diego Latorre,1,3.0,0,0,1,0,1,Argentina
2895,Diego Lugano,1,245.0,0,0,4,3,7,Uruguay
2896,Diego Maradona,8,812.0,0,1,12,3,15,Argentina
2897,Diego Milito,1,90.0,0,0,1,0,1,Argentina
2898,Diego Pérez,1,32.0,0,0,1,1,2,Argentina
2899,Diego Reyes,0,58.0,0,0,0,1,1,Trinidad and Tobago
2900,Diego Rolán,0,96.0,0,0,2,0,2,Uruguay
2901,Diego Simeone,5,279.0,0,0,6,2,8,Argentina
2902,Diego Tristán,0,195.0,0,0,3,0,3,Spain
2903,Dieter Erler,0,273.0,0,0,3,1,4,German DR
2904,Dieter Müller,3,429.0,0,0,2,4,6,Yugoslavia
2905,Dieter Ramusch,0,78.0,0,0,0,1,1,Latvia
2906,Dietmar Hamann,0,14.0,0,0,0,1,1,England
2907,Dietmar Kühbauer,0,58.0,0,0,3,0,3,Austria
2908,Dietrich Albrecht,0,50.0,0,0,1,0,1,United States
2909,Dieudonné Bassanguen,0,90.0,0,0,1,0,1,Cameroon
2910,Dieudonné Londo,0,55.0,0,0,1,0,1,Gabon
2911,Dieudonné Minoungou,1,50.0,0,0,1,0,1,Burkina Faso
2912,Dieumerci Mbokani,5,653.0,0,6,9,6,15,Djibouti
2913,Dieuphane Thelamour,0,83.0,0,0,1,0,1,Haiti
2914,Dikilu Bageta,0,88.0,0,1,1,0,1,DR Congo
2915,Dilshod Vasiev,0,71.0,0,0,1,0,1,Tajikistan
2916,Dimitar Baikushev,0,27.0,0,0,1,0,1,Bulgaria
2917,Dimitar Berbatov,0,1396.0,0,1,14,14,28,Denmark
2918,Dimitar Makriev,0,90.0,0,0,1,0,1,Bulgaria
2919,Dimitar Penev,0,132.0,1,0,1,1,2,Bulgaria
2920,Dimitar Rangelov,0,79.0,0,0,3,0,3,Bulgaria
2921,Dimitar Telkiyski,0,157.0,0,0,3,0,3,Bulgaria
2922,Dimitar Yakimov,1,187.0,0,0,2,2,4,Bulgaria
2923,Dimitri Payet,0,313.0,0,0,5,0,5,France
2924,Dimitri Ramothe,1,4.0,0,0,1,0,1,Guadeloupe
2925,Dimitrij Nazarov,0,206.0,0,0,4,0,4,Azerbaijan
2926,Dimitris Kokkinakis,0,61.0,0,0,0,1,1,Israel
2927,Dimitris Kolovos,0,85.0,0,0,0,1,1,Bosnia and Herzegovina
2928,Dimitris Limnios,0,35.0,0,0,0,1,1,Armenia
2929,Dimitris Markos,0,23.0,0,0,1,0,1,Greece
2930,Dimitris Mavrogenidis,0,85.0,0,0,0,1,1,Georgia
2931,Dimitris Papadopoulos,0,17.0,0,0,1,0,1,Greece
2932,Dimitris Pelkas,0,90.0,0,0,0,1,1,Georgia
2933,Dimitris Salpingidis,2,418.0,0,1,6,4,10,Greece
2934,Dimitris Saravakos,0,280.0,0,0,5,3,8,Greece
2935,Dinardo Rodríguez,0,103.0,0,1,2,2,4,Dominican Republic
2936,Diniyar Bilyaletdinov,0,231.0,0,0,3,1,4,Israel
2937,Dinko Dermendzhiev,1,284.0,0,0,4,2,6,Sweden
2938,Dino Baggio,2,359.0,0,0,5,1,6,Portugal
2939,Dino da Costa,0,56.0,0,0,0,1,1,Northern Ireland
2940,Dinos Kouis,0,260.0,0,0,2,3,5,Denmark
2941,Diogo Jota,0,276.0,0,0,1,5,6,Serbia
2942,Dioh Williams,0,78.0,0,0,1,0,1,Liberia
2943,Dioko Kaluyituka,0,126.0,0,0,2,2,4,Cape Verde
2944,Diomandé Losseni,2,94.0,0,0,0,2,2,Ethiopia
2945,Diomansy Kamara,1,66.0,0,0,0,1,1,Tunisia
2946,Dioni Guerra,0,8.0,0,0,1,0,1,Venezuela
2947,Dionisio Arce,7,280.0,0,1,2,5,7,Paraguay
2948,Dionisio Fernandes,0,50.0,0,0,1,0,1,Guinea-Bissau
2949,Dionisio Mejía,1,267.0,0,0,7,0,7,Mexico
2950,Diphetogo Selolwane,0,188.0,0,0,3,2,5,Botswana
2951,Dipsy Selolwane,1,153.0,0,1,3,1,4,Tunisia
2952,Diquan Adamson,0,7.0,0,0,0,1,1,Bermuda
2953,Dirceu,3,113.0,0,0,3,0,3,Brazil
2954,Dirk Kuyt,2,834.0,0,2,10,5,15,North Macedonia
2955,Divock Origi,1,147.0,0,0,2,0,2,Belgium
2956,Diógenes Domínguez,2,193.0,0,0,2,1,3,Paraguay
2957,Djakaridja Koné,1,144.0,0,0,2,0,2,Burkina Faso
2958,Djalma Campos,1,80.0,0,0,1,1,2,Angola
2959,Djalma Santos,1,18.0,0,1,1,0,1,Brazil
2960,Djalminha,2,97.0,0,0,2,0,2,Brazil
2961,Djamel Amani,0,189.0,0,0,3,0,3,Algeria
2962,Djamel Belmadi,0,34.0,0,0,1,0,1,Algeria
2963,Djamel Menad,1,523.0,0,0,9,3,12,Algeria
2964,Djamel Zidane,2,132.0,0,0,2,1,3,Nigeria
2965,Djibril Cissé,0,326.0,0,0,3,3,6,Cyprus
2966,Djibril Ouattara,0,49.0,0,0,0,1,1,Cameroon
2967,Djibril Sidibé,0,84.0,0,1,1,0,1,Mali
2968,Djihad Bizimana,0,16.0,0,0,1,0,1,Rwanda
2969,Djima Oyawolé,0,52.0,0,0,1,1,2,Togo
2970,Djiman Koukou,0,62.0,0,0,0,1,1,Sudan
2971,Djimy Alexis,1,81.0,0,0,1,0,1,Haiti
2972,Djogou Akoulassi,0,53.0,0,0,0,1,1,Niger
2973,Djumadurdy Meredov,2,186.0,0,0,2,1,3,Turkmenistan
2974,Dmitri Alenichev,0,176.0,0,0,3,1,4,Russia
2975,Dmitri Bulykin,1,169.0,0,0,6,0,6,Russia
2976,Dmitri Cheryshev,0,86.0,0,0,0,1,1,San Marino
2977,Dmitri Khokhlov,0,64.0,0,0,2,0,2,Russia
2978,Dmitri Kirichenko,1,166.0,0,0,3,0,3,Russia
2979,Dmitri Kombarov,0,54.0,0,1,1,0,1,Russia
2980,Dmitri Loskov,0,145.0,0,2,2,0,2,Russia
2981,Dmitri Radchenko,1,280.0,0,0,4,2,6,Russia
2982,Dmitri Sychev,1,604.0,0,0,4,5,9,Belgium
2983,Dmitri Torbinski,1,112.0,0,0,0,1,1,Netherlands
2984,Dmitri Yurist,0,75.0,0,0,1,0,1,Kazakhstan
2985,Dmitriy Shomko,0,90.0,1,0,1,1,2,Republic of Ireland
2986,Dmitry Byakov,0,328.0,0,0,4,3,7,Kazakhstan
2987,Dmitry Verkhovtsov,0,203.0,0,0,2,1,3,Andorra
2988,Dobromir Tashkov,0,53.0,0,0,0,1,1,Romania
2989,Dobromir Zhechev,1,40.0,0,0,1,0,1,Bulgaria
2990,Dobrosav Krstić,0,9.0,0,0,1,0,1,Yugoslavia
2991,Doctor Khumalo,1,21.0,0,0,0,1,1,DR Congo
2992,Doeur Sokhom,3,123.0,0,0,2,1,3,Cambodia
2993,Dollah Kassim,0,70.0,0,0,1,0,1,Singapore
2994,Dollah Salleh,4,389.0,0,1,6,1,7,Malaysia
2995,Dom Dwyer,0,50.0,0,0,1,0,1,United States
2996,Domagoj Vida,0,175.0,0,0,1,1,2,Croatia
2997,Domen Črnigoj,0,51.0,0,0,0,2,2,Latvia
2998,Domenic Mobilio,0,169.0,0,0,2,1,3,Canada
2999,Domenico Berardi,0,14.0,0,0,1,0,1,Italy
3000,Domiciano Cavém,0,97.0,0,0,1,1,2,Portugal
3001,Domingo Peralta,1,162.0,0,0,1,2,3,Dominican Republic
3002,Domingo Pérez,1,173.0,0,0,1,2,3,Bolivia
3003,Domingo Tarasconi,0,109.0,0,0,1,1,2,Argentina
3004,Domingos Paciência,1,291.0,0,0,5,3,8,Northern Ireland
3005,Domingues,0,119.0,0,1,1,2,3,Kenya
3006,Dominic Abui Pretino,0,5.0,0,0,1,0,1,South Sudan
3007,Dominic Adiyiah,0,73.0,0,0,2,0,2,Ghana
3008,Dominic Calvert-Lewin,0,74.0,0,0,2,0,2,England
3009,Dominic Gabriel,1,35.0,0,0,0,1,1,American Samoa
3010,Dominic Kinnear,1,52.0,0,0,1,0,1,United States
3011,Dominik Szoboszlai,0,229.0,0,0,4,0,4,Hungary
3012,Dominique Bathenay,0,138.0,0,0,1,1,2,German DR
3013,Dominique Fred,1,19.0,0,0,0,1,1,Fiji
3014,Dominique Rocheteau,4,388.0,0,0,9,1,10,France
3015,Dominique da Silva,0,82.0,0,1,1,0,1,Mauritania
3016,Don Annacoura,0,52.0,0,0,1,0,1,Seychelles
3017,Don Givens,0,552.0,0,0,10,2,12,Republic of Ireland
3018,Don Hutchison,0,173.0,0,0,1,3,4,Bosnia and Herzegovina
3019,Don Masson,1,78.0,0,1,0,1,1,Wales
3020,Donald Peláez,1,148.0,0,0,0,3,3,Ecuador
3021,Donald-Olivier Sié,3,324.0,0,0,2,2,4,Ivory Coast
3022,Donaldo Rosales,0,66.0,0,0,1,1,2,Honduras
3023,Donatas Kazlauskas,0,79.0,0,0,1,0,1,Lithuania
3024,Donatas Vencevicius,0,88.0,0,0,0,1,1,Faroe Islands
3025,Donato Gama da Silva,0,112.0,0,0,1,1,2,Spain
3026,Donny van de Beek,0,85.0,0,0,0,1,1,Gibraltar
3027,Donorovyn Lkhümbengarav,0,41.0,0,0,0,1,1,North Korea
3028,Donyell Malen,0,319.0,0,0,2,2,4,Germany
3029,Dor Peretz,0,177.0,0,0,2,1,3,Israel
3030,Dorel Stoica,0,118.0,1,0,1,1,2,Romania
3031,Dorin Goian,0,164.0,0,0,3,0,3,Romania
3032,Dorin Mateuț,0,239.0,0,0,5,1,6,Romania
3033,Dorinel Munteanu,1,635.0,0,0,4,9,13,Romania
3034,Dorlan Pabón,0,92.0,0,0,1,1,2,Bolivia
3035,Dorny Romero,2,49.0,0,1,0,2,2,Anguilla
3036,Dorset Langiagne,0,56.0,0,0,1,0,1,Grenada
3037,Dorukhan Toköz,0,40.0,0,0,0,1,1,Iceland
3038,Dossa Júnior,0,60.0,1,0,1,1,2,Andorra
3039,Doudou Diongue,1,10.0,0,0,0,1,1,Ghana
3040,Doug Utjesenovic,0,11.0,0,0,1,0,1,Australia
3041,Dougie Freedman,0,44.0,0,0,1,0,1,Scotland
3042,Douglas Aziz,1,22.0,0,1,1,0,1,Iraq
3043,Douglas Cadeño,0,6.0,0,0,1,0,1,Venezuela
3044,Douglas Costa,1,113.0,0,0,3,0,3,Brazil
3045,Douglas Sequeira,0,12.0,0,0,0,1,1,Cuba
3046,Dové Womé,1,135.0,0,0,0,2,2,Algeria
3047,Doyle Vaca,0,41.0,0,0,1,0,1,Bolivia
3048,Dragan Dimitrovski,0,62.0,0,0,0,1,1,Slovakia
3049,Dragan Džajić,2,673.0,0,0,8,7,15,Luxembourg
3050,Dragan Mladenović,0,73.0,0,0,1,0,1,Serbia
3051,Dragan Načevski,0,63.0,0,0,1,0,1,North Macedonia
3052,Dragan Pantelić,0,60.0,0,2,2,0,2,Yugoslavia
3053,Dragan Stojković,4,683.0,0,2,4,7,11,France
3054,Dragiša Binić,0,35.0,0,0,1,0,1,Yugoslavia
3055,Drago Vabec,0,83.0,0,0,1,0,1,Yugoslavia
3056,Dragoslav Šekularac,0,132.0,0,0,3,0,3,Yugoslavia
3057,Dramane Coulibaly,0,131.0,0,1,3,0,3,Mali
3058,Dramane Traoré,1,34.0,0,0,0,1,1,Senegal
3059,Dražan Jerković,4,501.0,0,0,1,7,8,France
3060,Dražen Ladić,0,17.0,1,0,0,1,1,Croatia
3061,Dražen Mužinić,0,18.0,0,0,0,1,1,Romania
3062,Dries Mertens,3,574.0,0,0,9,3,12,Belgium
3063,Driss Bamous,1,54.0,0,0,1,0,1,Morocco
3064,Dshon Forbes,1,78.0,0,0,0,1,1,Turks and Caicos Islands
3065,Du Zhenyu,0,22.0,0,0,1,0,1,China PR
3066,Duaij Naser Abdulla,1,167.0,0,0,2,0,2,Bahrain
3067,Duane Muckette,1,36.0,0,0,1,0,1,Trinidad and Tobago
3068,Duberty Aráoz,1,30.0,1,0,0,1,1,Bolivia
3069,Duckens Nazon,4,517.0,0,1,3,8,11,Panama
3070,Duddley Hatei,0,61.0,0,0,1,0,1,Solomon Islands
3071,Dudley Steinwall,0,81.0,0,0,1,0,1,Sri Lanka
3072,Dudu Georgescu,0,504.0,0,2,8,1,9,Romania
3073,Duh Deng-Sheng,0,171.0,0,0,0,2,2,Australia
3074,Duilio Davino,1,143.0,0,0,1,1,2,Mexico
3075,Duje Ćaleta-Car,0,22.0,0,0,0,1,1,Malta
3076,Dumisa Ngobe,1,43.0,0,0,1,0,1,South Africa
3077,Dumitru Marcu,0,50.0,0,0,2,0,2,Romania
3078,Duncan Cole,0,36.0,0,0,1,0,1,New Zealand
3079,Duncan Edwards,0,143.0,0,0,2,0,2,England
3080,Duncan Oughton,2,155.0,0,0,2,0,2,New Zealand
3081,Duncan Shearer,0,29.0,0,0,0,1,1,Finland
3082,Dunga,1,11.0,0,0,1,0,1,Brazil
3083,Dusit Chalermsan,1,96.0,0,0,0,2,2,Iraq
3084,Dustin Corea,1,90.0,0,0,0,1,1,Costa Rica
3085,Duván Zapata,2,188.0,0,0,2,1,3,Argentina
3086,Dušan Bajević,3,243.0,0,0,3,3,6,Spain
3087,Dušan Basta,0,19.0,0,0,1,0,1,Serbia
3088,Dušan Galis,0,47.0,0,0,1,0,1,Czechoslovakia
3089,Dušan Kabát,0,112.0,0,0,0,2,2,Turkey
3090,Dušan Savić,0,161.0,0,0,1,1,2,Yugoslavia
3091,Dušan Tadić,0,488.0,0,5,6,4,10,Serbia
3092,Dušan Tittel,0,266.0,0,0,3,2,5,Slovakia
3093,Dušan Vlahović,1,226.0,0,1,4,1,5,Serbia
3094,Dušan Švento,0,14.0,0,0,0,1,1,Wales
3095,Duško Tošić,0,4.0,0,0,0,1,1,Azerbaijan
3096,Dwayne De Rosario,6,678.0,0,5,12,3,15,Canada
3097,Dwayne Stanford,0,80.0,0,0,1,0,1,Barbados
3098,Dwayne Thomas,0,2.0,0,0,0,1,1,British Virgin Islands
3099,Dwight Allers Kelley,0,141.0,0,0,2,1,3,Saint Kitts and Nevis
3100,Dwight Ferguson,0,89.0,1,0,1,0,1,Grenada
3101,Dwight Pezzarossi,0,613.0,0,0,4,4,8,Costa Rica
3102,Dwight Yorke,1,537.0,0,2,7,3,10,Trinidad and Tobago
3103,Dylan Bronn,2,173.0,1,0,2,1,3,Belgium
3104,Dylan Tavares,0,19.0,0,0,1,0,1,Cape Verde
3105,Dzhomikhon Mukhiddinov,0,51.0,0,0,1,0,1,Tajikistan
3106,Dzintars Zirnis,0,13.0,1,0,0,1,1,Latvia
3107,Dániel Böde,0,327.0,0,0,4,1,5,Turkey
3108,Dániel Gazdag,0,153.0,0,0,1,2,3,Andorra
3109,Dániel Tőzsér,0,77.0,0,0,1,0,1,Hungary
3110,Dário Monteiro,0,360.0,0,0,4,1,5,Mozambique
3111,Dávid Hancko,0,85.0,0,0,0,1,1,Azerbaijan
3112,Dávid Holman,0,71.0,0,0,0,1,1,Azerbaijan
3113,Dölgöön Amaraa,0,17.0,0,0,1,0,1,Mongolia
3114,Döwlet Baýramow,0,20.0,0,0,0,1,1,Sri Lanka
3115,Dāvis Ikaunieks,0,90.0,0,0,1,1,2,Latvia
3116,Džemaludin Mušović,0,42.0,0,0,0,1,1,Luxembourg
3117,Dževdet Šainovski,0,55.0,0,0,0,1,1,Croatia
3118,Džoni Novak,0,107.0,0,0,0,2,2,Estonia
3119,E. Karitea,1,66.0,0,0,0,1,1,New Zealand
3120,Eamonn Bannon,0,77.0,0,0,0,1,1,German DR
3121,Eamonn Rogers,0,63.0,0,1,2,0,2,Republic of Ireland
3122,Earl Jean,0,158.0,0,0,3,2,5,Saint Lucia
3123,Earnie Stewart,0,640.0,0,0,8,3,11,United States
3124,Ebbe Sand,1,626.0,0,0,9,4,13,Nigeria
3125,Eber Moas,0,72.0,0,0,1,0,1,Uruguay
3126,Eberhard Vogel,0,337.0,0,1,4,4,8,German DR
3127,Ebi Smolarek,0,231.0,0,0,4,0,4,Poland
3128,Ebrahim Isa,0,42.0,0,0,1,0,1,Bahrain
3129,Ebrahim Taghipour,0,151.0,0,0,0,2,2,Laos
3130,Ebrahim Zowayed,0,57.0,0,0,0,1,1,Qatar
3131,Ebrima Ebou Sillah,0,58.0,0,0,1,0,1,Gambia
3132,Ed Murphy,0,200.0,0,0,2,2,4,United States
3133,Eddie Gray,0,15.0,0,0,1,0,1,Scotland
3134,Eddie Hernández,0,147.0,0,0,1,1,2,Honduras
3135,Eddie Johnson,1,800.0,0,1,11,5,16,El Salvador
3136,Eddie Krncevic,2,507.0,0,0,2,5,7,New Caledonia
3137,Eddie Lewis,0,162.0,0,0,1,3,4,United States
3138,Eddie McMorran,0,54.0,0,0,0,1,1,England
3139,Eddie Pope,0,70.0,0,0,4,0,4,United States
3140,Eddie Rukumana,0,83.0,0,0,1,1,2,Papua New Guinea
3141,Eddie Theobald,0,112.0,0,1,1,1,2,Denmark
3142,Eddy Bembuana-Keve,1,48.0,0,0,1,0,1,DR Congo
3143,Eddy Berdusco,0,68.0,0,0,1,0,1,Canada
3144,Eddy Carazas,1,30.0,0,0,1,0,1,Peru
3145,Eddy Voordeckers,0,135.0,0,0,2,0,2,Belgium
3146,Edelbert Dinha,0,82.0,0,0,1,0,1,Zimbabwe
3147,Edema Fuludu,0,14.0,0,0,1,0,1,Nigeria
3148,Eden Ben Basat,0,299.0,0,0,3,3,6,Luxembourg
3149,Eden Hazard,5,1267.0,0,6,16,8,24,Belgium
3150,Eder,0,109.0,0,0,0,1,1,France
3151,Edgar Alvarez,0,50.0,0,0,1,0,1,Honduras
3152,Edgar Angulo,0,53.0,0,0,1,0,1,Colombia
3153,Edgar Babayan,0,79.0,0,0,0,1,1,Italy
3154,Edgar Bernhardt,0,131.0,0,2,3,1,4,Bangladesh
3155,Edgar Davids,1,125.0,0,0,2,0,2,Netherlands
3156,Edgar Falch,0,74.0,1,0,1,0,1,Hungary
3157,Edgar Manucharyan,0,145.0,0,0,1,1,2,Armenia
3158,Edgar Marín,0,164.0,0,0,1,2,3,Costa Rica
3159,Edgar Núñez,0,90.0,0,0,1,0,1,Costa Rica
3160,Edgar Olivares,0,10.0,0,0,1,0,1,Bolivia
3161,Edgar Salli,0,40.0,0,0,0,1,1,Niger
3162,Edgar Valencia,0,19.0,0,0,1,0,1,Guatemala
3163,Edgar Çani,0,112.0,0,0,2,0,2,Albania
3164,Edgaras Jankauskas,0,280.0,0,1,5,2,7,Lithuania
3165,Edgaras Utkus,0,14.0,1,0,1,0,1,Italy
3166,Edgaras Česnauskis,0,124.0,0,0,0,2,2,Liechtenstein
3167,Edgard Meulens,0,65.0,0,0,0,1,1,Guatemala
3168,Edgardo Adinolfi,0,51.0,0,0,1,0,1,Uruguay
3169,Edgars Gauračs,0,77.0,0,0,1,0,1,Latvia
3170,Edhem Šljivo,0,7.0,0,0,1,0,1,Yugoslavia
3171,Edibily Lunyamila,0,52.0,0,0,1,0,1,Tanzania
3172,Edimilson Fernandes,0,90.0,0,0,1,0,1,Switzerland
3173,Edin Džeko,3,1902.0,0,2,24,18,42,Bosnia and Herzegovina
3174,Edin Mujčin,0,19.0,0,0,1,0,1,Bosnia and Herzegovina
3175,Edin Sprečo,0,84.0,0,0,1,1,2,Yugoslavia
3176,Edin Višća,0,353.0,0,0,6,1,7,Bosnia and Herzegovina
3177,Edinho,0,90.0,0,0,1,0,1,Portugal
3178,Edino Nazareth Filho,1,79.0,0,0,1,0,1,Brazil
3179,Edinson Cavani,10,1394.0,0,3,20,10,30,Uruguay
3180,Edison Flores,3,614.0,0,0,3,7,10,Ecuador
3181,Edivaldo Hermoza,0,47.0,0,0,0,1,1,Argentina
3182,Edixon Perea,2,100.0,0,0,1,1,2,Colombia
3183,Edixon Perea Valencia,0,78.0,0,0,1,0,1,Colombia
3184,Edmar Halovskyi de Lacerda,0,32.0,0,0,1,0,1,Ukraine
3185,Edmond Abazi,0,77.0,0,0,1,0,1,Albania
3186,Edmond Apéti Kaolo,3,165.0,0,1,0,3,3,Mali
3187,Edmond Kapllani,0,253.0,0,0,2,3,5,Albania
3188,Edmund Conen,4,250.0,0,0,0,4,4,Belgium
3189,Edmund Waterval,0,180.0,0,0,2,0,2,Suriname
3190,Edmundo,3,153.0,0,0,3,0,3,Brazil
3191,Edmundo Alves de Souza Neto,2,74.0,0,0,1,1,2,Brazil
3192,Edmílson,1,38.0,0,0,0,1,1,Costa Rica
3193,Edo Ophof,1,22.0,0,1,0,1,1,Malta
3194,Edrissa Sonko,0,79.0,0,0,1,0,1,Gambia
3195,Edson Castillo,1,51.0,0,0,1,0,1,Venezuela
3196,Edson Minga,0,88.0,0,0,2,0,2,Congo
3197,Edson Puch,2,102.0,0,0,0,2,2,Mexico
3198,Edson Tortolero,1,199.0,1,2,2,1,3,Bolivia
3199,Edson Álvarez,2,234.0,1,0,0,3,3,Curaçao
3200,Eduard Abazi,0,65.0,0,0,1,0,1,Albania
3201,Eduard Bello,0,64.0,0,0,1,0,1,Venezuela
3202,Eduard Glieder,0,125.0,0,0,2,1,3,San Marino
3203,Eduard Kozynkevych,0,90.0,0,0,1,0,1,Russia
3204,Eduard Malofeyev,3,300.0,0,0,1,5,6,North Korea
3205,Eduard Moss,0,42.0,0,0,0,1,1,Dominica
3206,Eduard Spertsyan,0,56.0,0,0,1,0,1,Armenia
3207,Eduard Streltsov,1,189.0,0,0,1,3,4,Finland
3208,Eduardo Antunes Coimbra,0,138.0,0,0,1,1,2,Paraguay
3209,Eduardo Bennett,7,688.0,0,5,9,3,12,Canada
3210,Eduardo Chavarria,0,130.0,0,0,2,0,2,Costa Rica
3211,Eduardo Espinoza,1,76.0,0,0,1,0,1,Mexico
3212,Eduardo Fernando Gomes,0,145.0,0,1,2,1,3,Mauritius
3213,Eduardo González Palmer,0,145.0,0,0,2,0,2,Mexico
3214,Eduardo González Valiño,0,3.0,0,0,1,0,1,Spain
3215,Eduardo Guzmán,1,6.0,0,0,0,1,1,Bolivia
3216,Eduardo Hurtado,0,581.0,0,0,10,0,10,Ecuador
3217,Eduardo Ithurbide,0,5.0,0,0,0,1,1,Argentina
3218,Eduardo Laing,1,60.0,0,0,1,0,1,Honduras
3219,Eduardo Machado,0,83.0,0,0,0,1,1,Algeria
3220,Eduardo Malásquez,0,49.0,0,1,0,2,2,Colombia
3221,Eduardo Mario Acevedo,0,45.0,0,0,1,0,1,Uruguay
3222,Eduardo Mingo,2,61.0,0,0,0,2,2,Ecuador
3223,Eduardo Retat,0,75.0,0,0,0,1,1,Ecuador
3224,Eduardo Ricagni,0,84.0,0,0,1,0,1,Italy
3225,Eduardo Sebrango,2,283.0,0,0,2,3,5,Cayman Islands
3226,Eduardo Vargas,12,1231.0,0,0,13,13,26,Chile
3227,Eduardo Vilarete,0,58.0,0,0,0,1,1,Paraguay
3228,Eduardo da Silva,0,1034.0,0,0,9,9,18,Croatia
3229,Eduvigis Rudolfo Dirksz,0,66.0,0,0,0,2,2,Suriname
3230,Edvard Lasota,1,63.0,0,0,1,0,1,Czech Republic
3231,Edvin Murati,0,145.0,0,0,2,1,3,Finland
3232,Edward Acquah,0,449.0,0,0,5,2,7,Ghana
3233,Edward Aggrey-Fynn,0,116.0,0,1,2,0,2,Ghana
3234,Edward Boateng,0,44.0,0,0,1,0,1,Ghana
3235,Edward Herrera,0,77.0,0,0,1,0,1,Malta
3236,Edward Jankowski,0,200.0,0,0,1,3,4,Finland
3237,Edward Jildo,0,17.0,0,0,1,0,1,Sudan
3238,Edward Semwanga,1,31.0,0,0,0,1,1,Congo
3239,Edwin Cardona,1,312.0,0,0,2,2,4,Colombia
3240,Edwin Clarcke,3,95.0,0,0,3,0,3,Argentina
3241,Edwin Congo,1,112.0,0,0,0,2,2,Argentina
3242,Edwin Gyasi,0,63.0,0,0,1,0,1,Ghana
3243,Edwin Miliano Loran,2,64.0,0,0,2,0,2,Curaçao
3244,Edwin Mukenya,0,61.0,0,0,1,0,1,Kenya
3245,Edwin Rarai,1,82.0,0,0,0,1,1,Tahiti
3246,Edwin Schal,0,90.0,0,0,1,0,1,Suriname
3247,Edwin Solano,1,52.0,0,0,1,0,1,Honduras
3248,Edwin Sánchez,0,78.0,0,0,0,1,1,Suriname
3249,Edwin Villatoro,0,74.0,0,0,0,1,1,Costa Rica
3250,Edwin Westphal,2,126.0,0,0,2,0,2,Guatemala
3251,Edy Dublin,0,26.0,0,0,0,1,1,Norway
3252,Edzai Kasinauyo,0,83.0,0,0,1,0,1,Zimbabwe
3253,Edílson,0,78.0,0,0,1,1,2,Brazil
3254,Edú Marangón,1,33.0,0,0,1,0,1,Brazil
3255,Efe Ambrose,0,87.0,0,0,1,0,1,Nigeria
3256,Efrain Chacurian,0,42.0,0,0,0,1,1,Haiti
3257,Efraín Juárez,1,55.0,0,0,1,0,1,Mexico
3258,Efstathios Aloneftis,0,445.0,0,0,7,2,9,Cyprus
3259,Egil Østenstad,0,75.0,0,0,1,0,1,Norway
3260,Egil á Bø,0,83.0,0,0,0,1,1,Romania
3261,Egisto Pandolfini,2,104.0,0,1,2,1,3,Italy
3262,Egor Filipenko,0,32.0,0,0,1,0,1,Belarus
3263,Egor Krimets,0,86.0,0,0,0,1,1,Qatar
3264,Egzon Bejtulai,0,86.0,1,0,0,1,1,North Macedonia
3265,Ehsan Hajsafi,2,186.0,0,3,3,1,4,Iran
3266,Ehson Panjshanbe,0,9.0,0,0,0,1,1,Japan
3267,Eimantas Poderis,0,66.0,0,0,0,1,1,Latvia
3268,Einar Daníelsson,0,28.0,0,0,0,1,1,Liechtenstein
3269,Einar Gunnarsson,0,89.0,1,0,1,0,1,Belgium
3270,Einar Jan Aas,0,3.0,0,0,0,1,1,Scotland
3271,Eitan Tibi,0,22.0,0,0,0,1,1,Liechtenstein
3272,Eiður Guðjohnsen,0,1018.0,0,2,13,8,21,Iceland
3273,Ekanit Panya,0,51.0,0,0,1,0,1,Thailand
3274,Eko Purdjianto,0,78.0,0,0,0,1,1,Cambodia
3275,El Arbi Hababi,0,16.0,0,0,1,0,1,Morocco
3276,El Fardou Ben Nabouhane,1,4.0,0,0,0,1,1,Ghana
3277,El Hadji Diouf,1,658.0,0,1,12,3,15,Senegal
3278,El Hadji Oumar Guèye,1,37.0,0,0,0,1,1,Ethiopia
3279,Eladio Benítez,0,8.0,0,0,1,0,1,Uruguay
3280,Eladio Rojas,0,119.0,0,0,2,0,2,Chile
3281,Eladio Zárate,4,115.0,0,0,1,3,4,Ecuador
3282,Elano,2,217.0,0,0,3,0,3,Brazil
3283,Elba de Padua Lima,1,10.0,0,0,1,0,1,Brazil
3284,Elbasan Rashani,0,90.0,0,0,0,1,1,Bulgaria
3285,Elcio Martina,0,90.0,0,0,0,1,1,El Salvador
3286,Eldar Hansen,1,87.0,0,0,0,1,1,Russia
3287,Eldar Ćivić,0,57.0,0,0,0,1,1,Liechtenstein
3288,Eldor Shomurodov,5,592.0,0,0,6,6,12,Bahrain
3289,Elek Nyilas,0,109.0,0,1,0,2,2,Azerbaijan
3290,Eli Ohana,0,428.0,0,1,7,1,8,Israel
3291,Elias Hossain,0,76.0,0,0,1,0,1,Bangladesh
3292,Elias Maguri,0,43.0,0,0,1,0,1,Tanzania
3293,Elias Pelembe,0,63.0,0,0,1,0,1,Mozambique
3294,Elias Tshimanga,1,90.0,0,0,1,0,1,DR Congo
3295,Elias Uzamukunda,0,58.0,0,0,0,1,1,Eritrea
3296,Elie Aiboy,1,122.0,0,0,2,1,3,Indonesia
3297,Eligio Antonio Insfrán,1,30.0,0,0,0,1,1,Argentina
3298,Elijah Joseph,0,26.0,0,0,1,0,1,Saint Lucia
3299,Elijah Just,1,71.0,0,0,1,0,1,New Zealand
3300,Elijah Litana,3,124.0,0,0,3,1,4,Zambia
3301,Elijah Tana,1,49.0,0,0,2,1,3,Togo
3302,Eliphas Shivute,2,198.0,0,0,0,5,5,Egypt
3303,Eliran Atar,0,83.0,0,0,0,1,1,Albania
3304,Eliseo Prado,0,63.0,0,0,1,0,1,Argentina
3305,Eliseo Quintanilla,1,441.0,0,2,7,0,7,El Salvador
3306,Eliseu,0,87.0,0,0,1,0,1,Portugal
3307,Eljero Elia,0,82.0,0,0,0,1,1,Scotland
3308,Eljif Elmas,0,535.0,0,0,7,1,8,North Macedonia
3309,Elkeson,0,313.0,0,1,2,2,4,Maldives
3310,Elkin Soto,0,134.0,0,0,1,1,2,Colombia
3311,Elly Adero,0,30.0,0,0,1,0,1,Kenya
3312,Ellyes Skhiri,0,93.0,0,0,2,0,2,Tunisia
3313,Elmar Geirsson,0,44.0,0,0,0,1,1,Netherlands
3314,Elmer Acevedo,0,119.0,0,0,1,1,2,El Salvador
3315,Elmer Martínez,0,51.0,0,0,0,1,1,Belize
3316,Elmo Kambindu,0,53.0,0,0,0,1,1,Togo
3317,Elos Elonga-Ekakia,0,159.0,0,0,0,2,2,Mauritius
3318,Eloy,1,70.0,0,0,0,1,1,Algeria
3319,Eloy Olaya,0,87.0,0,0,0,2,2,Austria
3320,Elrio van Heerden,3,142.0,0,0,2,1,3,South Africa
3321,Elroy Kuylen,1,111.0,0,0,1,2,3,Montserrat
3322,Elroy Smith,0,39.0,0,0,0,1,1,Saint Kitts and Nevis
3323,Elsad Zverotić,0,217.0,0,0,2,2,4,Bulgaria
3324,Elseid Hysaj,0,120.0,0,0,2,0,2,Albania
3325,Elson Hooi,0,87.0,0,0,1,0,1,Curaçao
3326,Elvin Mammadov,0,131.0,0,0,1,1,2,Azerbaijan
3327,Elvir Baljić,0,583.0,0,2,4,6,10,Bosnia and Herzegovina
3328,Elvir Bolić,0,663.0,0,0,12,3,15,Slovenia
3329,Elvis Kafoteka,1,38.0,0,0,2,0,2,Malawi
3330,Elvis Macedo Babanco,0,73.0,0,0,1,0,1,Cape Verde
3331,Elyaniv Barda,0,286.0,0,0,8,1,9,Israel
3332,Elías Aguilar,2,99.0,0,0,2,0,2,Costa Rica
3333,Elías Figueroa,0,84.0,0,0,2,0,2,Chile
3334,Elías Hernández,1,29.0,0,0,1,0,1,Mexico
3335,Elías Montes,0,84.0,0,0,3,0,3,El Salvador
3336,Emad Ayoub,2,151.0,0,0,1,3,4,Hong Kong
3337,Emad Mohammed,3,468.0,0,0,7,3,10,Iraq
3338,Emad Moteab,2,505.0,0,0,11,0,11,Egypt
3339,Emad Suleiman,1,123.0,0,0,2,1,3,Egypt
3340,Emanuel Fabri,1,59.0,0,0,2,0,2,Malta
3341,Emanuel Farrugia,0,62.0,0,0,1,0,1,Malta
3342,Emanuel Pogatetz,0,32.0,0,0,0,1,1,Netherlands
3343,Emanuele Giaccherini,1,83.0,0,0,0,2,2,Brazil
3344,Emeka Mamale,0,1.0,0,0,0,1,1,Mauritius
3345,Emelio Caligdong,0,20.0,0,0,1,0,1,Philippines
3346,Emerich Dembrovschi,1,242.0,0,0,3,2,5,Romania
3347,Emerson,1,40.0,0,0,1,0,1,Brazil
3348,Emerson Umaña,0,80.0,0,0,1,0,1,El Salvador
3349,Emery Welshman,1,198.0,0,0,3,0,3,Guyana
3350,Emil Dumitriu,0,153.0,0,0,3,0,3,Romania
3351,Emil Forsberg,5,581.0,0,4,11,2,13,Sweden
3352,Emil Gargorov,0,114.0,0,0,1,1,2,Bulgaria
3353,Emil Hallfreðsson,0,40.0,0,0,1,0,1,Iceland
3354,Emil Kenjisariev,0,86.0,0,0,1,0,1,Kyrgyzstan
3355,Emil Kostadinov,1,1166.0,0,0,10,10,20,Scotland
3356,Emil Lőrincz,0,20.0,0,0,2,0,2,Hungary
3357,Emil Pažický,0,54.0,0,0,1,0,1,Czechoslovakia
3358,Emile Heskey,1,162.0,0,0,0,3,3,Germany
3359,Emile Mbouh,0,123.0,0,0,1,1,2,Gabon
3360,Emile Ounei,0,43.0,0,1,1,0,1,New Caledonia
3361,Emile Pierre Diéme,0,26.0,0,0,1,0,1,Senegal
3362,Emile Saimovici,2,129.0,0,0,2,0,2,Barbados
3363,Emile Smith Rowe,0,58.0,0,0,0,1,1,San Marino
3364,Emiliano González Arqués,0,45.0,0,0,1,0,1,Andorra
3365,Emilio Butragueño,6,843.0,0,1,9,6,15,Spain
3366,Emilio Izaguirre,1,109.0,0,0,2,0,2,Honduras
3367,Emilio Mora,1,26.0,0,0,1,0,1,Mexico
3368,Emilio Nsue,0,176.0,0,0,3,0,3,Equatorial Guinea
3369,Emilio Palacios,0,97.0,0,0,1,1,2,Nicaragua
3370,Emin Ağayev,0,14.0,1,0,1,0,1,Finland
3371,Emin Imamaliev,0,83.0,0,0,1,0,1,Azerbaijan
3372,Emin Mahmudov,0,216.0,0,1,1,3,4,Azerbaijan
3373,Emir Bajrami,0,84.0,0,0,1,0,1,Sweden
3374,Emir Spahić,0,219.0,1,0,4,1,5,Bosnia and Herzegovina
3375,Emmanuel Adebayor,6,843.0,0,0,14,3,17,Togo
3376,Emmanuel Agyemang-Badu,2,150.0,0,0,3,0,3,Ghana
3377,Emmanuel Ake,1,51.0,0,0,0,1,1,Burkina Faso
3378,Emmanuel Amunike,4,233.0,0,0,5,1,6,Nigeria
3379,Emmanuel Chipatala,0,47.0,0,0,1,1,2,Malawi
3380,Emmanuel Duah,0,70.0,0,0,1,0,1,Ghana
3381,Emmanuel Eboué,1,33.0,0,0,1,0,1,Ivory Coast
3382,Emmanuel Emenike,4,369.0,0,1,2,5,7,Nigeria
3383,Emmanuel Feseha,0,90.0,0,0,1,0,1,Ethiopia
3384,Emmanuel Koum,2,123.0,0,0,2,0,2,Cameroon
3385,Emmanuel Kundé,2,379.0,0,3,6,0,6,Cameroon
3386,Emmanuel Maboang,3,271.0,0,0,4,0,4,Cameroon
3387,Emmanuel Mayuka,4,179.0,0,0,2,2,4,Senegal
3388,Emmanuel Musonda,0,60.0,0,0,1,0,1,Zambia
3389,Emmanuel Ofei Ansah,0,59.0,0,0,0,1,1,Guinea
3390,Emmanuel Okocha,0,82.0,0,0,0,1,1,Algeria
3391,Emmanuel Okwi,2,282.0,0,0,3,2,5,Angola
3392,Emmanuel Ola,0,41.0,0,0,1,0,1,Ghana
3393,Emmanuel Olisadebe,1,280.0,0,0,4,5,9,Ukraine
3394,Emmanuel Osei Kuffour,0,44.0,0,0,1,0,1,Ghana
3395,Emmanuel Osigwe,1,114.0,0,0,1,1,2,Nigeria
3396,Emmanuel Petit,0,194.0,0,0,3,0,3,France
3397,Emmanuel Poila,0,90.0,0,0,1,0,1,Solomon Islands
3398,Emmanuel Rivière,1,74.0,0,1,0,2,2,Canada
3399,Emmanuel Sanon,2,109.0,0,0,0,2,2,Italy
3400,Emmanuel Tiki,0,10.0,0,0,1,0,1,Cameroon
3401,Emment Kapengwe,0,166.0,0,0,2,1,3,Zambia
3402,Emmerson Boyce,0,46.0,0,0,0,2,2,Aruba
3403,Emory Núñez,1,40.0,0,0,1,0,1,Belize
3404,Emre Aşık,0,80.0,0,0,0,2,2,Sweden
3405,Emre Belözoğlu,1,284.0,0,1,3,3,6,Turkey
3406,Emre Can,0,81.0,0,0,1,0,1,Germany
3407,Emílio da Silva,2,163.0,0,0,2,1,3,Timor-Leste
3408,Endang Witarsa,0,70.0,0,0,0,1,1,China PR
3409,Ender Konca,0,24.0,0,0,1,0,1,Turkey
3410,Endre Botka,0,18.0,0,0,1,0,1,Hungary
3411,Endri Çekiçi,0,73.0,0,1,1,0,1,Albania
3412,Energio Díaz,1,61.0,0,0,0,1,1,Peru
3413,Enes Ünal,0,38.0,0,1,0,2,2,Andorra
3414,Enis Bardhi,0,331.0,0,2,2,5,7,North Macedonia
3415,Enner Valencia,9,879.0,0,4,10,10,20,Switzerland
3416,Enock Mwepu,0,98.0,0,0,1,1,2,Zambia
3417,Enric Gensana,0,69.0,0,0,1,0,1,Spain
3418,Enrico Chiesa,1,107.0,0,0,1,1,2,Czech Republic
3419,Enrico Hernández,0,37.0,0,0,1,0,1,El Salvador
3420,Enrique Alfaro Rojas,0,8.0,0,0,0,1,1,Canada
3421,Enrique Alvarez,1,19.0,0,1,0,1,1,Brazil
3422,Enrique Borja,1,48.0,0,0,0,1,1,France
3423,Enrique Cantos,2,126.0,0,0,0,3,3,Colombia
3424,Enrique Casaretto,0,107.0,0,0,0,2,2,Brazil
3425,Enrique Collar,0,75.0,0,0,2,0,2,Spain
3426,Enrique Esqueda,0,57.0,0,0,0,1,1,Trinidad and Tobago
3427,Enrique Ferrer,0,62.0,0,0,0,1,1,Haiti
3428,Enrique García,2,132.0,0,0,4,1,5,Argentina
3429,Enrique Guaita,0,19.0,0,0,1,0,1,Italy
3430,Enrique Hormazábal,4,480.0,0,0,8,2,10,Chile
3431,Enrique Jara Saguier,0,88.0,0,0,2,0,2,Paraguay
3432,Enrique Lora,0,66.0,0,0,1,0,1,Spain
3433,Enrique Mateos,0,11.0,0,0,1,0,1,Spain
3434,Enrique Raymondi,1,341.0,0,0,3,3,6,Bolivia
3435,Enrique Raymondi Chávez,0,30.0,0,0,0,1,1,Chile
3436,Enrique Reneau,0,117.0,0,0,1,1,2,Mexico
3437,Enrique Saura,0,155.0,0,0,1,1,2,Cyprus
3438,Enrique Sesma,0,107.0,0,0,1,1,2,United States
3439,Enrique Sorrel,2,123.0,0,1,4,0,4,Chile
3440,Enrique Tenemás,1,62.0,0,0,0,1,1,Argentina
3441,Enrique Vera,1,27.0,0,0,0,1,1,Slovakia
3442,Enrique Ávalos,1,100.0,0,0,0,2,2,Bolivia
3443,Enzo Fernández,2,164.0,1,0,1,1,2,Argentina
3444,Enzo Francescoli,3,499.0,0,3,5,5,10,Uruguay
3445,Enzo Scifo,3,620.0,0,2,6,8,14,Belgium
3446,Eoin Hand,0,79.0,0,0,0,1,1,Russia
3447,Eoin Jess,0,98.0,0,0,2,0,2,Scotland
3448,Epeli Saukuru,0,66.0,0,0,0,1,1,New Caledonia
3449,Epotele Bazamba,1,51.0,0,0,1,0,1,DR Congo
3450,Eran Zahavi,0,1046.0,0,1,11,12,23,Russia
3451,Erasmo Vera,0,29.0,0,0,1,0,1,Chile
3452,Erasto Nyoni,0,87.0,0,2,2,0,2,Tanzania
3453,Erastus Gariseb,0,70.0,0,0,0,1,1,Egypt
3454,Eren Derdiyok,0,247.0,0,0,3,1,4,Latvia
3455,Erhan Önal,0,80.0,0,0,1,0,1,Turkey
3456,Eric Abidal,0,20.0,1,0,1,0,1,Belarus
3457,Eric Akoto,0,86.0,0,0,1,0,1,Togo
3458,Eric Cantona,0,553.0,0,1,8,2,10,France
3459,Eric Carrière,2,231.0,0,0,2,1,3,France
3460,Eric Davis,3,298.0,0,3,2,3,5,Guyana
3461,Eric Dier,1,110.0,0,0,2,0,2,England
3462,Eric Etaeta,0,76.0,0,0,0,1,1,Solomon Islands
3463,Eric Gerets,1,23.0,0,0,1,1,2,Belgium
3464,Eric Godlieb,0,2.0,0,0,1,0,1,Suriname
3465,Eric Hoffmann,0,65.0,1,0,0,1,1,Luxembourg
3466,Eric Komeng,0,68.0,0,0,0,1,1,Samoa
3467,Eric Lichaj,0,45.0,0,0,1,0,1,United States
3468,Eric Maxim Choupo-Moting,2,236.0,0,1,4,2,6,Cameroon
3469,Eric McMordie,0,47.0,0,0,1,0,1,Northern Ireland
3470,Eric Ramírez,0,11.0,0,0,1,0,1,Venezuela
3471,Eric Tinkler,0,21.0,0,0,0,1,1,Malawi
3472,Eric Van Meir,0,26.0,0,0,1,0,1,Belgium
3473,Eric Wynalda,4,859.0,0,3,17,2,19,United States
3474,Eric Young,0,31.0,0,0,0,1,1,Faroe Islands
3475,Erich Beer,0,178.0,0,1,2,1,3,Germany
3476,Erich Hof,0,386.0,0,3,8,2,10,Norway
3477,Erich Obermayer,1,80.0,0,0,1,0,1,Austria
3478,Erich Probst,5,466.0,0,0,11,1,12,Austria
3479,Erick Miranda,1,28.0,0,0,0,1,1,Mexico
3480,Erick Ozuna,0,283.0,0,0,3,2,5,Dominican Republic
3481,Erick Pulgar,1,165.0,0,0,3,1,4,Japan
3482,Erick Scott,2,88.0,0,0,1,1,2,Cuba
3483,Erik Dyreborg,0,25.0,0,0,0,1,1,German DR
3484,Erik Edman,0,74.0,0,0,0,1,1,Bulgaria
3485,Erik Hagen,0,17.0,0,0,1,1,2,Bosnia and Herzegovina
3486,Erik Holmgren,0,164.0,0,0,1,1,2,Malta
3487,Erik Huseklepp,0,162.0,0,0,3,0,3,Norway
3488,Erik Jendrišek,0,82.0,0,0,0,1,1,Czech Republic
3489,Erik Johansen,0,89.0,0,0,1,1,2,Luxembourg
3490,Erik Just Olsen,0,54.0,0,1,0,1,1,Sweden
3491,Erik Lamela,2,84.0,0,0,2,0,2,Argentina
3492,Erik Mykland,0,74.0,0,0,1,0,1,Norway
3493,Erik Persson,0,65.0,0,0,1,0,1,Sweden
3494,Erik Sandvad,0,87.0,1,0,1,0,1,Portugal
3495,Erik Santos de Gouveia,0,13.0,0,0,1,0,1,Aruba
3496,Erik Sorga,0,265.0,0,0,3,1,4,Estonia
3497,Eriq Zavaleta,0,61.0,0,0,1,1,2,El Salvador
3498,Erixon Danso,0,54.0,0,0,2,0,2,Aruba
3499,Erjon Bogdani,0,648.0,0,0,7,4,11,Denmark
3500,Erkan Zengin,0,93.0,0,0,2,1,3,Austria
3501,Erland Johnsen,0,89.0,0,0,0,1,1,Scotland
3502,Erling Haaland,0,196.0,0,1,4,1,5,Norway
3503,Ermen Benítez,1,88.0,0,0,0,1,1,Uruguay
3504,Ermes Muccinelli,1,154.0,0,0,1,1,2,Italy
3505,Ermin Bičakčić,0,174.0,0,0,2,1,3,Slovakia
3506,Ermin Šiljak,0,323.0,0,0,5,5,10,Slovenia
3507,Ermindo Onega,1,154.0,0,0,4,0,4,Argentina
3508,Ermir Lenjani,0,79.0,0,0,1,1,2,Albania
3509,Ernest Brenner,0,10.0,0,0,0,1,1,Norway
3510,Ernest Ebongué,1,223.0,0,0,1,2,3,Cameroon
3511,Ernest Liberati,0,80.0,0,0,0,1,1,Luxembourg
3512,Ernest Mengel,0,27.0,0,0,1,0,1,Luxembourg
3513,Ernest Pohl,0,148.0,0,0,2,1,3,Poland
3514,Ernest Schultz,0,86.0,0,0,1,0,1,France
3515,Ernest Spiteri-Gonzi,1,137.0,0,0,1,2,3,Turkey
3516,Ernesto Belis,1,4.0,0,0,1,0,1,Argentina
3517,Ernesto Betancourt,1,70.0,0,0,0,1,1,Bolivia
3518,Ernesto Cisneros,0,193.0,0,0,3,1,4,Jamaica
3519,Ernesto Cristaldo,1,78.0,0,0,1,0,1,Paraguay
3520,Ernesto Duarte Machado da Silva,2,65.0,0,0,2,0,2,Brazil
3521,Ernesto Díaz,0,249.0,0,0,4,1,5,Colombia
3522,Ernesto Grillo,2,31.0,0,0,2,0,2,Argentina
3523,Ernesto Humberto Juárez,1,86.0,0,0,1,0,1,Argentina
3524,Ernesto Vidal,1,18.0,0,0,0,1,1,Bolivia
3525,Ernie Brandts,3,194.0,1,0,2,3,5,Austria
3526,Ernie Campbell,0,108.0,0,0,1,1,2,New Zealand
3527,Ernie Tapai,1,181.0,0,0,3,1,4,Tahiti
3528,Ernst Albrecht,0,24.0,0,0,0,1,1,Luxembourg
3529,Ernst Baumeister,0,71.0,0,0,0,1,1,Turkey
3530,Ernst Happel,0,68.0,0,1,1,0,1,Austria
3531,Ernst Hufschmid,0,75.0,0,0,1,0,1,Switzerland
3532,Ernst Kozlicek,0,71.0,0,0,1,0,1,Austria
3533,Ernst Lehner,2,184.0,0,0,2,3,5,Austria
3534,Ernst Lörtscher,1,22.0,1,0,1,0,1,Germany
3535,Ernst Ocwirk,1,134.0,0,0,2,1,3,Austria
3536,Ernst Ogris,0,83.0,0,0,0,1,1,Denmark
3537,Ernst Stojaspal,3,84.0,0,1,3,0,3,Austria
3538,Ernst Wilimowski,4,397.0,0,0,1,4,5,Poland
3539,Ernő Solymosi,1,128.0,1,1,2,2,4,German DR
3540,Erol Keskin,1,143.0,0,0,1,1,2,Turkey
3541,Errol Daniels,0,225.0,0,0,3,1,4,Costa Rica
3542,Errol McFarlane,1,297.0,0,0,1,3,4,Saint Vincent and the Grenadines
3543,Errol O'Loughlin,0,86.0,0,0,1,0,1,Saint Kitts and Nevis
3544,Erroll Bennett,4,445.0,0,0,0,5,5,New Caledonia
3545,Ertuğrul Sağlam,0,176.0,0,0,4,0,4,Turkey
3546,Ervin Fakaj,0,90.0,0,0,1,0,1,Albania
3547,Ervin Skela,0,159.0,0,2,1,4,5,Republic of Ireland
3548,Erwin Hochsträsser,0,80.0,0,1,1,0,1,Switzerland
3549,Erwin Hoffer,0,160.0,0,0,3,0,3,Austria
3550,Erwin Koeman,0,74.0,0,0,2,0,2,Netherlands
3551,Erwin Ramírez,1,80.0,0,1,0,1,1,Bolivia
3552,Erwin Romero,0,65.0,0,0,1,0,1,Bolivia
3553,Erwin Saavedra,2,70.0,0,1,0,2,2,Paraguay
3554,Erwin Sánchez,3,697.0,0,1,9,4,13,Peru
3555,Erwin Vandenbergh,2,613.0,0,1,8,7,15,Scotland
3556,Esa Heiskanen,0,49.0,0,0,2,0,2,Finland
3557,Esala Masi,11,604.0,0,1,6,8,14,Fiji
3558,Esam Dariban,0,39.0,0,0,0,1,1,Cambodia
3559,Esey Tesfay,0,58.0,1,0,0,1,1,Eritrea
3560,Esrom Nyandoro,1,140.0,0,0,0,2,2,Cameroon
3561,Essam Abu Touk,0,179.0,0,2,4,1,5,Uzbekistan
3562,Essam Baheeg,2,101.0,0,0,2,0,2,Egypt
3563,Essau Kanyenda,0,207.0,0,0,3,2,5,Ethiopia
3564,Estanislao Struway,0,45.0,0,0,1,0,1,Paraguay
3565,Estanislau Basora,4,336.0,0,0,6,1,7,Spain
3566,Esteban Cambiasso,1,187.0,0,0,1,2,3,Germany
3567,Esteban Obiang,1,70.0,0,0,0,1,1,Algeria
3568,Esteban Paredes,1,104.0,0,0,4,0,4,Chile
3569,Etienne Alain Djissikadie,0,10.0,0,0,1,0,1,Gabon
3570,Etienne Barbara,0,79.0,0,0,1,0,1,Malta
3571,Etienne Bito'o,0,84.0,0,0,0,1,1,Algeria
3572,Etienne Hajason Rasoanaivo,0,67.0,0,0,0,1,1,Zimbabwe
3573,Etienne Mermer,3,273.0,0,0,1,4,5,American Samoa
3574,Etienne Olivier Rasoanaivo,0,82.0,0,0,0,1,1,Zambia
3575,Etienne Rado Rasoanaivo,0,128.0,0,0,2,1,3,Madagascar
3576,Eudalio Arriaga,0,90.0,0,0,1,0,1,Colombia
3577,Eudes Dagoulou,0,7.0,0,0,0,1,1,Madagascar
3578,Eugen Sidorenco,0,248.0,0,0,3,1,4,Moldova
3579,Eugen Walaschek,1,42.0,0,0,0,1,1,Germany
3580,Eugene Kirwan,1,23.0,0,0,1,0,1,Antigua and Barbuda
3581,Eugene Martha,2,123.0,1,0,1,1,2,Curaçao
3582,Eugene Ssepuuya,0,15.0,0,0,1,1,2,Benin
3583,Eugenio Dolmo Flores,2,177.0,0,0,1,2,3,Canada
3584,Eugenio Fernando Bila,0,6.0,0,0,0,1,1,Botswana
3585,Eugenio La Rosa,3,151.0,0,0,3,0,3,Peru
3586,Eugenio Leal,0,75.0,0,0,1,0,1,Spain
3587,Eugenio Morel,0,229.0,0,0,3,2,5,Paraguay
3588,Eugenio Méndez,0,85.0,0,0,2,0,2,Chile
3589,Eugeniu Cebotaru,0,85.0,0,0,1,0,1,Moldova
3590,Eugène Ekéké,1,65.0,0,0,1,0,1,Cameroon
3591,Eugène Kabongo,1,249.0,0,0,3,3,6,Ivory Coast
3592,Euller,0,20.0,0,0,0,1,1,Venezuela
3593,Euloge Placca Fessou,1,187.0,0,0,1,2,3,Togo
3594,Euloge Sacramento,0,43.0,0,0,0,1,1,Tunisia
3595,Eulogio Martínez,1,122.0,0,0,0,2,2,Brazil
3596,Eurico Gomes,0,31.0,0,0,1,0,1,Portugal
3597,Eusebio Escobar,0,27.0,0,0,1,0,1,Colombia
3598,Eustache Manglé,4,243.0,0,0,1,3,4,DR Congo
3599,Eustacio Rizo,1,89.0,0,0,0,1,1,Guatemala
3600,Eustaquio Barreiro,1,63.0,0,0,0,1,1,Ecuador
3601,Eusébio,9,1325.0,0,5,9,17,26,Luxembourg
3602,Euzebiusz Smolarek,0,540.0,0,0,8,4,12,Poland
3603,Evagoras Christofi,0,28.0,0,0,1,0,1,Cyprus
3604,Evair Aparecido Paulino,0,31.0,0,0,1,0,1,Brazil
3605,Evan Dimas,1,60.0,0,0,0,1,1,Thailand
3606,Evan Welsh,0,89.0,0,0,0,1,1,Honduras
3607,Evani Esperance,0,81.0,0,0,1,0,1,Suriname
3608,Evans Sakala,1,38.0,0,0,1,0,1,Zambia
3609,Evaristo de Macedo,8,470.0,0,0,8,0,8,Brazil
3610,Everad Sam,0,75.0,0,0,0,1,1,Honduras
3611,Everon Espacia,0,73.0,0,0,1,0,1,Curaçao
3612,Everton Soares,0,132.0,0,0,3,0,3,Brazil
3613,Evgeny Boldygin,0,103.0,0,0,1,1,2,Pakistan
3614,Evidence Makgopa,0,90.0,0,0,0,1,1,Ethiopia
3615,Ewald Hoeseb,0,28.0,0,0,1,0,1,Namibia
3616,Eyal Berkovic,0,218.0,0,0,3,2,5,France
3617,Eyjólfur Sverrisson,0,426.0,0,0,6,3,9,Iceland
3618,Eyvind Clausen,0,58.0,0,0,2,0,2,Denmark
3619,Ezechiel N'Douassel,0,158.0,0,1,2,0,2,Chad
3620,Ezequiel Jerez,0,87.0,0,0,0,1,1,Guatemala
3621,Ezequiel Lavezzi,1,169.0,0,0,5,1,6,Argentina
3622,Ezgjan Alioski,1,246.0,0,1,2,4,6,Albania
3623,Ezio Pascutti,0,38.0,0,0,1,0,1,Italy
3624,Ezz El-Din Yaqoub,1,56.0,0,0,1,0,1,Egypt
3625,Ezzedine Chakroun,0,229.0,0,0,1,3,4,Algeria
3626,Ezzeldin Osman,0,40.0,0,0,1,0,1,Sudan
3627,Ezzewdin Bezan,0,8.0,0,0,1,0,1,Libya
3628,Fabian Frei,0,20.0,0,0,1,0,1,Switzerland
3629,Fabian Johnson,0,29.0,0,0,1,0,1,United States
3630,Fabian Schär,1,273.0,0,1,3,5,8,Switzerland
3631,Fabio Baudo Franco,3,82.0,0,0,0,3,3,Chile
3632,Fabio Cannavaro,0,52.0,1,0,1,0,1,Russia
3633,Fabio Capello,1,167.0,0,0,1,2,3,Luxembourg
3634,Fabio Celestini,0,87.0,0,0,0,1,1,Republic of Ireland
3635,Fabio D'Elia,0,49.0,0,0,1,0,1,Liechtenstein
3636,Fabio Francini,0,90.0,1,0,1,0,1,Scotland
3637,Fabio Grosso,0,289.0,0,0,2,2,4,Scotland
3638,Fabio Quagliarella,1,327.0,0,2,3,3,6,Lithuania
3639,Fabián Estay,0,171.0,0,0,3,0,3,Chile
3640,Fabián Estoyanoff,2,9.0,0,0,0,2,2,Argentina
3641,Fabián Orellana,0,113.0,0,0,1,1,2,Chile
3642,Fabián Ruiz,0,8.0,0,0,1,0,1,Spain
3643,Fabrice Do Marcolino,1,190.0,0,0,3,0,3,Gabon
3644,Fabrice N'Guessi,0,66.0,0,0,0,1,1,Niger
3645,Fabrice Noël,1,14.0,0,0,1,0,1,Haiti
3646,Fabrice Ondama,1,150.0,0,0,1,1,2,Congo
3647,Fabrice Reuperné,1,90.0,0,0,0,1,1,Canada
3648,Fabricio Coloccini,0,66.0,0,0,0,1,1,Peru
3649,Fabrizio Ravanelli,0,305.0,0,0,5,2,7,Italy
3650,Fadel Keïta,0,162.0,0,0,1,1,2,Rwanda
3651,Fadi Alloush,0,80.0,0,1,1,0,1,Lebanon
3652,Fadi Lafi,1,58.0,0,0,1,0,1,Palestine
3653,Fadil Vokrri,0,183.0,0,0,2,2,4,German DR
3654,Fahad Al Ansari,0,127.0,0,0,2,0,2,Kuwait
3655,Fahad Al Enezi,0,50.0,0,0,1,0,1,Kuwait
3656,Fahad Al Hajeri,0,13.0,0,0,1,0,1,Kuwait
3657,Fahad Al Hamad,0,82.0,0,0,1,0,1,Kuwait
3658,Fahad Al Kuwari,2,182.0,0,1,1,2,3,Qatar
3659,Fahad Al-Bishi,5,312.0,0,2,5,2,7,China PR
3660,Fahad Al-Ghesheyan,1,85.0,0,0,1,0,1,Saudi Arabia
3661,Fahad Al-Mehallel,8,471.0,0,0,7,3,10,Macau
3662,Fahad Al-Musaibeah,1,13.0,0,0,1,0,1,Saudi Arabia
3663,Fahad Al-Muwallad,2,576.0,0,0,8,2,10,Saudi Arabia
3664,Fahad Al-Rashidi,0,81.0,0,0,1,0,1,Kuwait
3665,Fahad Bayo,0,152.0,0,0,2,1,3,Rwanda
3666,Fahad Fallata,0,65.0,0,0,1,0,1,Saudi Arabia
3667,Fahad Khamees,2,183.0,0,0,4,1,5,United Arab Emirates
3668,Fahad Khamis Mubarak,0,61.0,0,0,0,1,1,Singapore
3669,Fahad Yousef Al-Sovayed,0,26.0,0,0,1,0,1,Kuwait
3670,Fahd Ali,0,45.0,0,0,1,0,1,United Arab Emirates
3671,Fahed Masoud,0,90.0,0,0,0,1,1,Brunei
3672,Fahid Ben Khalfallah,0,43.0,0,0,1,0,1,Tunisia
3673,Fahreddin Cansever,0,115.0,0,0,3,0,3,Turkey
3674,Fahrudin Mustafić,0,75.0,0,1,2,0,2,Singapore
3675,Faisal Agab,1,139.0,0,1,2,1,3,Sudan
3676,Faisal Ajab Al-Azemi,0,81.0,0,0,1,0,1,Kuwait
3677,Faisal Al Badri,1,53.0,0,2,2,0,2,Libya
3678,Faisal Al Otaibi,0,7.0,0,0,0,1,1,Lebanon
3679,Faisal Al-Dakhil,4,969.0,0,1,16,4,20,Kuwait
3680,Faisal Antar,2,86.0,0,0,0,3,3,Pakistan
3681,Faisal Aziz Rashed,1,43.0,0,0,0,1,1,Jordan
3682,Faisal Bushaala,0,45.0,0,0,0,1,1,Mali
3683,Faisal Khalil,1,272.0,0,0,2,2,4,United Arab Emirates
3684,Faisal Zayid,1,108.0,0,0,2,0,2,Kuwait
3685,Faitalia Hamilton-Pama,1,18.0,0,0,1,0,1,Samoa
3686,Faiz Nasir,0,78.0,0,0,1,0,1,Malaysia
3687,Fakhreddine Ben Youssef,1,140.0,0,0,0,2,2,Sierra Leone
3688,Falah Hassan,1,85.0,0,0,1,0,1,Iraq
3689,Falimery Ramanamahefa,0,108.0,0,0,2,0,2,Madagascar
3690,Famara Diédhiou,4,271.0,0,0,2,4,6,Senegal
3691,Fan Zhiyi,2,536.0,1,4,6,4,10,Vietnam
3692,Fandi Ahmad,1,227.0,0,0,2,2,4,Vietnam
3693,Faneva Imà Andriatsima,1,280.0,0,1,6,0,6,Madagascar
3694,Fanis Theofanous,0,21.0,0,0,1,0,1,Cyprus
3695,Fanny Hangunyu,0,44.0,0,0,1,0,1,Zambia
3696,Fantamady Keita,4,274.0,0,0,3,2,5,Mali
3697,Faouzi Ghoulam,1,154.0,0,1,3,0,3,Algeria
3698,Faouzi Mansouri,0,14.0,0,0,1,0,1,Algeria
3699,Faouzi Mubarak Aaish,2,186.0,0,2,3,1,4,Bahrain
3700,Faouzi Rouissi,0,103.0,0,2,3,0,3,Tunisia
3701,Faraj Al-Bor'osi,0,89.0,0,0,1,0,1,Libya
3702,Faraj Laheeb,0,247.0,0,0,3,0,3,Kuwait
3703,Fares Aouni,0,175.0,0,0,0,4,4,Namibia
3704,Fares Juma,0,70.0,1,0,1,0,1,Saudi Arabia
3705,Farhad Majidi,2,322.0,0,0,3,2,5,Kyrgyzstan
3706,Farhat Haitbaev,2,136.0,0,0,0,2,2,Maldives
3707,Farhat Musabekov,1,34.0,0,0,0,1,1,Myanmar
3708,Farhod Tadjiyev,0,132.0,0,0,3,0,3,Uzbekistan
3709,Farid Al Masori,1,78.0,0,0,0,1,1,Nepal
3710,Farid Ghazi,1,12.0,0,0,1,0,1,Algeria
3711,Faris Ramli,0,68.0,0,0,2,0,2,Singapore
3712,Farkhod Vosiyev,0,57.0,0,0,0,1,1,Myanmar
3713,Farlen Ilama,0,16.0,0,0,1,0,1,Costa Rica
3714,Faroug Jabra,0,8.0,0,0,1,0,1,Sudan
3715,Farouk Gaafar,0,55.0,0,1,2,0,2,Egypt
3716,Farouk Ibrahim Al Awadi Al Saleh,0,24.0,0,0,0,1,1,Qatar
3717,Farouk Miya,1,212.0,0,0,4,1,5,Togo
3718,Farrukh Ismayilov,0,268.0,0,0,3,0,3,Azerbaijan
3719,Farshad Noor,1,27.0,0,0,1,0,1,Afghanistan
3720,Farshad Pious,2,296.0,0,0,4,2,6,Qatar
3721,Faruk Hadžibegić,0,216.0,0,3,3,1,4,Yugoslavia
3722,Faruq Ibrahim,1,11.0,0,0,0,1,1,Iraq
3723,Fashion Sakala,0,290.0,0,1,4,1,5,Zambia
3724,Fat'hi Kameel Fayaz Matar Marzouq,1,127.0,0,0,1,2,3,Bahrain
3725,Fatai Amoo,0,12.0,0,0,0,1,1,Kenya
3726,Fathi Jaber,0,76.0,0,0,0,1,1,North Korea
3727,Fathi Kameel,3,412.0,0,0,3,4,7,Iran
3728,Fatih Tekke,0,382.0,0,0,3,4,7,Turkey
3729,Fatih Terim,0,128.0,0,1,2,0,2,Turkey
3730,Fatkhullo Fatkhuloev,0,88.0,0,0,0,1,1,Bangladesh
3731,Fatos Bećiraj,0,484.0,0,1,6,6,12,San Marino
3732,Faustino Asprilla,2,556.0,0,0,8,4,12,Argentina
3733,Faustino Delgado,0,3.0,0,1,1,0,1,Peru
3734,Fausto De Amicis,1,144.0,0,0,2,0,2,Australia
3735,Fausto Klinger,0,77.0,0,0,0,1,1,Uruguay
3736,Fawaz Al Ahmad,0,114.0,0,0,2,0,2,Kuwait
3737,Fawzi Al-Issawi,0,76.0,0,0,1,0,1,Libya
3738,Fawzi Bashir,0,171.0,0,0,3,0,3,Oman
3739,Fawzi Bashir Doorbeen,0,52.0,0,0,1,0,1,Oman
3740,Fawzi El-Aisawi,0,22.0,0,1,1,0,1,Libya
3741,Fawzi Moussouni,1,53.0,0,0,0,1,1,South Africa
3742,Fayad Mahmoud,1,44.0,0,1,0,1,1,Saudi Arabia
3743,Fayez Al-Felaij,1,90.0,0,0,1,0,1,Kuwait
3744,Fayez Marzouq,0,87.0,0,0,0,1,1,Thailand
3745,Faysal Shayesteh,1,78.0,0,0,0,1,1,Syria
3746,Fayçal Fajr,0,80.0,0,0,1,0,1,Morocco
3747,Fazrul Nawaz,1,215.0,0,0,2,2,4,Singapore
3748,Federico Bernardeschi,0,163.0,0,0,2,1,3,Italy
3749,Federico Bikoro,0,82.0,0,0,0,1,1,Zambia
3750,Federico Chiesa,2,252.0,0,0,4,0,4,Italy
3751,Federico Magallanes,0,82.0,0,2,3,0,3,Uruguay
3752,Federico Peluso,0,90.0,0,0,1,0,1,Italy
3753,Federico Vairo,1,51.0,0,0,1,0,1,Argentina
3754,Federico Valverde,0,197.0,0,0,1,2,3,Paraguay
3755,Fedor Černych,0,425.0,0,0,7,2,9,Lithuania
3756,Feisal Salum,0,53.0,0,0,1,0,1,Tanzania
3757,Feiz Shamsin,0,75.0,0,0,0,1,1,Laos
3758,Fekri Al-Hubaishi,0,66.0,0,0,1,0,1,Yemen
3759,Felicien Minde,0,74.0,0,0,1,0,1,Tanzania
3760,Felipe Baloy,1,236.0,1,0,3,1,4,Panama
3761,Felipe Buffoni,1,43.0,0,0,0,1,1,Argentina
3762,Felipe Caicedo,2,859.0,0,6,8,9,17,Ecuador
3763,Felipe Cata Edson,0,55.0,0,0,0,1,1,Eswatini
3764,Felipe Gutiérrez,0,101.0,0,0,2,0,2,Chile
3765,Felipe Melo,1,71.0,0,0,1,1,2,Brazil
3766,Felipe Rosas,0,72.0,0,0,1,0,1,Mexico
3767,Felitciano Zschusschen,0,39.0,0,1,1,0,1,Curaçao
3768,Felix Aboagye,1,110.0,0,0,1,1,2,Mozambique
3769,Felix Gasselich,0,123.0,0,0,1,1,2,Austria
3770,Felix Katongo,1,90.0,0,0,1,1,2,Sudan
3771,Felix Khojoyan,0,50.0,0,0,0,1,1,Belarus
3772,Felix Magath,0,33.0,0,0,1,1,2,Austria
3773,Felix Michel Melki,1,27.0,0,0,1,0,1,Lebanon
3774,Felix Owolabi,0,49.0,0,0,1,1,2,Nigeria
3775,Felix Tagawa,7,422.0,0,0,0,7,7,Vanuatu
3776,Fenedy Masauvakalo,1,41.0,0,0,0,1,1,Fiji
3777,Feng Ji-zhi,1,78.0,1,0,1,1,2,Hong Kong
3778,Feras Esmaeel,0,17.0,0,0,0,1,1,Indonesia
3779,Feras Shelbaieh,0,56.0,0,1,1,0,1,Jordan
3780,Ferdinando Riva,0,35.0,0,0,0,1,1,Scotland
3781,Ferenc Bene,5,933.0,0,0,12,13,25,German DR
3782,Ferenc Horváth,0,206.0,0,0,3,1,4,Hungary
3783,Ferenc Machos,0,118.0,0,0,4,0,4,Hungary
3784,Ferenc Mészáros,0,79.0,0,0,1,1,2,Poland
3785,Ferenc Orosz,0,15.0,0,0,1,0,1,Hungary
3786,Ferenc Puskás,4,124.0,0,0,2,2,4,Hungary
3787,Ferenc Sipos,0,24.0,0,0,1,0,1,Hungary
3788,Ferhan Hasani,0,59.0,0,0,1,0,1,North Macedonia
3789,Ferjani Sassi,2,87.0,0,1,1,1,2,Tunisia
3790,Fernand Brosius,0,50.0,1,0,1,0,1,Portugal
3791,Fernand Coulibaly,0,25.0,0,0,0,1,1,Tunisia
3792,Fernandinho,1,97.0,1,0,1,1,2,Brazil
3793,Fernando Amorebieta,0,62.0,0,0,1,0,1,Venezuela
3794,Fernando Arce,1,205.0,0,0,4,0,4,Mexico
3795,Fernando Astengo,2,161.0,0,0,1,1,2,Chile
3796,Fernando Baldeón,0,60.0,0,0,0,2,2,Chile
3797,Fernando Cabrita,0,36.0,0,0,0,1,1,Spain
3798,Fernando Chalana,0,71.0,0,0,1,1,2,Cyprus
3799,Fernando Consul,1,83.0,0,0,1,0,1,Brazil
3800,Fernando Cornejo,0,52.0,0,0,0,1,1,Argentina
3801,Fernando Couto,1,252.0,0,0,4,0,4,Portugal
3802,Fernando Cáceres,0,69.0,0,0,1,0,1,Argentina
3803,Fernando Fiorillo,0,69.0,0,0,1,0,1,Colombia
3804,Fernando Francisco,0,90.0,0,0,0,1,1,Libya
3805,Fernando Gomes,0,503.0,0,0,4,5,9,Scotland
3806,Fernando Gómez Colomer,0,63.0,0,0,1,0,1,Spain
3807,Fernando Hierro,6,1275.0,1,10,20,6,26,Spain
3808,Fernando Jiménez,0,40.0,0,0,1,0,1,Costa Rica
3809,Fernando Kanapkis,1,181.0,0,0,3,1,4,Uruguay
3810,Fernando Llorente,0,254.0,0,0,2,2,4,South Africa
3811,Fernando Manuel Co,0,47.0,0,0,0,1,1,Guinea
3812,Fernando Manuel Sousa,0,51.0,0,0,1,0,1,Angola
3813,Fernando Marcos,0,55.0,0,0,1,0,1,Mexico
3814,Fernando Meira,0,21.0,0,0,1,0,1,Portugal
3815,Fernando Morena,0,242.0,0,3,5,1,6,Ecuador
3816,Fernando Morientes,6,690.0,0,0,10,2,12,Spain
3817,Fernando Navarro Morán,1,72.0,0,0,0,1,1,Martinique
3818,Fernando Ochoaizpur,0,48.0,0,0,1,0,1,Bolivia
3819,Fernando Peres,0,176.0,0,1,2,0,2,Portugal
3820,Fernando Peyroteo,1,72.0,0,1,0,1,1,Switzerland
3821,Fernando Quirarte,0,77.0,0,0,2,0,2,Mexico
3822,Fernando Redondo,0,65.0,0,0,0,1,1,Paraguay
3823,Fernando Riera,4,227.0,0,0,2,2,4,Argentina
3824,Fernando Saucedo,0,83.0,0,0,1,0,1,Bolivia
3825,Fernando Silva,0,143.0,0,0,0,2,2,Armenia
3826,Fernando Torres,17,1369.0,0,3,14,14,28,Spain
3827,Fernando Varela,1,81.0,0,0,1,0,1,Cape Verde
3828,Fernando Vergara,1,52.0,0,0,1,0,1,Chile
3829,Ferran Torres,3,452.0,0,1,5,3,8,Georgia
3830,Ferydoon Zandi,1,53.0,0,0,0,2,2,China PR
3831,Fevzi Davletov,0,5.0,0,0,0,1,1,Oman
3832,Fevzi Zemzem,0,46.0,0,0,1,1,2,Portugal
3833,Feyyaz Uçar,0,433.0,0,1,3,4,7,Turkey
3834,Fidel Escobar,0,22.0,0,0,0,1,1,Honduras
3835,Fidel Martínez,0,74.0,0,0,1,1,2,Ecuador
3836,Fikru Tefera,0,130.0,0,1,2,0,2,Ethiopia
3837,Filip Hološko,0,312.0,0,0,3,2,5,Slovakia
3838,Filip Ivanovski,0,86.0,0,0,1,0,1,North Macedonia
3839,Filip Kostić,0,141.0,0,0,2,1,3,Serbia
3840,Filip Novák,0,71.0,0,0,1,0,1,Czech Republic
3841,Filip Stojković,0,89.0,1,0,1,0,1,Poland
3842,Filip Đorđević,0,8.0,0,0,0,1,1,Wales
3843,Filip Đuričić,0,163.0,0,0,3,0,3,Serbia
3844,Filip Šebo,0,112.0,0,0,2,1,3,Slovakia
3845,Filipe Duarte,0,52.0,0,0,1,0,1,Macau
3846,Filipe Luís,0,114.0,0,0,2,0,2,Brazil
3847,Filipo Bureta,0,81.0,1,0,1,0,1,Australia
3848,Filippo Berardi,0,77.0,0,0,1,0,1,San Marino
3849,Filippo Fabbri,0,15.0,1,0,0,1,1,San Marino
3850,Filippo Inzaghi,3,901.0,0,2,12,10,22,Denmark
3851,Fillisione Taufahema,1,78.0,0,0,1,0,1,Tonga
3852,Finidi George,1,177.0,0,0,2,2,4,Nigeria
3853,Finn Laudrup,0,71.0,0,0,2,0,2,Denmark
3854,Finn Seemann,0,9.0,0,0,1,0,1,Norway
3855,Firas Al-Buraikan,0,191.0,0,0,3,0,3,Saudi Arabia
3856,Firas Al-Khatib,1,254.0,0,2,2,3,5,Syria
3857,Firas Issmael,1,64.0,0,0,0,1,1,Afghanistan
3858,Firmin Ndombe Mubele,2,370.0,0,0,1,4,5,Burundi
3859,Firmin Sanou,0,42.0,0,1,0,1,1,Kenya
3860,Fiston Abdul Razak,0,212.0,0,1,2,2,4,Seychelles
3861,Fitzroy Simpson,1,62.0,0,0,1,0,1,Jamaica
3862,Fivos Vrahimis,0,158.0,0,0,1,2,3,Cyprus
3863,Flavio Maestri,0,268.0,0,0,3,2,5,Chile
3864,Flavius Domide,0,74.0,0,0,1,0,1,Romania
3865,Flemming Povlsen,1,594.0,0,0,7,5,12,Denmark
3866,Fleury Di Nallo,0,255.0,0,0,2,3,5,France
3867,Florea Dumitrache,2,592.0,0,2,6,6,12,Romania
3868,Florea Martinovici,0,15.0,0,0,1,0,1,Romania
3869,Florea Văetuș,0,16.0,0,0,1,0,1,Romania
3870,Florencio Amarilla,2,174.0,0,1,3,2,5,Paraguay
3871,Florent Hadergjonaj,0,29.0,0,0,0,1,1,North Macedonia
3872,Florent Malouda,0,188.0,0,0,1,4,5,Georgia
3873,Florent Rouamba,0,75.0,0,0,0,1,1,Uganda
3874,Florentin Petre,0,187.0,0,0,2,2,4,Azerbaijan
3875,Florian Bohnert,0,90.0,0,0,0,1,1,Bulgaria
3876,Florian Jozefzoon,1,70.0,0,0,0,1,1,Aruba
3877,Florian Myrtaj,0,53.0,0,0,1,0,1,Albania
3878,Florian Thauvin,0,45.0,0,0,0,1,1,Andorra
3879,Florin Andone,0,59.0,0,0,1,0,1,Romania
3880,Florin Bratu,0,77.0,0,0,1,0,1,Romania
3881,Florin Cernat,0,18.0,0,0,0,2,2,Andorra
3882,Florin Răducioiu,10,1174.0,0,2,7,14,21,Romania
3883,Florin Tănase,0,28.0,0,0,1,0,1,Romania
3884,Floros Nicolaou,0,62.0,0,0,0,1,1,Scotland
3885,Floyd Ayité,0,71.0,0,0,1,0,1,Togo
3886,Floyd Guthrie,1,10.0,0,0,0,1,1,Jamaica
3887,Flávio Amado,5,547.0,0,1,8,5,13,Angola
3888,Flávio Conceição,1,28.0,0,0,1,0,1,Brazil
3889,Flávio Minuano,3,234.0,0,0,3,2,5,Brazil
3890,Flórián Albert,4,312.0,0,0,5,6,11,Hungary
3891,Flórián Urbán,0,77.0,0,0,0,1,1,Azerbaijan
3892,Fodé Camara,0,224.0,0,1,5,0,5,Guinea
3893,Fodé Mansaré,0,132.0,0,0,2,0,2,Guinea
3894,Fortunato Castillo,0,131.0,0,0,4,0,4,Bolivia
3895,Fotis Papoulis,0,46.0,0,0,1,1,2,San Marino
3896,Fouad Bushegir,1,90.0,0,0,0,1,1,Syria
3897,Foxi Kéthévoama,0,68.0,0,0,2,0,2,Central African Republic
3898,Fran,0,104.0,0,0,1,1,2,Spain
3899,Fran Karačić,1,38.0,0,0,0,1,1,Nepal
3900,Fran Núñez,0,52.0,0,0,1,0,1,Dominican Republic
3901,Francesco Acerbi,0,21.0,0,0,0,1,1,Bosnia and Herzegovina
3902,Francesco Graziani,1,340.0,0,0,6,2,8,Luxembourg
3903,Francesco Totti,2,368.0,0,2,5,3,8,Belgium
3904,Franchel Ibara,0,67.0,0,0,1,0,1,Congo
3905,Francileudo Santos,8,851.0,0,0,14,4,18,Tunisia
3906,Francis Doe,0,15.0,0,0,0,1,1,Senegal
3907,Francis Dupont,0,81.0,0,0,1,0,1,Saint Vincent and the Grenadines
3908,Francis Kahata,0,35.0,0,0,0,1,1,Nigeria
3909,Francis Kasonde,0,56.0,0,0,0,1,1,Egypt
3910,Francis Lee,0,206.0,0,0,3,0,3,England
3911,Francis N'Ganga,0,104.0,0,0,2,0,2,Congo
3912,Francis Niakuam,0,80.0,0,0,1,0,1,Papua New Guinea
3913,Francis Ouma,0,70.0,0,0,0,1,1,Guinea
3914,Francis Oumar,0,210.0,0,0,3,0,3,Chad
3915,Francis Were,0,44.0,0,0,0,1,1,Burkina Faso
3916,Francisco Antonio Pavón,0,40.0,0,0,1,0,1,Honduras
3917,Francisco Arce,1,93.0,0,1,1,2,3,Uruguay
3918,Francisco Atura,1,43.0,0,0,1,0,1,Palestine
3919,Francisco Calvo,1,43.0,0,0,2,0,2,Costa Rica
3920,Francisco Flores,0,155.0,0,0,4,0,4,Mexico
3921,Francisco Fonseca,4,718.0,0,0,8,5,13,Saint Kitts and Nevis
3922,Francisco Gento,0,231.0,0,0,2,1,3,Spain
3923,Francisco González,1,33.0,0,0,1,0,1,Colombia
3924,Francisco Higuera,0,18.0,0,0,0,1,1,Cyprus
3925,Francisco Hormazábal,0,45.0,0,0,1,0,1,Chile
3926,Francisco Javier Aguilar García,0,63.0,0,0,1,0,1,Spain
3927,Francisco Javier Cruz,0,84.0,0,0,0,1,1,Canada
3928,Francisco Javier Rodríguez,1,83.0,0,0,0,1,1,South Africa
3929,Francisco José Carrasco,1,254.0,0,1,1,3,4,Malta
3930,Francisco Llorente Gento,0,67.0,0,0,1,0,1,Spain
3931,Francisco Lojacono,0,53.0,0,1,0,1,1,Israel
3932,Francisco López Contreras,0,112.0,0,0,1,1,2,Costa Rica
3933,Francisco Massinga,0,59.0,0,0,1,0,1,Mozambique
3934,Francisco Molina,7,345.0,0,0,5,2,7,Chile
3935,Francisco Palacios,0,90.0,0,0,1,0,1,Panama
3936,Francisco Palencia,4,557.0,0,0,4,5,9,Saudi Arabia
3937,Francisco Ramírez,0,137.0,0,0,2,3,5,Jamaica
3938,Francisco Rodrigues,2,69.0,0,0,0,2,2,Bolivia
3939,Francisco Rojas,0,33.0,0,0,1,0,1,Costa Rica
3940,Francisco Rui Marcos,0,55.0,0,1,1,0,1,Mozambique
3941,Francisco Socorro,0,37.0,0,0,0,1,1,Haiti
3942,Francisco Uribe,0,401.0,0,0,4,3,7,Saint Vincent and the Grenadines
3943,Francisco Valdés,1,193.0,0,0,3,0,3,Chile
3944,Francisco Varallo,1,189.0,0,0,4,0,4,Argentina
3945,Francisco Vital,0,58.0,0,0,1,0,1,Portugal
3946,Francisco Zuluaga,1,19.0,0,1,1,0,1,Colombia
3947,Franck Doté,1,26.0,0,0,0,1,1,Ghana
3948,Franck Kessié,2,88.0,0,1,2,0,2,Ivory Coast
3949,Franck Pangop,0,88.0,0,0,1,0,1,Cameroon
3950,Franck Ribéry,1,536.0,0,1,5,5,10,Spain
3951,Franck Sauzée,0,201.0,0,0,4,2,6,Yugoslavia
3952,Franco Causio,1,94.0,0,0,1,1,2,Italy
3953,Franco Navarro,1,332.0,0,0,3,3,6,Peru
3954,Franco Paonessa,0,6.0,0,0,1,0,1,Puerto Rico
3955,Francois Croes,1,27.0,1,0,0,1,1,Aruba
3956,Francois Sakama,0,109.0,0,0,1,1,2,New Zealand
3957,Frane Matošić,0,71.0,0,0,1,0,1,Yugoslavia
3958,Franjo Vladić,0,50.0,0,0,1,0,1,Yugoslavia
3959,Frank Arnesen,3,356.0,0,4,7,3,10,Denmark
3960,Frank Fabra,2,40.0,1,0,1,1,2,Colombia
3961,Frank Farina,0,45.0,0,0,1,0,1,Australia
3962,Frank Feltscher,0,78.0,0,0,0,1,1,Colombia
3963,Frank Klopas,1,20.0,0,0,0,1,1,Argentina
3964,Frank Lampard,2,861.0,0,8,10,9,19,France
3965,Frank Leboeuf,1,214.0,0,1,2,1,3,France
3966,Frank McAvennie,0,59.0,0,0,1,0,1,Scotland
3967,Frank O'Farrell,0,88.0,0,0,1,0,1,Republic of Ireland
3968,Frank O'Neill,0,60.0,0,0,1,0,1,Republic of Ireland
3969,Frank Odoi,1,223.0,0,0,1,2,3,Tunisia
3970,Frank Pingel,1,245.0,0,0,3,2,5,Faroe Islands
3971,Frank Rijkaard,2,254.0,0,0,4,0,4,Netherlands
3972,Frank Seator,0,10.0,0,0,0,1,1,Ghana
3973,Frank Sinalo,0,91.0,0,0,2,0,2,Malawi
3974,Frank Stapleton,0,642.0,0,1,10,5,15,Denmark
3975,Frank Strandli,0,59.0,0,0,1,0,1,Norway
3976,Frank Sturing,1,6.0,0,0,0,1,1,Cayman Islands
3977,Frank Wallace,3,118.0,0,0,1,2,3,Cuba
3978,Frank de Boer,0,529.0,0,1,6,2,8,Finland
3979,Frankie Beauchamp,2,124.0,0,0,0,2,2,Samoa
3980,Frankie Hejduk,1,175.0,0,0,1,2,3,Guatemala
3981,Frankie Oviedo,0,125.0,0,0,1,2,3,Colombia
3982,Franklin Salas,1,139.0,0,0,1,1,2,Ecuador
3983,Franklyn Baptiste,0,44.0,0,0,1,0,1,Grenada
3984,Franky Vercauteren,2,394.0,0,0,4,5,9,Portugal
3985,Frans Geurtsen,0,87.0,0,0,0,1,1,Albania
3986,Frans Janssens,0,28.0,0,0,1,0,1,Belgium
3987,Frans Thijssen,0,115.0,0,0,2,1,3,Netherlands
3988,František Karkó,0,172.0,0,0,0,2,2,Finland
3989,František Knebort,0,164.0,0,0,2,2,4,Czechoslovakia
3990,František Pelcner,0,77.0,0,0,0,1,1,Poland
3991,František Svoboda,1,24.0,0,0,1,0,1,Czechoslovakia
3992,František Veselý,2,263.0,0,0,3,0,3,Czechoslovakia
3993,František Vlk,0,108.0,0,0,1,2,3,Czechoslovakia
3994,František Šafránek,0,38.0,0,1,0,1,1,Romania
3995,František Štambachr,0,140.0,0,0,1,1,2,Czechoslovakia
3996,Frantz Bertin,0,90.0,0,0,1,0,1,Haiti
3997,Frantzdy Pierrot,2,372.0,0,0,2,3,5,Haiti
3998,Franz Aigner,0,22.0,0,0,0,1,1,Liechtenstein
3999,Franz Beckenbauer,5,297.0,0,0,4,1,5,Germany
4000,Franz Binder,0,33.0,0,0,1,0,1,Austria
4001,Franz Burgmeier,0,391.0,1,0,3,3,6,Liechtenstein
4002,Franz Hasil,0,58.0,0,1,1,0,1,Austria
4003,Franz Schiemer,0,159.0,0,0,0,3,3,Romania
4004,Franz Schädler,0,78.0,0,0,1,0,1,Liechtenstein
4005,Franz Wolny,0,54.0,0,0,0,1,1,Russia
4006,François Amégasse,0,37.0,0,0,1,0,1,Gabon
4007,François Heutte,0,182.0,0,0,2,1,3,Austria
4008,François Kamano,2,73.0,0,1,1,1,2,Guinea
4009,François M'Pelé,3,171.0,0,0,3,0,3,Congo
4010,François N'Doumbé,0,67.0,0,0,1,0,1,Cameroon
4011,François Omam-Biyik,5,360.0,0,1,6,5,11,Gabon
4012,François Tahi,0,89.0,0,0,0,1,1,Sudan
4013,François Van der Elst,0,472.0,0,0,5,5,10,Belgium
4014,François Vanden Eynde,2,107.0,0,0,0,2,2,Republic of Ireland
4015,François de Vries,0,59.0,0,0,0,1,1,Luxembourg
4016,Frazer Kamwandi,0,88.0,0,0,2,0,2,Zambia
4017,Fred,2,474.0,0,0,8,0,8,Brazil
4018,Fred Masella,0,35.0,0,0,0,1,1,Costa Rica
4019,Freddie Ljungberg,2,601.0,0,1,5,7,12,Poland
4020,Freddie Mwila,0,179.0,0,0,3,0,3,Zambia
4021,Freddy,0,52.0,0,0,1,0,1,Angola
4022,Freddy Adu,0,76.0,0,0,2,0,2,United States
4023,Freddy Eastwood,0,22.0,0,0,0,1,1,Slovakia
4024,Freddy Elie,0,89.0,0,0,1,0,1,Venezuela
4025,Freddy Fernández,0,30.0,0,0,0,1,1,El Salvador
4026,Freddy García,1,409.0,0,0,7,2,9,Belize
4027,Freddy Grisales,0,81.0,0,0,3,1,4,Colombia
4028,Freddy Góndola,0,52.0,0,0,1,0,1,Panama
4029,Freddy Rincón,5,549.0,0,0,3,8,11,Germany
4030,Freddy Vava,1,90.0,0,0,1,0,1,Vanuatu
4031,Frederic Remi,0,3.0,0,0,0,1,1,Namibia
4032,Frederick Gomez,0,120.0,0,0,1,1,2,Aruba
4033,Frederico Rosa,0,176.0,1,0,1,2,3,Portugal
4034,Fredi Bobić,0,266.0,0,0,2,3,5,Armenia
4035,Fredrik Jensen,0,45.0,0,0,1,1,2,Armenia
4036,Fredrik Strømstad,0,105.0,0,0,1,1,2,Hungary
4037,Fredy Bareiro,1,71.0,0,0,0,1,1,Brazil
4038,Fredy Guarín,0,11.0,0,0,1,0,1,Colombia
4039,Fredy Thompson,0,77.0,0,0,0,1,1,Grenada
4040,Frenkie de Jong,0,108.0,0,0,0,2,2,Germany
4041,Friaça,0,47.0,0,0,1,0,1,Brazil
4042,Fricis Kaņeps,0,203.0,0,1,3,2,5,Latvia
4043,Frickson Erazo,0,81.0,0,0,0,1,1,Argentina
4044,Friday Ekpo,1,75.0,0,0,0,1,1,Cameroon
4045,Friedrich Scherfke,1,23.0,0,1,0,1,1,Brazil
4046,Friso Mando,0,36.0,0,2,1,1,2,Suriname
4047,Fritz Künzli,0,524.0,0,0,7,3,10,Romania
4048,Fritz Szepan,0,8.0,0,0,1,0,1,Germany
4049,Fritz Walter,3,304.0,0,2,2,3,5,Norway
4050,Frode Johnsen,0,87.0,0,0,1,0,1,Norway
4051,Froylán Ledezma,1,140.0,0,0,3,0,3,Costa Rica
4052,Frédéric Chassot,0,87.0,0,0,0,1,1,San Marino
4053,Frédéric Kanouté,6,897.0,0,2,8,9,17,Kenya
4054,Frédéric Mendy,0,11.0,0,0,0,1,1,Sudan
4055,Fróði Benjaminsen,0,114.0,1,1,2,2,4,Italy
4056,Fu Weng Lei,0,87.0,0,0,1,0,1,Macau
4057,Fuad Abou Shaqr,1,105.0,0,0,1,1,2,Bahrain
4058,Fuad Anwar,2,63.0,0,0,1,1,2,Netherlands
4059,Fulgencio Berdugo,3,133.0,0,0,1,2,3,Colombia
4060,Fulvio Collovati,0,40.0,0,0,1,1,2,Luxembourg
4061,Fulvio Nesti,0,67.0,0,0,0,1,1,Switzerland
4062,Fung Chi Ming,1,15.0,0,0,0,1,1,Malaysia
4063,Fung Hing Wa,1,11.0,1,0,0,1,1,Hong Kong
4064,Fyodor Cherenkov,1,140.0,0,0,3,0,3,Russia
4065,Fyodor Kudryashov,0,117.0,1,0,2,0,2,Russia
4066,Fyodor Smolov,0,371.0,0,0,5,1,6,Liechtenstein
4067,Fábio Abreu,0,68.0,0,0,1,0,1,Angola
4068,Fábio Coentrão,0,153.0,0,0,1,1,2,Israel
4069,Fábio César Montezine,0,212.0,0,0,4,0,4,Qatar
4070,Fábio Virginio de Lima,0,289.0,0,0,5,0,5,United Arab Emirates
4071,Félix Arambulo,1,50.0,0,0,0,1,1,Colombia
4072,Félix Castillo,6,310.0,0,0,1,6,7,Paraguay
4073,Félix Lasso,0,127.0,0,0,1,1,2,Chile
4074,Félix Loustau,6,417.0,0,0,7,0,7,Argentina
4075,Félix Ricardo Torres,0,68.0,0,0,1,0,1,Paraguay
4076,Félix Rodríguez,0,36.0,0,0,0,1,1,Dominica
4077,Félix Torres,0,163.0,0,0,2,0,2,Ecuador
4078,Férébory Doré,1,79.0,0,0,2,0,2,Congo
4079,Gabadinho Mhango,3,179.0,0,0,2,2,4,Namibia
4080,Gabino Sosa,6,225.0,0,0,6,0,6,Argentina
4081,Gabriel Achilier,0,30.0,0,0,0,1,1,Peru
4082,Gabriel Barbosa,1,316.0,0,1,3,1,4,Brazil
4083,Gabriel Batistuta,26,1635.0,0,7,28,9,37,Argentina
4084,Gabriel Cedrés,0,184.0,0,0,2,1,3,Uruguay
4085,Gabriel Cichero,1,80.0,0,0,0,1,1,Chile
4086,Gabriel Enrique Gómez,2,192.0,0,2,3,1,4,Panama
4087,Gabriel Gnimassou,0,65.0,0,0,1,0,1,Burkina Faso
4088,Gabriel González,0,30.0,0,0,1,0,1,Paraguay
4089,Gabriel Heinze,2,64.0,1,0,1,2,3,Mexico
4090,Gabriel Jaime Gómez Jaramillo,0,8.0,0,0,0,1,1,Argentina
4091,Gabriel Jesus,0,495.0,0,0,5,4,9,Ecuador
4092,Gabriel Mendes,0,55.0,1,0,1,0,1,Sweden
4093,Gabriel Mercado,1,93.0,0,0,1,2,3,Chile
4094,Gabriel Michel,0,76.0,0,0,3,0,3,Haiti
4095,Gabriel Milito,0,16.0,0,0,0,1,1,Venezuela
4096,Gabriel Miranda,1,88.0,0,0,1,1,2,Paraguay
4097,Gabriel Nzeyimana,0,90.0,0,0,0,1,1,Gabon
4098,Gabriel Riera,0,36.0,0,0,0,1,1,Czech Republic
4099,Gabriel Tamaş,0,105.0,0,0,1,1,2,Slovenia
4100,Gabriel Torje,0,227.0,0,1,1,4,5,Luxembourg
4101,Gabriel Torres,8,890.0,0,5,14,4,18,Mexico
4102,Gabriel Urdaneta,1,111.0,0,1,1,2,3,Mexico
4103,Gabriel Wajoka,2,90.0,0,0,2,0,2,Tahiti
4104,Gabriel Ávalos,1,90.0,0,0,0,1,1,Peru
4105,Gadi Brumer,0,65.0,0,0,1,0,1,Israel
4106,Gaetano Scirea,0,81.0,0,0,0,1,1,Greece
4107,Gafurzhan Suyumbayev,0,104.0,0,0,1,2,3,Denmark
4108,Gagny Coulibaly,1,68.0,0,1,0,1,1,Burkina Faso
4109,Gahrymanberdi Çoňkaýew,0,87.0,0,0,0,1,1,Indonesia
4110,Gaizka Mendieta,3,470.0,0,2,5,2,7,Spain
4111,Gaku Shibasaki,1,81.0,0,0,1,0,1,Japan
4112,Galabgwe Moyana,0,22.0,0,0,0,1,1,Eritrea
4113,Galimzyan Khusainov,1,17.0,0,0,1,1,2,Spain
4114,Galo Fidean Vásquez,0,68.0,0,0,1,0,1,Ecuador
4115,Gamal Abdel Azim,0,4.0,0,0,1,0,1,Egypt
4116,Gamal Abdelhamid,2,150.0,0,0,3,0,3,Egypt
4117,Gao Feng,1,235.0,0,0,1,3,4,Syria
4118,Gao Hongbo,1,378.0,0,0,4,2,6,Pakistan
4119,Gao Lin,3,280.0,1,3,1,3,4,China PR
4120,Gao Sheng,1,13.0,0,0,1,0,1,China PR
4121,Gao Wei-jie,1,62.0,0,0,0,1,1,Australia
4122,Garath McCleary,2,85.0,0,0,1,1,2,Costa Rica
4123,Garba Lawal,3,214.0,0,0,3,1,4,Nigeria
4124,Garba Okoye,0,168.0,0,0,3,1,4,Nigeria
4125,Gareth Bale,7,1614.0,0,6,18,14,32,Wales
4126,Gareth Barry,0,40.0,0,0,0,1,1,Kazakhstan
4127,Gareth McAuley,2,492.0,2,0,5,6,11,San Marino
4128,Gareth Southgate,0,88.0,0,0,0,1,1,Luxembourg
4129,Garfield Gonsalves,0,22.0,1,0,0,1,1,Antigua and Barbuda
4130,Garnik Avalyan,0,127.0,0,1,2,0,2,Armenia
4131,Garra Dembélé,1,56.0,0,0,0,1,1,Botswana
4132,Garrincha,3,194.0,0,0,3,2,5,Brazil
4133,Garry Lund,0,56.0,1,0,0,1,1,New Zealand
4134,Garry O'Connor,0,120.0,0,0,1,1,2,Scotland
4135,Garry Rodrigues,1,260.0,0,0,0,4,4,South Africa
4136,Gary Breen,1,236.0,0,0,2,2,4,Republic of Ireland
4137,Gary Byrne,0,68.0,0,1,1,0,1,Australia
4138,Gary Cahill,0,74.0,0,0,1,1,2,Bulgaria
4139,Gary Caldwell,0,67.0,0,0,1,0,1,Scotland
4140,Gary Cole,0,477.0,0,1,7,2,9,Fiji
4141,Gary Doherty,0,196.0,0,0,1,2,3,Russia
4142,Gary Gillespie,0,58.0,1,0,1,0,1,Yugoslavia
4143,Gary Kelly,0,80.0,0,0,0,1,1,Cyprus
4144,Gary Lineker,10,1012.0,0,3,17,5,22,England
4145,Gary Mabbutt,0,21.0,0,0,1,0,1,England
4146,Gary Mackay,0,86.0,0,0,0,1,1,Bulgaria
4147,Gary McAllister,1,186.0,0,2,2,1,3,Scotland
4148,Gary McSwegan,0,50.0,0,0,1,0,1,Scotland
4149,Gary Medel,0,329.0,1,0,3,3,6,Bolivia
4150,Gary Naysmith,0,63.0,0,0,0,1,1,Iceland
4151,Gary Neville,0,68.0,1,0,1,0,1,Croatia
4152,Gary Ngassebe,1,78.0,0,0,0,1,1,Mali
4153,Gary Speed,0,307.0,0,0,3,4,7,Moldova
4154,Gary Waddock,0,23.0,0,0,1,1,2,Iceland
4155,Garðar Árnason,0,59.0,0,0,1,0,1,Iceland
4156,Gaston Bawa,1,36.0,0,0,0,1,1,Burkina Faso
4157,Gaston Taument,1,86.0,0,0,1,0,1,Netherlands
4158,Gastón Giménez,0,85.0,0,0,0,1,1,Venezuela
4159,Gastón Pereiro,0,90.0,0,0,1,0,1,Uruguay
4160,Gastón Silva,0,24.0,1,0,0,1,1,Uruguay
4161,Gatoch Panom,0,47.0,0,1,1,0,1,Ethiopia
4162,Gavi,1,74.0,0,0,1,0,1,Spain
4163,Gavin Glinton,0,74.0,0,0,1,0,1,Turks and Caicos Islands
4164,Gavril Balint,2,395.0,0,0,6,2,8,Romania
4165,Gavril Serfözö,0,27.0,0,0,0,1,1,Bulgaria
4166,Gayson Gregory,0,185.0,0,0,2,2,4,Bermuda
4167,Gaël Kakuta,0,6.0,0,0,0,1,1,Tanzania
4168,Gbassay Sessay,1,11.0,0,0,1,0,1,Sierra Leone
4169,Gebremedhin Haile,0,9.0,0,0,1,0,1,Ethiopia
4170,Gedo,5,435.0,0,0,3,2,5,Egypt
4171,Geir Frigård,0,88.0,0,0,1,0,1,Norway
4172,Geir Karlsen,0,69.0,1,0,0,1,1,Norway
4173,Gelson,0,2.0,0,0,1,0,1,Angola
4174,Gelson Fernandes,1,142.0,0,0,0,2,2,Moldova
4175,Genar Andrinúa,0,3.0,0,0,0,1,1,Northern Ireland
4176,Genc Tomorri,0,22.0,0,0,0,1,1,Germany
4177,Genki Haraguchi,3,440.0,0,1,3,6,9,Japan
4178,Gennadi Bliznyuk,0,78.0,0,0,2,0,2,Belarus
4179,Gennadi Gusarov,0,45.0,0,0,0,2,2,Turkey
4180,Gennady Yevryuzhikhin,0,77.0,0,0,2,1,3,Cyprus
4181,Genrich Fedosov,1,75.0,0,0,0,1,1,Poland
4182,Geny Catamo,0,158.0,0,1,1,1,2,Mozambique
4183,Geoff Aunger,1,151.0,0,0,3,0,3,Canada
4184,Geoff Brand,0,90.0,0,0,1,0,1,New Zealand
4185,Geoff Cameron,0,86.0,0,0,2,0,2,United States
4186,Geoff Hurst,2,768.0,0,0,11,2,13,England
4187,Geoffrey Sserunkuma,0,107.0,0,0,2,0,2,Uganda
4188,Geofrey Massa,0,107.0,0,0,3,0,3,Uganda
4189,Geofrey Munshya,2,93.0,0,0,0,2,2,Ethiopia
4190,Georg Hammer,0,10.0,0,0,0,1,1,Portugal
4191,Georg Siimenson,0,36.0,0,0,0,2,2,Sweden
4192,George Alhassan,2,311.0,0,0,3,4,7,Ghana
4193,George Best,0,380.0,0,1,5,2,7,Switzerland
4194,George Borba,1,12.0,0,0,1,0,1,Israel
4195,George Cummins,0,120.0,0,0,0,2,2,Luxembourg
4196,George Dangler,0,42.0,0,0,1,0,1,Dominica
4197,George Dublin,0,77.0,0,0,0,2,2,Aruba
4198,George Isaac,0,359.0,0,0,5,1,6,Saint Kitts and Nevis
4199,George Kiriau,0,100.0,0,0,1,1,2,Tonga
4200,George Mallia,0,81.0,0,0,0,2,2,Denmark
4201,George Mbwando,0,81.0,0,0,0,1,1,Mauritania
4202,George McCartney,0,61.0,0,0,1,0,1,Northern Ireland
4203,George Moussis,0,29.0,0,0,0,1,1,Anguilla
4204,George Mouyémé,1,82.0,0,0,0,1,1,Angola
4205,George Ngoma Nanitelamio,0,15.0,0,0,0,1,1,Equatorial Guinea
4206,George Onyango,0,24.0,0,0,1,0,1,Kenya
4207,George Pușcaș,0,220.0,0,0,2,3,5,Romania
4208,George Robledo,1,141.0,0,0,4,0,4,Chile
4209,George Suri,0,42.0,0,0,1,0,1,Solomon Islands
4210,George Weah,2,336.0,0,0,5,2,7,Liberia
4211,Georges Aeby,1,24.0,0,0,1,0,1,Switzerland
4212,Georges Akieremy,0,73.0,0,0,0,1,1,Algeria
4213,Georges Bereta,0,61.0,0,0,1,0,1,France
4214,Georges Bregy,0,400.0,0,2,6,3,9,Switzerland
4215,Georges Gertrude,1,53.0,0,0,0,1,1,Canada
4216,Georges Gope-Fenepej,4,529.0,0,0,1,7,8,Vanuatu
4217,Georges Grün,2,179.0,0,0,2,3,5,Belgium
4218,Georges Lech,0,312.0,0,0,3,2,5,France
4219,Georges Verriest,1,116.0,0,1,0,1,1,Austria
4220,Georges Vuilleumier,0,56.0,0,0,0,2,2,Portugal
4221,Georgi Asparuhov,4,770.0,0,1,11,3,14,Bulgaria
4222,Georgi Bachev,1,88.0,1,0,1,0,1,Spain
4223,Georgi Chilikov,0,37.0,0,0,1,0,1,Bulgaria
4224,Georgi Denev,0,196.0,0,0,5,1,6,Cyprus
4225,Georgi Dimitrov,0,287.0,0,0,2,4,6,Norway
4226,Georgi Dzhikiya,0,111.0,0,0,1,1,2,Russia
4227,Georgi Georgiev,1,131.0,0,0,1,1,2,Uzbekistan
4228,Georgi Iliev,0,69.0,0,0,1,0,1,Bulgaria
4229,Georgi Ivanov,0,157.0,0,0,2,1,3,Bulgaria
4230,Georgi Kinkladze,0,258.0,0,1,3,2,5,Georgia
4231,Georgi Kondratiev,3,147.0,0,0,3,0,3,Russia
4232,Georgi Kostadinov,0,192.0,0,0,1,2,3,Belarus
4233,Georgi Markov,0,18.0,0,0,1,0,1,Bulgaria
4234,Georgi Milanov,0,66.0,0,0,1,0,1,Bulgaria
4235,Georgi Panchediev,0,89.0,0,1,1,0,1,Bulgaria
4236,Georgi Slavkov,0,163.0,0,0,3,1,4,Bulgaria
4237,Georgi Sokolov,1,64.0,0,0,1,0,1,Bulgaria
4238,Georgi Tkavadze,0,18.0,0,0,1,0,1,Turkmenistan
4239,Georgi Yomov,0,89.0,0,0,1,0,1,Bulgaria
4240,Georgi Yordanov,0,39.0,0,0,1,0,1,Bulgaria
4241,Georgina Tura,1,77.0,0,0,0,1,1,Tahiti
4242,Georginio Wijnaldum,0,1055.0,0,0,10,8,18,Netherlands
4243,Georgios Delikaris,0,161.0,0,0,3,1,4,Greece
4244,Georgios Efrem,0,211.0,0,0,5,0,5,Cyprus
4245,Georgios Fotakis,0,79.0,0,0,0,1,1,Georgia
4246,Georgios Georgiadis,0,204.0,0,0,2,2,4,San Marino
4247,Georgios Kamaras,0,83.0,0,0,0,1,1,Israel
4248,Georgios Karagounis,0,30.0,0,0,0,1,1,Finland
4249,Georgios Kostikos,0,141.0,0,1,1,2,3,Greece
4250,Georgios Samaras,2,441.0,0,2,4,2,6,Bosnia and Herzegovina
4251,Georgios Tzavellas,0,90.0,0,0,1,0,1,Greece
4252,Geovani Faria da Silva,0,36.0,0,1,1,0,1,Brazil
4253,Gerald Asamoah,0,51.0,0,0,1,0,1,Germany
4254,Gerald Delmas,1,90.0,0,0,1,0,1,New Caledonia
4255,Gerald Díaz,0,3.0,0,0,1,0,1,Puerto Rico
4256,Gerald Phiri Jr.,0,81.0,0,1,1,0,1,Malawi
4257,Gerald Quennet,3,93.0,0,0,3,0,3,Tahiti
4258,Gerald Vanenburg,0,19.0,0,0,1,0,1,Netherlands
4259,Gerald Willfurth,0,71.0,0,0,1,0,1,Austria
4260,Geraldo,0,41.0,0,0,1,0,1,Angola
4261,Geraldo José da Silva,1,106.0,0,0,0,2,2,Ecuador
4262,Gerard Cieślik,0,93.0,0,0,2,0,2,Poland
4263,Gerard Ellie,0,149.0,0,1,2,0,2,Haiti
4264,Gerard López,0,59.0,0,0,1,1,2,Bosnia and Herzegovina
4265,Gerard Maki,1,38.0,0,0,0,1,1,Cook Islands
4266,Gerard Moreno,0,222.0,0,0,4,0,4,Spain
4267,Gerard Piqué,1,277.0,1,0,4,1,5,Spain
4268,Gerard Plessers,0,12.0,0,0,1,0,1,Belgium
4269,Gerard Williams,1,13.0,0,0,0,1,1,Belize
4270,Gerardo Arce,0,11.0,1,0,1,0,1,Brazil
4271,Gerardo Bedoya,0,170.0,0,0,1,2,3,United States
4272,Gerardo Galindo,1,54.0,0,0,1,0,1,Mexico
4273,Gerardo Gordillo,1,119.0,0,0,2,0,2,Guatemala
4274,Gerardo Rivas,5,222.0,0,0,1,5,6,Paraguay
4275,Gerardo Torrado,4,269.0,0,1,4,1,5,Mexico
4276,Gerardo Yecerotte,0,85.0,0,0,1,0,1,Bolivia
4277,Gerd Kische,0,18.0,0,0,1,0,1,Netherlands
4278,Gerd Müller,12,2147.0,0,3,24,15,39,Germany
4279,Gerd Weber,0,196.0,0,1,2,2,4,German DR
4280,Geremi,2,121.0,0,1,2,0,2,Cameroon
4281,Geremi Njitap,3,250.0,0,0,4,2,6,Cameroon
4282,Geremy Lombardi,0,71.0,0,0,1,0,1,Dominican Republic
4283,Gergely Rudolf,0,395.0,0,0,4,3,7,Sweden
4284,Gergő Lovrencsics,0,26.0,0,0,0,1,1,Greece
4285,Gerhard Hanappi,0,72.0,0,0,2,1,3,Austria
4286,Gerhard Körner,0,35.0,0,1,1,0,1,German DR
4287,Gerhard Rodax,1,63.0,0,0,1,0,1,Austria
4288,Gerhard Siedl,0,55.0,0,0,0,1,1,Norway
4289,Gerhard Strack,0,79.0,0,0,1,0,1,Germany
4290,Gerhard Vogt,0,47.0,0,0,0,1,1,Portugal
4291,Germaine van Dijk,0,11.0,0,0,0,1,1,Guyana
4292,Germán Aceros,3,104.0,0,0,2,1,3,Colombia
4293,Germán Carty,0,69.0,0,0,2,0,2,Peru
4294,Germán Leguía,0,6.0,0,0,1,0,1,Peru
4295,Gernot Jurtin,0,65.0,0,0,1,0,1,Austria
4296,Gerry Armstrong,2,501.0,0,1,7,4,11,Northern Ireland
4297,Gerry Baker,0,81.0,0,0,2,0,2,United States
4298,Gerry Daly,0,413.0,0,1,6,2,8,Denmark
4299,Gerry Hitchens,1,38.0,0,0,0,1,1,Brazil
4300,Gerry McMahon,0,49.0,0,0,0,1,1,Liechtenstein
4301,Gerry Taggart,0,140.0,0,0,1,3,4,Denmark
4302,Gerson Díaz,0,78.0,0,0,0,1,1,Peru
4303,Gerson Mayen,1,131.0,0,0,3,0,3,El Salvador
4304,Gerson Rodrigues,0,520.0,1,1,3,6,9,Luxembourg
4305,Gerson Tinoco,0,94.0,0,0,1,1,2,Saint Vincent and the Grenadines
4306,Gerson Torres,0,90.0,0,0,1,0,1,Costa Rica
4307,Gert Claessens,0,32.0,0,0,1,0,1,Belgium
4308,Gert Dörfel,0,142.0,0,0,0,3,3,Northern Ireland
4309,Gert Verheyen,0,220.0,0,0,2,3,5,Belgium
4310,Gervais Batota,0,96.0,0,0,1,1,2,Congo
4311,Gervatius Uri Khob,2,237.0,0,0,0,4,4,Mozambique
4312,Gervinho,8,528.0,0,0,8,3,11,Ivory Coast
4313,Gerónimo Barbadillo,0,64.0,0,0,2,1,3,Peru
4314,Getaneh Kebede,2,580.0,1,1,8,2,10,Ethiopia
4315,Gevorg Ghazaryan,0,580.0,0,0,6,4,10,Armenia
4316,Ghafour Jahani,0,207.0,0,0,4,1,5,Hong Kong
4317,Ghailene Chaalali,0,47.0,0,0,1,0,1,Tunisia
4318,Ghanem Al-Hajri,1,58.0,0,0,0,1,1,Qatar
4319,Ghanem Hamarsheh,0,176.0,0,0,2,0,2,Jordan
4320,Ghanem Sultan,1,53.0,1,0,0,1,1,Egypt
4321,Gharib Amzine,0,46.0,0,0,0,1,1,Algeria
4322,Gharib Hareb,0,33.0,0,1,1,0,1,United Arab Emirates
4323,Ghazi Al Kuwari,0,82.0,0,0,1,0,1,Bahrain
4324,Gheorghe Andronic,0,87.0,0,0,1,0,1,Moldova
4325,Gheorghe Boghiu,0,43.0,0,0,0,1,1,Liechtenstein
4326,Gheorghe Bucur,0,237.0,0,0,4,0,4,Romania
4327,Gheorghe Constantin,0,138.0,0,0,2,0,2,Romania
4328,Gheorghe Craioveanu,0,113.0,0,0,1,2,3,Romania
4329,Gheorghe Grozav,0,45.0,0,0,0,1,1,Turkey
4330,Gheorghe Hagi,3,1108.0,0,4,17,10,27,Northern Ireland
4331,Gheorghe Mulţescu,0,40.0,0,0,1,0,1,Romania
4332,Gheorghe Ovseannicov,0,25.0,0,0,0,1,1,Latvia
4333,Gheorghe Popescu,0,612.0,0,1,8,5,13,Romania
4334,Ghislain Akassou,0,45.0,0,0,0,1,1,Rwanda
4335,Gholam Ali,0,20.0,0,0,1,0,1,United Arab Emirates
4336,Gholam Hossein Farzami,0,57.0,0,0,1,0,1,Iran
4337,Gholam Hossein Mazloumi,0,311.0,0,0,3,2,5,Iran
4338,Gholam Vafakhah,0,23.0,0,0,1,0,1,Iran
4339,Gholamreza Rezaei,1,304.0,0,0,2,3,5,Syria
4340,Giacinto Facchetti,0,162.0,0,0,2,1,3,Italy
4341,Giacomo Bulgarelli,2,181.0,0,0,3,0,3,Italy
4342,Giacomo Raspadori,0,24.0,0,0,1,0,1,Italy
4343,Giampaolo Pazzini,0,226.0,0,0,2,1,3,Montenegro
4344,Giampiero Boniperti,0,195.0,0,0,2,1,3,Italy
4345,Giancarlo Antognoni,0,96.0,0,0,1,2,3,Luxembourg
4346,Giancarlo De Sisti,0,124.0,0,1,2,1,3,Austria
4347,Giancarlo Maldonado,0,511.0,0,0,8,2,10,Bolivia
4348,Gianfranco Zola,0,454.0,0,0,6,3,9,Italy
4349,Gianluca Lapadula,3,203.0,0,0,4,2,6,Ecuador
4350,Gianluca Vialli,1,343.0,0,0,7,1,8,Italy
4351,Gianluca Zambrotta,1,6.0,0,0,1,0,1,Italy
4352,Gianni Rivera,2,573.0,0,1,8,2,10,Italy
4353,Giannis Gianniotas,0,78.0,0,0,1,0,1,Greece
4354,Gianpetro Zappa,0,121.0,0,0,1,1,2,Switzerland
4355,Gibby Mbasela,0,11.0,0,0,1,0,1,Zambia
4356,Gideon Omokirio,3,216.0,1,1,3,2,5,Solomon Islands
4357,Gideon Tish,0,38.0,0,0,1,0,1,Israel
4358,Gidi Damti,0,94.0,0,0,1,1,2,Sweden
4359,Giedrius Arlauskis,0,101.0,2,0,1,1,2,Switzerland
4360,Gift Kampamba,1,112.0,0,0,0,3,3,Egypt
4361,Gigi Riva,1,1085.0,0,2,12,8,20,Italy
4362,Gijsberta Gersley,0,40.0,0,0,0,1,1,Dominican Republic
4363,Gil Guiambe,0,73.0,0,0,0,2,2,DR Congo
4364,Gil Reece,0,113.0,0,0,1,1,2,Wales
4365,Gil Vermouth,0,36.0,0,0,1,0,1,Israel
4366,Gilbert Agius,0,103.0,0,0,0,2,2,Faroe Islands
4367,Gilbert Chirwa,0,3.0,0,0,1,0,1,Malawi
4368,Gilbert Dussier,0,245.0,0,1,3,2,5,German DR
4369,Gilbert Mushangazhike,0,95.0,0,0,2,0,2,Zimbabwe
4370,Gilbert Nyhime,0,90.0,0,0,0,1,1,Turks and Caicos Islands
4371,Gilbert Van Binst,0,15.0,0,0,1,0,1,Belgium
4372,Gilbert Zender,0,52.0,0,0,0,1,1,Finland
4373,Gilbert Álvarez,0,72.0,0,0,0,1,1,Peru
4374,Gilberto,1,59.0,0,0,0,1,1,Japan
4375,Gilberto Alves,2,107.0,0,0,1,1,2,Peru
4376,Gilberto Murgas,1,34.0,0,1,0,1,1,Costa Rica
4377,Gilberto Silva,0,78.0,1,0,0,1,1,Brazil
4378,Gilberto Yearwood,1,89.0,0,0,0,1,1,Jamaica
4379,Gilberto dos Santos,2,185.0,0,1,1,2,3,Lebanon
4380,Giles Barnes,1,41.0,0,0,0,2,2,Haiti
4381,Gill Swerts,0,88.0,0,0,0,1,1,Bosnia and Herzegovina
4382,Gilles Bettmer,0,27.0,0,0,1,0,1,Luxembourg
4383,Gilles De Bilde,0,86.0,0,0,1,1,2,Belgium
4384,Gilles Malinowski,1,90.0,0,0,0,1,1,Fiji
4385,Gilles Rampillon,0,75.0,0,0,1,0,1,France
4386,Gilles Sunu,0,71.0,0,0,1,0,1,Togo
4387,Gilles Yapi Yapo,0,96.0,0,0,2,0,2,Ivory Coast
4388,Gilli Rólantsson,0,32.0,0,0,1,0,1,Faroe Islands
4389,Gino Brandon,0,82.0,0,0,0,1,1,Guatemala
4390,Gino Colaussi,3,101.0,0,0,0,4,4,France
4391,Gino Iorgulescu,0,49.0,1,0,1,1,2,Northern Ireland
4392,Gino Pariani,1,17.0,0,0,0,1,1,Spain
4393,Gino Pivatelli,0,84.0,0,0,1,0,1,Italy
4394,Ginter Gawlik,0,2.0,0,0,1,0,1,Poland
4395,Gints Freimanis,0,40.0,0,0,0,1,1,Hungary
4396,Giora Spiegel,3,331.0,0,0,3,3,6,Hong Kong
4397,Giorgi Demetradze,0,352.0,0,0,2,4,6,Georgia
4398,Giorgi Gakhokidze,0,169.0,0,0,2,0,2,Georgia
4399,Giorgi Kharaishvili,0,10.0,0,0,0,1,1,Gibraltar
4400,Giorgi Kvilitaia,0,84.0,0,0,0,1,1,Gibraltar
4401,Giorgi Merebashvili,0,66.0,0,0,0,1,1,Moldova
4402,Giorgi Papunashvili,0,59.0,0,0,1,0,1,Georgia
4403,Giorgi Shashiashvili,0,26.0,0,0,1,0,1,Georgia
4404,Giorgian de Arrascaeta,2,234.0,0,1,4,3,7,Peru
4405,Giorgio Chiellini,1,438.0,1,0,6,2,8,Italy
4406,Giorgio Chinaglia,0,29.0,0,1,0,2,2,Luxembourg
4407,Giorgos Dedes,0,93.0,0,0,2,0,2,Greece
4408,Giorgos Donis,0,191.0,0,0,1,2,3,San Marino
4409,Giorgos Karagounis,1,280.0,0,1,4,1,5,Portugal
4410,Giorgos Koudas,0,89.0,0,0,2,0,2,Greece
4411,Giorgos Masouras,0,77.0,0,0,2,0,2,Greece
4412,Giorgos Merkis,0,9.0,0,0,1,0,1,Cyprus
4413,Giorgos Savvidis,0,41.0,0,0,1,0,1,Cyprus
4414,Giorgos Sideris,0,471.0,0,1,8,2,10,Greece
4415,Giorgos Skartados,0,54.0,0,0,0,1,1,Albania
4416,Giourkas Seitaridis,0,29.0,0,0,1,0,1,Greece
4417,Giovane Élber,2,177.0,0,0,0,2,2,El Salvador
4418,Giovani Lo Celso,1,74.0,0,0,0,1,1,Venezuela
4419,Giovani dos Santos,5,494.0,0,0,3,6,9,Mexico
4420,Giovanni Di Lorenzo,0,90.0,0,0,2,0,2,Italy
4421,Giovanni Drenthe,0,57.0,0,0,0,1,1,Cayman Islands
4422,Giovanni Ferrari,0,176.0,0,0,3,0,3,Italy
4423,Giovanni Gayle,1,25.0,0,0,1,0,1,Honduras
4424,Giovanni Hernández,3,282.0,0,0,3,1,4,Colombia
4425,Giovanni Moreno,0,63.0,0,0,1,0,1,Colombia
4426,Giovanni Regales,1,38.0,0,0,1,0,1,Curaçao
4427,Giovanni Savarese,0,138.0,0,0,3,0,3,Venezuela
4428,Giovanni Sio,0,51.0,0,0,2,0,2,Ivory Coast
4429,Giovanni Trigueros,0,88.0,0,0,1,0,1,El Salvador
4430,Giovanni van Bronckhorst,2,267.0,0,0,2,2,4,Netherlands
4431,Giovanny Espinoza,0,5.0,0,0,1,0,1,Ecuador
4432,Girma Tekle,1,290.0,0,0,4,0,4,Ethiopia
4433,Girma Tesfaye,1,90.0,0,0,1,0,1,Ethiopia
4434,Giuseppe Bergomi,0,9.0,0,0,1,0,1,Italy
4435,Giuseppe Giannini,0,98.0,0,0,2,0,2,Italy
4436,Giuseppe Meazza,1,276.0,0,1,4,1,5,Italy
4437,Giuseppe Rossi,2,169.0,0,0,1,2,3,United States
4438,Giuseppe Signori,0,187.0,0,0,2,1,3,Malta
4439,Given Singuluma,1,2.0,0,0,1,0,1,Zambia
4440,Givi Nodia,2,86.0,0,0,2,0,2,Russia
4441,Gjergji Muzaka,0,87.0,0,0,0,1,1,Romania
4442,Gjorgji Hristov,0,391.0,0,0,6,3,9,Armenia
4443,Gladys Bokese,0,72.0,0,0,0,1,1,Eswatini
4444,Glen Johnson,1,49.0,1,0,1,0,1,Sweden
4445,Glenn Hoddle,0,193.0,0,0,3,1,4,England
4446,Glenn Hysén,0,100.0,0,0,1,1,2,Sweden
4447,Glenn Strömberg,1,316.0,0,0,2,4,6,Sweden
4448,Glenn Whelan,1,78.0,0,0,1,1,2,Georgia
4449,Glensworth Elizee,0,45.0,0,0,1,0,1,Dominica
4450,Gleofilo Vlijter,2,142.0,0,0,3,0,3,Suriname
4451,Glyn Hodges,0,28.0,0,0,1,0,1,Wales
4452,Goce Sedloski,0,192.0,0,1,2,2,4,North Macedonia
4453,Gocha Gogrichiani,0,59.0,0,0,1,0,1,Georgia
4454,Gocha Jamarauli,0,53.0,0,0,1,0,1,Georgia
4455,Godfred Karikari,0,156.0,0,0,2,0,2,Hong Kong
4456,Godfrey Chitalu,0,443.0,0,0,6,2,8,Sudan
4457,Godfrey Katerega,0,73.0,0,0,1,0,1,Uganda
4458,Godfrey Kisitu,2,94.0,0,0,0,2,2,Congo
4459,Godfrey Oboabona,0,82.0,0,0,0,1,1,Namibia
4460,Godfrey Walusimbi,0,87.0,0,1,1,0,1,Uganda
4461,Godwin Attram,0,87.0,0,0,0,1,1,Cape Verde
4462,Godwin Emenako,0,28.0,0,0,1,0,1,Nigeria
4463,Godwin Iwelumo,0,93.0,0,0,1,1,2,Nigeria
4464,Godwin Odiye,0,61.0,1,0,0,1,1,Nigeria
4465,Gogie Stewart,0,82.0,0,0,1,1,2,Canada
4466,Gohar Zaman,3,210.0,0,0,3,0,3,Pakistan
4467,Gohi Bi Zoro Cyriac,0,44.0,0,0,0,1,1,Liberia
4468,Golman Pierre,1,773.0,0,0,8,7,15,Haiti
4469,Gonzalo Castañeda,0,78.0,0,0,1,1,2,Ecuador
4470,Gonzalo Farfán,1,9.0,0,0,1,0,1,Mexico
4471,Gonzalo Galindo,1,122.0,0,0,1,2,3,Bolivia
4472,Gonzalo Higuaín,9,973.0,0,0,18,5,23,Argentina
4473,Gonzalo Jara,0,98.0,0,0,1,1,2,Venezuela
4474,Gonzalo Martínez,1,15.0,0,0,1,0,1,Colombia
4475,Gonzalo Pineda,1,65.0,0,0,1,0,1,Mexico
4476,Gonzalo Plata,1,314.0,0,0,3,1,4,Ecuador
4477,Gonzalo Romero,3,255.0,0,0,2,3,5,Guatemala
4478,Gonzalo de los Santos,0,29.0,0,0,1,0,1,Uruguay
4479,Gonçalo Guedes,0,147.0,0,0,1,1,2,Serbia
4480,Gonçalo Paciência,0,56.0,0,0,1,0,1,Portugal
4481,Gonçalo Ramos,3,135.0,0,0,3,0,3,Portugal
4482,Goran Maznov,0,180.0,0,0,3,1,4,North Macedonia
4483,Goran Pandev,1,504.0,0,2,4,9,13,North Macedonia
4484,Goran Stavrevski,0,93.0,1,0,2,0,2,North Macedonia
4485,Goran Vlaović,3,250.0,0,0,2,3,5,Turkey
4486,Gordon Braun,0,11.0,0,0,1,0,1,Luxembourg
4487,Gordon Durie,0,269.0,0,0,2,3,5,Yugoslavia
4488,Gordon Kinsaini,0,55.0,0,0,2,0,2,Suriname
4489,Gordon McQueen,0,207.0,0,0,0,3,3,Romania
4490,Gordon Schildenfeld,0,87.0,0,0,1,0,1,Croatia
4491,Gordon Smith,0,79.0,0,0,0,1,1,Spain
4492,Gordon Strachan,1,153.0,0,1,0,3,3,Sweden
4493,Gorgonio Ibarrola,1,62.0,0,0,0,1,1,Ecuador
4494,Gouramangi Singh,1,99.0,0,0,1,1,2,Bahrain
4495,Goçguly Goçgulyýew,1,5.0,0,1,0,1,1,Taiwan
4496,Graeme Rutjes,0,13.0,0,0,0,1,1,Wales
4497,Graeme Souness,1,86.0,0,0,0,1,1,Russia
4498,Graham Arnold,0,422.0,0,0,7,1,8,Australia
4499,Graham Williams,1,48.0,1,0,1,0,1,Russia
4500,Graham Zusi,0,300.0,0,0,3,1,4,United States
4501,Granit Xhaka,2,466.0,0,0,5,4,9,Slovenia
4502,Grant Hanley,0,116.0,0,0,2,0,2,Scotland
4503,Grant McCann,0,166.0,0,0,1,2,3,Liechtenstein
4504,Grant Turner,0,528.0,0,0,8,2,10,New Zealand
4505,Graziano Pellè,2,369.0,0,0,3,3,6,Malta
4506,Grațian Sepi,0,18.0,0,0,0,1,1,Switzerland
4507,Greg Brown,0,85.0,0,0,1,0,1,Australia
4508,Greg Vanney,0,90.0,0,0,1,0,1,United States
4509,Gregorio Benito,0,5.0,1,0,1,0,1,Romania
4510,Gregorio Gómez,0,27.0,0,0,1,0,1,Mexico
4511,Gregory Goodridge,0,161.0,0,0,2,2,4,Barbados
4512,Gregory Richardson,0,1.0,0,0,1,0,1,Guyana
4513,Grenddy Perozo,1,90.0,0,0,0,1,1,Paraguay
4514,Grover Harmon,1,35.0,0,0,0,1,1,Tonga
4515,Grzegorz Krychowiak,1,228.0,0,0,3,2,5,Georgia
4516,Grzegorz Lato,10,926.0,0,0,9,10,19,Poland
4517,Grégoire M'Bida,2,220.0,0,0,3,1,4,Cameroon
4518,Grétar Steinsson,0,9.0,0,0,0,1,1,Bulgaria
4519,Gu Guangming,5,359.0,0,0,3,3,6,China PR
4520,Gu Sang-Bum,0,85.0,0,0,1,0,1,South Korea
4521,Gualberto Mojica,0,26.0,0,0,1,0,1,Bolivia
4522,Gudmundur Thorbjornsson,0,35.0,0,0,0,1,1,Spain
4523,Guedes Lupapa,0,2.0,0,0,1,0,1,Angola
4524,Guido Alvarenga,1,75.0,0,1,0,2,2,Uruguay
4525,Guido Andrade,1,49.0,0,0,0,1,1,Colombia
4526,Guido Buchwald,0,44.0,0,0,1,0,1,Germany
4527,Guido Burgstaller,0,99.0,0,0,2,0,2,Austria
4528,Guido Gratton,0,108.0,0,0,2,0,2,Italy
4529,Guido Rodríguez,1,13.0,0,0,1,0,1,Argentina
4530,Guilherme Afonso,0,112.0,0,0,2,0,2,Angola
4531,Guilherme de Cássio Alves,1,9.0,0,0,1,0,1,Brazil
4532,Guilherme de Paula Lucrécio,1,72.0,0,1,1,0,1,Malaysia
4533,Guillaume Gillet,0,45.0,0,0,1,0,1,Belgium
4534,Guillermo Albornoz,1,49.0,0,0,0,1,1,Brazil
4535,Guillermo Amor,1,228.0,0,0,2,2,4,Spain
4536,Guillermo Barbadillo,0,62.0,0,0,0,1,1,Chile
4537,Guillermo Cantu,0,79.0,0,0,1,0,1,Mexico
4538,Guillermo Clavero,0,149.0,0,0,4,0,4,Chile
4539,Guillermo Díaz,0,128.0,0,0,3,0,3,Chile
4540,Guillermo Díaz Carmona,1,52.0,0,0,0,1,1,Bolivia
4541,Guillermo Escalada,3,263.0,0,0,4,4,8,Uruguay
4542,Guillermo Franco,1,261.0,0,0,2,3,5,Mexico
4543,Guillermo La Rosa,1,208.0,0,0,0,3,3,Colombia
4544,Guillermo Ochoa,0,53.0,1,0,1,0,1,Honduras
4545,Guillermo Ramírez,1,249.0,0,0,2,4,6,Trinidad and Tobago
4546,Guillermo Rivera,0,311.0,0,0,5,1,6,El Salvador
4547,Guillermo Riveros,1,40.0,0,0,0,1,1,Brazil
4548,Guillermo Saavedra,0,25.0,0,0,1,0,1,Chile
4549,Guillermo Stábile,7,323.0,0,0,7,1,8,Argentina
4550,Guillermo Subiabre,2,161.0,0,1,3,1,4,Chile
4551,Guillermo Torres,1,16.0,0,0,1,0,1,Chile
4552,Gulzhigit Alykulov,1,68.0,0,0,1,2,3,Kyrgyzstan
4553,Gunnar Aase,0,77.0,0,0,0,1,1,Luxembourg
4554,Gunnar Gren,0,81.0,0,0,1,0,1,Sweden
4555,Gunnar Halle,0,129.0,0,0,3,0,3,Norway
4556,Gunnar Heiðar Þorvaldsson,0,40.0,0,0,1,1,2,Iceland
4557,Gunnar Thoresen,0,3.0,0,0,1,0,1,Norway
4558,Gunther Schepens,0,74.0,0,0,1,1,2,Belgium
4559,Guram Kashia,0,56.0,0,0,0,1,1,Finland
4560,Gurban Gurbanov,2,298.0,0,1,2,3,5,Liechtenstein
4561,Gurbangeldi Durdyýew,0,110.0,0,0,0,2,2,Jordan
4562,Gustav Josefsson,0,48.0,0,0,2,0,2,Sweden
4563,Gustav Wetterström,3,337.0,0,0,3,3,6,Sweden
4564,Gustave Bebbe,0,87.0,0,0,0,1,1,Mauritius
4565,Gustave Kemp,0,33.0,0,0,1,0,1,Luxembourg
4566,Gustavo Adolfo Cabrera,0,49.0,1,0,0,2,2,Guatemala
4567,Gustavo Adrián López,0,83.0,0,0,1,0,1,Argentina
4568,Gustavo Cuéllar,1,31.0,0,0,1,0,1,Colombia
4569,Gustavo Gómez,2,272.0,3,0,3,2,5,Paraguay
4570,Gustavo Morínigo,0,107.0,0,0,2,0,2,Paraguay
4571,Gustavo Moscoso,1,90.0,0,0,0,1,1,Germany
4572,Gustavo Neffa,3,134.0,0,0,3,1,4,Paraguay
4573,Gustavo Peña,0,14.0,0,1,1,0,1,Mexico
4574,Gustavo Poyet,0,161.0,0,0,1,1,2,Uruguay
4575,Gustavo Sangaré,0,24.0,0,0,0,1,1,Cameroon
4576,Gustavo Vassallo,0,11.0,0,0,1,0,1,Peru
4577,Guti,0,120.0,0,0,2,0,2,Spain
4578,Guus Til,0,80.0,0,0,1,0,1,Netherlands
4579,Guvanch Ovekov,0,77.0,0,1,1,0,1,Turkmenistan
4580,Guwanç Abylow,0,24.0,0,0,2,0,2,Turkmenistan
4581,Guwançmuhammet Öwekow,0,81.0,0,0,3,0,3,Turkmenistan
4582,Guy Feutchine,0,82.0,0,0,1,0,1,Cameroon
4583,Guy François,0,216.0,0,0,2,1,3,Haiti
4584,Guy Hellers,0,179.0,1,0,1,2,3,Luxembourg
4585,Guy Mamihasindrahona,0,90.0,0,0,1,0,1,Madagascar
4586,Guy Mbenza,0,125.0,0,0,2,0,2,Congo
4587,Guy Nzeng,1,59.0,0,0,1,0,1,Gabon
4588,Guy Roger Nzamba,0,214.0,0,0,3,2,5,Cameroon
4589,Guy Saint-Vil,0,188.0,0,0,3,1,4,Haiti
4590,Guðmundur Torfason,0,62.0,0,0,0,1,1,Turkey
4591,Guðni Bergsson,0,61.0,0,0,1,0,1,Iceland
4592,Gyasi Zardes,0,484.0,0,0,8,0,8,United States
4593,Gylfi Sigurðsson,3,1129.0,0,6,12,10,22,Portugal
4594,Gyula Hajszán,0,109.0,0,0,2,0,2,Hungary
4595,Gyula Rákosi,0,129.0,0,0,1,1,2,German DR
4596,Gyula Zsengellér,5,533.0,0,1,10,0,10,Hungary
4597,György Bognár,0,131.0,0,1,1,3,4,Poland
4598,György Garics,0,82.0,0,0,1,0,1,Austria
4599,György Sárosi,6,381.0,0,1,5,2,7,Bulgaria
4600,György Tatar,0,90.0,0,0,1,1,2,Russia
4601,Győző Burcsa,0,65.0,0,0,1,0,1,Hungary
4602,Gábor Egressy,0,51.0,0,0,1,0,1,Hungary
4603,Gábor Gyepes,0,80.0,1,0,1,0,1,Croatia
4604,Gábor Halmai,0,89.0,0,0,3,0,3,Hungary
4605,Gábor P. Szabó,0,128.0,0,1,2,1,3,Bulgaria
4606,Gábor Pölöskei,2,137.0,0,0,1,2,3,Hungary
4607,Gérard Hausser,1,62.0,0,0,1,0,1,France
4608,Gérard Soler,1,69.0,0,0,2,1,3,France
4609,Gérson,1,65.0,0,0,1,0,1,Brazil
4610,Géza Toldi,3,195.0,0,0,1,3,4,Bulgaria
4611,Gökdeniz Karadeniz,1,240.0,0,0,2,3,5,Turkey
4612,Gökhan Gönül,0,78.0,0,0,1,0,1,Turkey
4613,Gökhan Inler,0,256.0,0,3,3,1,4,Switzerland
4614,Gökhan Ünal,0,123.0,0,0,1,1,2,Greece
4615,Gösta Dunker,1,82.0,0,0,0,1,1,Germany
4616,Gösta Sandberg,0,22.0,0,0,1,0,1,Sweden
4617,Gøran Sørloth,0,413.0,0,0,5,3,8,Cyprus
4618,Gündüz Kılıç,0,72.0,0,0,1,0,1,Turkey
4619,Günter Netzer,0,101.0,0,1,1,1,2,Germany
4620,Günther Wirth,0,39.0,0,0,1,1,2,German DR
4621,Güýçmyrat Annagulyýew,1,85.0,0,0,1,0,1,Turkmenistan
4622,Ha Seok-ju,5,570.0,0,0,6,5,11,Lebanon
4623,Habib Bamogo,1,59.0,0,0,0,1,1,Guinea
4624,Habib Beye,1,45.0,0,0,1,0,1,Senegal
4625,Habib Diallo,0,90.0,0,0,0,1,1,Togo
4626,Habib Fardan,0,25.0,0,0,1,0,1,United Arab Emirates
4627,Habib Jafar,1,167.0,0,0,2,1,3,Jordan
4628,Habib Khabiri,0,59.0,0,0,0,1,1,Kuwait
4629,Habib Shareefi,0,84.0,0,0,1,0,1,Iran
4630,Hacène Lalmas,3,110.0,0,0,3,0,3,Algeria
4631,Hadi Aghily,0,88.0,0,0,1,1,2,Qatar
4632,Hadi Ahmed,1,26.0,0,0,1,0,1,Iraq
4633,Hadi Ismanto,0,75.0,0,0,1,0,1,Indonesia
4634,Hady Khashaba,0,100.0,0,2,1,1,2,Namibia
4635,Hafiz Nor,1,52.0,0,0,0,1,1,Yemen
4636,Haidar Abdullah,0,56.0,0,0,0,1,1,Kazakhstan
4637,Haidar Mahmoud,3,169.0,0,0,3,1,4,Iraq
4638,Haidar Najim,0,36.0,0,0,1,0,1,Iraq
4639,Haidar Obeid,2,115.0,0,0,1,1,2,Macau
4640,Haim Bar,0,57.0,0,0,1,0,1,Israel
4641,Haim Revivo,1,376.0,0,0,5,5,10,Poland
4642,Hairuddin Omar,2,139.0,0,0,1,1,2,Hong Kong
4643,Haitham Al-Shboul,0,83.0,0,0,0,1,1,Iran
4644,Haitham Elrasheed,0,30.0,0,0,1,0,1,Sudan
4645,Haitham Thabit,0,80.0,0,0,1,0,1,Yemen
4646,Haitham Zein,1,211.0,0,0,4,1,5,Lebanon
4647,Haji Wright,1,76.0,0,0,0,1,1,Netherlands
4648,Hajime Hosogai,1,97.0,0,0,1,0,1,Japan
4649,Hakan Balta,0,79.0,0,0,1,0,1,Turkey
4650,Hakan Yakin,0,385.0,0,1,7,2,9,Switzerland
4651,Hakan Çalhanoğlu,0,404.0,0,1,3,4,7,Czech Republic
4652,Hakan Şükür,4,1892.0,0,2,26,13,39,Turkey
4653,Hakim Abdallah,0,74.0,0,0,1,0,1,Madagascar
4654,Hakim Braham,0,24.0,0,0,1,0,1,Tunisia
4655,Hakim Ziyech,1,83.0,0,1,2,1,3,Morocco
4656,Hakob Ter-Petrosyan,0,90.0,0,0,0,1,1,Albania
4657,Hal Robson-Kanu,2,313.0,0,0,3,2,5,Scotland
4658,Halil Altıntop,0,239.0,0,0,2,2,4,Kazakhstan
4659,Halil Dervişoğlu,0,133.0,0,0,2,1,3,Gibraltar
4660,Hallgrímur Jónasson,0,116.0,0,0,0,2,2,Portugal
4661,Hallur Hansson,0,73.0,0,0,2,0,2,Faroe Islands
4662,Hallvar Thoresen,0,258.0,0,2,3,2,5,Norway
4663,Hamad Al Harbi,0,87.0,0,0,0,1,1,Malaysia
4664,Hamad Al-Montashari,1,147.0,0,0,2,0,2,Saudi Arabia
4665,Hamad Khalid Bo Hamad,2,214.0,0,0,0,4,4,North Korea
4666,Hamada Sedki,0,9.0,1,0,1,0,1,Zimbabwe
4667,Hamdan Abdulla Al-Moamari,0,57.0,0,0,0,1,1,Syria
4668,Hamdan Al-Kamali,0,85.0,1,1,2,0,2,United Arab Emirates
4669,Hamdi Al Masri,0,17.0,1,0,1,0,1,Japan
4670,Hamdi Salihi,0,334.0,0,1,4,2,6,Sweden
4671,Hamdou Elhouni,1,36.0,0,0,1,0,1,Libya
4672,Hamed Al-Saleh,3,286.0,0,0,1,4,5,Macau
4673,Hamed Snousi,1,90.0,0,0,1,0,1,Libya
4674,Hameed Darwish,0,84.0,0,0,1,0,1,Bahrain
4675,Hameur Bouazza,1,92.0,0,0,0,1,1,Ivory Coast
4676,Hami Mandıralı,0,168.0,0,0,1,1,2,Turkey
4677,Hamid Alidousti,3,89.0,0,0,2,1,3,China PR
4678,Hamid Derakhshan,2,59.0,0,0,0,3,3,Oman
4679,Hamid Estili,5,425.0,0,0,1,7,8,Iran
4680,Hamid Ismail,0,90.0,0,0,0,1,1,United Arab Emirates
4681,Hamilton Cuvi,1,126.0,0,0,0,2,2,Uruguay
4682,Hamilton Ricard,2,196.0,0,0,1,3,4,Uruguay
4683,Haminu Draman,1,106.0,0,0,2,0,2,Ghana
4684,Hamit Altıntop,2,236.0,0,0,3,1,4,Turkey
4685,Hamlet Mkhitaryan,0,66.0,0,0,1,0,1,Armenia
4686,Hammadi Ahmed,1,86.0,0,0,1,0,1,Iraq
4687,Hamoud Al-Shemmari,1,84.0,0,0,1,0,1,Kuwait
4688,Hamza Abourazzouk,0,89.0,0,0,1,0,1,Morocco
4689,Hamza Al-Dardour,4,604.0,0,0,7,4,11,Palestine
4690,Hamza El-Gamal,1,22.0,0,0,1,0,1,Egypt
4691,Hamza Mathlouthi,1,4.0,0,0,1,0,1,Tunisia
4692,Hamza Yacef,0,48.0,0,0,1,0,1,Algeria
4693,Hamzah Idris,1,64.0,0,0,1,0,1,Saudi Arabia
4694,Hamzah Idris Falatah,0,118.0,0,0,3,0,3,Saudi Arabia
4695,Han Bong-Zin,2,153.0,0,0,2,0,2,North Korea
4696,Han Hyong-Il,0,148.0,0,0,3,0,3,North Korea
4697,Han Kwang-song,0,90.0,0,0,0,1,1,Turkmenistan
4698,Han Peng,0,70.0,0,0,0,2,2,Malaysia
4699,Hani Al Saqer,1,102.0,0,0,0,2,2,Indonesia
4700,Hani Al-Dhabit,0,463.0,0,2,9,2,11,Oman
4701,Hannes Löhr,0,165.0,0,0,3,0,3,Germany
4702,Hannes Reinmayr,0,96.0,0,0,1,2,3,Israel
4703,Hannu Tihinen,0,185.0,0,0,3,1,4,Finland
4704,Hannu Turunen,0,41.0,0,0,0,1,1,Germany
4705,Hans Buzek,0,127.0,0,0,1,1,2,Austria
4706,Hans Cieslarczyk,1,18.0,0,0,0,1,1,France
4707,Hans Fróði Hansen,0,86.0,0,0,1,0,1,Faroe Islands
4708,Hans Gillhaus,0,157.0,0,0,0,2,2,Greece
4709,Hans Holmqvist,0,68.0,0,0,0,1,1,Albania
4710,Hans Krankl,5,938.0,0,2,14,5,19,Malta
4711,Hans Maldonado,0,133.0,0,1,1,1,2,Argentina
4712,Hans Nordahl,0,26.0,0,0,0,1,1,Germany
4713,Hans Persson,0,23.0,0,0,0,1,1,Finland
4714,Hans Pirkner,0,106.0,0,1,2,0,2,Austria
4715,Hans Richter,0,45.0,0,0,1,0,1,German DR
4716,Hans Schäfer,6,388.0,0,0,3,5,8,Saarland
4717,Hans Vanaken,0,128.0,0,0,2,1,3,Belgium
4718,Hans-Jörg Pfister,0,148.0,0,0,0,2,2,German DR
4719,Hans-Jürgen Kreische,0,454.0,0,0,3,6,9,German DR
4720,Hans-Jürgen Riediger,0,29.0,0,0,1,0,1,German DR
4721,Hans-Peter Briegel,0,26.0,0,0,0,1,1,Finland
4722,Hans-Peter Friedländer,0,59.0,0,0,0,1,1,Luxembourg
4723,Hans-Peter Schild,0,18.0,0,0,0,1,1,Turkey
4724,Hans-Peter Zwicker,0,2.0,0,0,0,1,1,Malta
4725,Hansi Müller,1,30.0,0,0,1,0,1,Germany
4726,Hany Ramzy,1,169.0,0,0,1,1,2,Togo
4727,Hao Haidong,2,709.0,0,0,9,7,16,China PR
4728,Hao Junmin,1,473.0,0,1,5,2,7,China PR
4729,Harald Berg,0,183.0,0,0,2,1,3,Luxembourg
4730,Harald Brattbakk,0,24.0,0,0,1,0,1,Norway
4731,Harald Cerny,0,186.0,0,0,1,2,3,Cyprus
4732,Harald Hennum,0,98.0,0,0,3,0,3,Norway
4733,Harald Sunde,0,119.0,0,0,1,1,2,Norway
4734,Haraldur Ingólfsson,0,61.0,0,0,1,0,1,Iceland
4735,Hardy Binguila,0,81.0,0,0,0,1,1,Ethiopia
4736,Hared Robleh,0,29.0,0,0,0,1,1,DR Congo
4737,Hari Khadka,3,134.0,0,1,2,1,3,Nepal
4738,Harib Al-Maazmi,0,54.0,0,0,1,0,1,United Arab Emirates
4739,Haris Medunjanin,0,363.0,0,0,4,4,8,Bosnia and Herzegovina
4740,Haris Mohammed,0,81.0,0,0,0,1,1,United Arab Emirates
4741,Haris Seferovic,4,587.0,0,0,7,7,14,Switzerland
4742,Haris Škoro,0,83.0,0,0,1,0,1,Yugoslavia
4743,Harold Amaru,3,214.0,0,0,2,1,3,Tahiti
4744,Harold Hassall,0,70.0,0,0,2,0,2,England
4745,Harold Legodi,0,86.0,0,0,0,1,1,Congo
4746,Harold Lozano,1,90.0,0,0,0,1,1,Switzerland
4747,Harold Ng Fok,1,90.0,0,0,0,1,1,Fiji
4748,Harold Wallace,1,54.0,0,0,1,0,1,Costa Rica
4749,Haroldo Domingues,2,164.0,0,0,3,0,3,Brazil
4750,Haron Shakava,0,49.0,0,0,0,1,1,Mauritius
4751,Harouna Traoré,0,76.0,0,0,1,0,1,Burkina Faso
4752,Harris Tchilimbou,0,69.0,0,0,0,1,1,São Tomé and Príncipe
4753,Harrison Róchez,2,125.0,0,0,2,2,4,Belize
4754,Harry Andersson,3,179.0,0,0,0,3,3,Cuba
4755,Harry Bild,0,72.0,0,0,1,0,1,Sweden
4756,Harry Duggan,1,88.0,0,0,1,0,1,Republic of Ireland
4757,Harry Elyse Randrianaivo,0,102.0,0,0,2,0,2,Madagascar
4758,Harry Hestad,0,160.0,0,0,2,0,2,Norway
4759,Harry Kane,10,2228.0,0,13,23,21,44,England
4760,Harry Keough,0,35.0,0,1,0,1,1,Canada
4761,Harry Kewell,5,735.0,0,1,6,7,13,Iran
4762,Harry Lubse,0,48.0,0,0,1,0,1,Netherlands
4763,Harry Maguire,2,245.0,0,0,2,4,6,Sweden
4764,Harry Milanzi,0,193.0,0,0,3,2,5,Zambia
4765,Harry Panayiotou,0,148.0,0,1,0,3,3,Turks and Caicos Islands
4766,Harry Randrianaivo,0,185.0,0,0,3,0,3,Madagascar
4767,Harry Souttar,2,333.0,0,0,4,2,6,Australia
4768,Harry Waya,1,91.0,0,1,2,0,2,Malawi
4769,Harry Wilson,0,45.0,0,0,0,2,2,Azerbaijan
4770,Harry Winks,0,32.0,0,0,0,1,1,Kosovo
4771,Harry Zech,0,53.0,0,0,0,1,1,Lithuania
4772,Hartmut Schade,0,68.0,0,0,1,1,2,German DR
4773,Haruhisa Hasegawa,1,88.0,0,0,1,0,1,Japan
4774,Harun Jusoh,1,89.0,0,0,0,1,1,Thailand
4775,Haruna Ilerika,2,97.0,0,0,0,2,2,Egypt
4776,Harutyun Vardanyan,0,56.0,0,0,1,0,1,Armenia
4777,Hasabu El Sagheir,0,9.0,0,0,0,1,1,Ethiopia
4778,Hasan Ali Kaldırım,0,24.0,0,0,1,0,1,Turkey
4779,Hasan Salihamidžić,1,135.0,0,0,1,3,4,Bosnia and Herzegovina
4780,Hasan Şaş,2,51.0,0,0,1,1,2,Brazil
4781,Hasan Şengün,0,124.0,0,0,0,2,2,Northern Ireland
4782,Hashim Saleh,0,29.0,0,0,0,1,1,Nepal
4783,Hashim Sayed Isa,0,124.0,0,1,2,0,2,Bahrain
4784,Hassan Abbas,1,85.0,1,0,1,0,1,Japan
4785,Hassan Abdel-Fattah,1,987.0,0,2,10,7,17,South Korea
4786,Hassan Akesbi,0,14.0,0,0,0,1,1,Senegal
4787,Hassan Al-Haydos,2,674.0,0,4,10,4,14,Qatar
4788,Hassan Amcharrat,2,87.0,0,0,1,2,3,Ivory Coast
4789,Hassan Ayoub,1,41.0,0,0,0,1,1,India
4790,Hassan Bashir,2,84.0,0,2,1,1,2,Yemen
4791,Hassan Chaito,0,126.0,0,0,2,0,2,Lebanon
4792,Hassan El-Shazly,10,412.0,0,1,11,1,12,Egypt
4793,Hassan Fallatah,0,34.0,0,0,0,1,1,Hong Kong
4794,Hassan Korongo,0,45.0,0,1,1,0,1,Sudan
4795,Hassan Maatouk,2,356.0,0,3,6,3,9,Lebanon
4796,Hassan Mili,0,46.0,0,0,1,0,1,Rwanda
4797,Hassan Mohamed,0,35.0,0,0,0,1,1,Qatar
4798,Hassan Mostafa,0,80.0,0,0,0,1,1,Benin
4799,Hassan Mubarak,1,42.0,0,0,1,1,2,Japan
4800,Hassan Mubiru,0,94.0,0,0,2,0,2,Uganda
4801,Hassan Mudhafar,0,21.0,0,1,1,0,1,Oman
4802,Hassan Myuter Saied Al Suwaidi,0,62.0,0,0,1,0,1,Qatar
4803,Hassan Nader,1,114.0,0,0,2,0,2,Morocco
4804,Hassan Rowshan,2,491.0,0,0,5,3,8,Iran
4805,Hassan Saeed Ahmed,0,137.0,0,0,3,0,3,United Arab Emirates
4806,Hassan Shehata,1,156.0,0,0,3,1,4,Egypt
4807,Hassane Bandé,1,39.0,0,0,0,1,1,Cape Verde
4808,Hasse Borg,0,119.0,0,3,3,0,3,Sweden
4809,Hasse Jeppson,2,130.0,0,0,1,2,3,Sweden
4810,Hassen Gabsi,1,245.0,0,0,1,2,3,Tunisia
4811,Hassouneh Al-Sheikh,1,33.0,0,0,1,0,1,Jordan
4812,Hatem Aqel,0,91.0,0,1,2,0,2,Jordan
4813,Hatem Ben Arfa,0,90.0,0,0,0,1,1,Faroe Islands
4814,Hattan Bahebri,2,51.0,0,0,1,1,2,Saudi Arabia
4815,Hawar Mulla Mohammed,4,155.0,0,2,4,1,5,Turkmenistan
4816,Hayao Kawabe,0,71.0,0,0,1,0,1,Japan
4817,Hayden Foxe,0,125.0,0,0,2,0,2,Australia
4818,Hayden Tinto,0,45.0,0,0,0,1,1,Mexico
4819,Hayk Hakobyan,0,72.0,0,0,1,0,1,Armenia
4820,Haykel Guemamdia,1,79.0,0,1,2,2,4,Tunisia
4821,Haytham Tambal,1,400.0,0,0,5,2,7,Sudan
4822,Hazem Emam,2,153.0,0,0,3,0,3,Egypt
4823,He Jia,1,61.0,0,0,1,0,1,China PR
4824,Heath Dickinson,1,18.0,1,0,1,0,1,Fiji
4825,Hector Sam,0,84.0,0,0,1,0,1,Trinidad and Tobago
4826,Hector Wright,1,248.0,0,1,4,2,6,Jamaica
4827,Hedgardo Marín,1,8.0,0,0,1,0,1,Mexico
4828,Heiko Herrlich,0,42.0,0,0,1,0,1,Germany
4829,Heiko Westermann,0,114.0,0,0,1,1,2,Liechtenstein
4830,Heimana Paama,1,13.0,1,0,1,0,1,New Zealand
4831,Heimano Bourebare,1,25.0,0,0,1,0,1,Tahiti
4832,Heimo Pfeifenberger,0,199.0,0,0,5,1,6,Austria
4833,Heiner Mora,1,47.0,0,0,1,0,1,Costa Rica
4834,Heini Vatnsdal,0,72.0,0,0,1,0,1,Faroe Islands
4835,Heinrich Isaacks,0,17.0,0,0,1,0,1,Namibia
4836,Heinrich Schmidtgal,0,46.0,0,0,0,1,1,Germany
4837,Heinrich Uukkivi,0,3.0,0,0,0,1,1,Sweden
4838,Heinz Flohe,2,197.0,0,0,2,1,3,Yugoslavia
4839,Heinz Hermann,0,211.0,0,0,2,2,4,Iceland
4840,Heinz Lüdi,0,2.0,1,0,1,0,1,Belgium
4841,Heinz Schneiter,2,179.0,0,0,1,2,3,Belgium
4842,Heinz Strehl,0,69.0,0,0,1,0,1,Germany
4843,Heitor,0,22.0,0,0,1,0,1,Brazil
4844,Heiðar Helguson,0,144.0,0,0,3,1,4,Iceland
4845,Heleno de Freitas,8,289.0,0,0,6,3,9,Brazil
4846,Helgi Sigurðsson,0,142.0,0,0,2,1,3,Iceland
4847,Helman Mkhalele,3,171.0,0,1,3,1,4,South Africa
4848,Helmut Bicek,0,90.0,0,1,2,0,2,United States
4849,Helmut Haller,5,352.0,0,1,7,2,9,Greece
4850,Helmut Köglberger,0,106.0,0,0,0,2,2,Malta
4851,Helmut Müller,0,35.0,0,0,1,0,1,German DR
4852,Helmut Rahn,10,618.0,0,0,7,4,11,Germany
4853,Helmut Redl,0,147.0,0,0,3,1,4,Austria
4854,Helmut Schön,0,111.0,0,0,2,0,2,Germany
4855,Helmut Senekowitsch,0,66.0,0,0,0,1,1,Luxembourg
4856,Helmut Siber,0,175.0,0,0,2,1,3,Russia
4857,Hendrik Isemborghs,0,91.0,0,0,1,1,2,Belgium
4858,Hendrik Somaeb,0,64.0,0,0,1,0,1,Namibia
4859,Hendry Thomas,0,90.0,0,0,1,0,1,Honduras
4860,Henk Groot,0,195.0,0,0,1,2,3,German DR
4861,Henk Wery,0,20.0,0,0,0,1,1,Poland
4862,Henk van Spaandonck,0,37.0,0,0,0,1,1,Belgium
4863,Hennadiy Lytovchenko,2,327.0,0,0,3,3,6,Norway
4864,Hennadiy Zubov,0,95.0,0,0,2,1,3,Ukraine
4865,Hennie van Nee,0,8.0,0,0,0,2,2,Albania
4866,Henning Berg,0,278.0,1,0,4,1,5,Belarus
4867,Henning Enoksen,0,120.0,0,0,2,0,2,Denmark
4868,Henning Frenzel,0,484.0,0,0,5,2,7,German DR
4869,Henning Jarnskor,0,12.0,0,0,1,0,1,Faroe Islands
4870,Henning Jensen,0,83.0,0,0,1,1,2,Denmark
4871,Henning Munk Jensen,0,124.0,0,1,2,0,2,Denmark
4872,Henok Goitom,0,9.0,0,0,0,1,1,Botswana
4873,Henri Anier,1,246.0,0,0,2,3,5,Estonia
4874,Henri Baillot,0,63.0,0,0,1,1,2,Yugoslavia
4875,Henri Camara,7,859.0,0,0,7,9,16,Burkina Faso
4876,Henri Coppens,1,289.0,0,1,4,3,7,Finland
4877,Henri Klein,0,74.0,0,0,2,0,2,Luxembourg
4878,Henri Konan,1,90.0,0,1,0,1,1,Ghana
4879,Henri Mbazumutima,0,72.0,0,0,0,2,2,Tunisia
4880,Henri Saivet,1,13.0,0,0,1,0,1,Senegal
4881,Henrico Botes,0,75.0,0,0,1,0,1,Namibia
4882,Henrik Andersen,0,85.0,0,0,1,0,1,Denmark
4883,Henrik Dalsgaard,0,90.0,0,0,0,1,1,Switzerland
4884,Henrik Larsen,3,97.0,0,0,0,4,4,France
4885,Henrik Larsson,9,1558.0,0,6,19,8,27,Sweden
4886,Henrikh Mkhitaryan,0,986.0,0,4,10,8,18,Armenia
4887,Henrique Tembe,0,44.0,0,0,0,1,1,Senegal
4888,Henry Fa'arodo,1,482.0,0,4,6,5,11,New Zealand
4889,Henry Koto,1,88.0,0,0,1,0,1,Solomon Islands
4890,Henry Martín,1,218.0,0,0,1,2,3,Mexico
4891,Henry McKop,0,62.0,0,0,0,1,1,Togo
4892,Henry Morris,0,160.0,0,0,0,3,3,Northern Ireland
4893,Henry Motego,0,73.0,0,1,2,0,2,Kenya
4894,Henry Nwosu,1,103.0,0,0,1,1,2,Nigeria
4895,Henryk Bałuszyński,0,4.0,0,0,1,0,1,Poland
4896,Henryk Kasperczak,0,12.0,0,0,1,0,1,Poland
4897,Henryk Martyna,0,52.0,0,0,1,0,1,Poland
4898,Henryk Wieczorek,0,77.0,0,0,1,0,1,Poland
4899,Herbert Binkert,0,16.0,0,0,0,1,1,Norway
4900,Herbert Hermann,0,27.0,0,0,1,0,1,Switzerland
4901,Herbert Marquez,0,58.0,0,0,1,0,1,Venezuela
4902,Herbert Martin,0,68.0,0,1,1,0,1,Saarland
4903,Herbert Pankau,0,132.0,0,0,2,0,2,German DR
4904,Herbert Prohaska,0,345.0,0,2,5,2,7,Austria
4905,Herbert Sandin,0,56.0,0,0,1,0,1,Sweden
4906,Herbert Sosa,0,88.0,0,1,1,0,1,El Salvador
4907,Herbert Wimmer,1,135.0,0,0,1,1,2,Germany
4908,Herbert Zimmermann,0,119.0,0,0,1,1,2,Wales
4909,Herculez Gomez,0,127.0,0,0,2,0,2,United States
4910,Herfried Sabitzer,0,80.0,0,0,1,0,1,Austria
4911,Heribert Weber,0,66.0,0,0,1,0,1,Austria
4912,Heriberto Morales,0,11.0,1,0,1,0,1,Jamaica
4913,Herilia Rafanodina,0,57.0,0,0,1,0,1,Madagascar
4914,Herman Soliz,0,27.0,1,0,1,0,1,Ecuador
4915,Hermann Hreiðarsson,0,183.0,0,0,1,4,5,Iceland
4916,Hermenegildo Segrera,0,269.0,0,0,1,3,4,Chile
4917,Herminio Masantonio,8,584.0,0,0,8,3,11,Argentina
4918,Hernando Bolados,0,30.0,0,0,1,0,1,Chile
4919,Hernando Salazar,1,85.0,0,0,0,1,1,Brazil
4920,Hernán Crespo,7,1111.0,0,2,17,9,26,Argentina
4921,Hernán Darío Herrera,0,223.0,0,1,3,2,5,Colombia
4922,Hernán Gaviria,1,101.0,0,0,0,2,2,Switzerland
4923,Hernán Medford,5,688.0,0,1,5,7,12,Sweden
4924,Hernán Rengifo,0,175.0,0,0,1,1,2,Peru
4925,Hernâni Ferreira da Silva,0,30.0,0,0,2,0,2,Portugal
4926,Herry Kiswanto,0,188.0,0,0,2,1,3,Thailand
4927,Herry Risdianto,0,178.0,0,0,2,0,2,Indonesia
4928,Hervé Bazile,1,70.0,0,1,1,0,1,Haiti
4929,Hervé Revelli,0,238.0,0,0,0,5,5,Luxembourg
4930,Hesham Hanafy,0,24.0,0,0,1,0,1,Egypt
4931,Hesham Mohammed,0,369.0,0,0,9,0,9,Iraq
4932,Hesham Shaban,0,81.0,0,0,1,0,1,Libya
4933,Heston Munthali,0,76.0,0,0,1,1,2,Malawi
4934,Hicham Aboucherouane,1,72.0,0,0,1,1,2,Guinea
4935,Hicham Mahdoufi,0,43.0,1,0,1,0,1,Gabon
4936,Hicham Zerouali,2,108.0,0,0,0,2,2,Burkina Faso
4937,Hichem Essifi,0,73.0,0,0,2,0,2,Tunisia
4938,Hideaki Kitajima,1,79.0,0,0,1,0,1,Japan
4939,Hideki Maeda,1,80.0,0,1,1,0,1,Japan
4940,Hidemasa Morita,0,90.0,0,0,2,0,2,Japan
4941,Hidetoshi Nakata,1,320.0,0,0,7,1,8,Japan
4942,Hilaire Kédigui,0,83.0,0,0,2,0,2,Chad
4943,Hilal El-Helwe,2,367.0,0,1,4,2,6,Lebanon
4944,Hillal Soudani,2,291.0,0,0,5,1,6,Algeria
4945,Hillary Makasa,1,90.0,0,0,1,0,1,Zambia
4946,Himson Teleda,0,108.0,0,0,2,0,2,Solomon Islands
4947,Hipólito Rincón,0,382.0,0,0,7,0,7,Spain
4948,Hiro Labaste,0,55.0,0,0,0,1,1,Australia
4949,Hiroaki Morishima,4,329.0,0,0,3,3,6,Macau
4950,Hiromi Hara,0,200.0,0,0,3,1,4,Japan
4951,Hiroshi Kiyotake,0,123.0,0,1,2,1,3,Oman
4952,Hiroshi Nanami,5,228.0,0,0,4,3,7,Japan
4953,Hirving Lozano,1,407.0,0,0,4,3,7,Canada
4954,Hisashi Kato,0,84.0,0,0,0,1,1,Singapore
4955,Hisashi Kurosaki,0,69.0,0,0,1,0,1,Japan
4956,Hisham Abdul-Munam,0,90.0,0,0,1,0,1,Jordan
4957,Hla Htay,1,64.0,0,0,1,1,2,Myanmar
4958,Hlaing Bo Bo,1,86.0,0,0,2,0,2,Myanmar
4959,Hlynur Birgisson,0,70.0,1,0,1,0,1,Luxembourg
4960,Hocine Achiou,2,159.0,0,0,2,0,2,Algeria
4961,Hocine Benmiloudi,1,62.0,0,0,1,0,1,Algeria
4962,Hocine Yahi,1,168.0,0,0,2,0,2,Algeria
4963,Hok Sochetra,0,77.0,0,0,2,0,2,Cambodia
4964,Holger Badstuber,0,86.0,0,0,1,0,1,Germany
4965,Hollies Vato,1,143.0,0,0,1,1,2,Solomon Islands
4966,Homam Ahmed,1,25.0,0,0,0,1,1,Honduras
4967,Homayoun Behzadi,0,249.0,0,0,4,0,4,Iran
4968,Homos,1,39.0,0,0,1,0,1,Egypt
4969,Hong Jeong-ho,0,4.0,0,0,1,0,1,South Korea
4970,Hong Myung-bo,4,234.0,0,2,0,4,4,India
4971,Hong Sung-Ho,1,33.0,0,0,1,0,1,South Korea
4972,Hong Yong-jo,1,495.0,0,1,5,3,8,Yemen
4973,Honorato Gonzabay,2,117.0,2,0,0,2,2,Ecuador
4974,Horacio Casarín,1,286.0,0,0,5,0,5,Mexico
4975,Horst Hrubesch,3,108.0,0,0,1,2,3,Belgium
4976,Horst Kohle,0,72.0,0,0,0,1,1,Portugal
4977,Horst Köppel,0,73.0,0,0,0,1,1,Turkey
4978,Horst Nemec,0,120.0,0,0,3,0,3,Austria
4979,Horst Schade,0,70.0,0,0,1,0,1,Germany
4980,Horst Siegl,1,330.0,0,0,5,0,5,Czech Republic
4981,Horst Szymaniak,0,78.0,0,1,0,2,2,Chile
4982,Horst-Dieter Höttges,0,51.0,0,0,1,0,1,Germany
4983,Hosny Abd Rabo,5,440.0,0,6,6,3,9,Egypt
4984,Hossam Ghaly,0,38.0,0,0,1,0,1,Egypt
4985,Hossam Hassan,8,1101.0,0,2,11,9,20,Egypt
4986,Hossein Faraki,2,232.0,0,0,2,1,3,Kuwait
4987,Hossein Kalani,5,372.0,0,0,7,0,7,Iran
4988,Hossein Kanaanizadegan,0,18.0,0,0,1,0,1,Iran
4989,Hossein Kazerani,0,41.0,0,0,1,1,2,Hong Kong
4990,Hossein Zamani,1,81.0,0,0,0,1,1,India
4991,Hotaru Yamaguchi,0,90.0,0,0,1,0,1,Japan
4992,Houmane Jarir,2,236.0,0,0,2,2,4,Tunisia
4993,Housain Al-Mogahwi,1,67.0,0,0,0,1,1,Lebanon
4994,Houssam Wadi,0,12.0,0,0,1,0,1,Palestine
4995,Houssine Kharja,1,555.0,0,2,4,4,8,Morocco
4996,Hovhannes Goharyan,0,23.0,0,0,1,0,1,Armenia
4997,Hovhannes Hambardzumyan,0,116.0,0,0,2,0,2,Armenia
4998,Hrayr Mkoyan,0,120.0,1,0,2,0,2,Armenia
4999,Hristo Bonev,2,952.0,0,6,10,9,19,Bulgaria
5000,Hristo Iliev,0,345.0,0,0,4,2,6,Bulgaria
5001,Hristo Kolev,0,169.0,0,0,2,1,3,Luxembourg
5002,Hristo Stoichkov,9,1244.0,0,13,17,11,28,Bulgaria
5003,Hristo Yanev,0,109.0,0,0,1,1,2,Iceland
5004,Hsu Te Ming,1,90.0,0,0,1,0,1,Taiwan
5005,Huang Bowen,0,57.0,0,0,1,0,1,China PR
5006,Huang Che-ming,1,62.0,0,0,0,1,1,Bangladesh
5007,Huang Wei-yi,1,203.0,0,0,1,2,3,Iraq
5008,Huang Xiangdong,5,341.0,0,0,2,3,5,North Korea
5009,Hubert Hien,1,50.0,0,0,0,1,1,Nigeria
5010,Hubert Robson,0,74.0,0,0,0,1,1,Comoros
5011,Hubert Sambo,1,21.0,0,0,1,0,1,Curaçao
5012,Hubert Suda,0,66.0,0,1,2,0,2,Malta
5013,Hughton Hector,0,90.0,0,0,1,0,1,Trinidad and Tobago
5014,Hugo Almeida,1,402.0,0,0,3,5,8,Azerbaijan
5015,Hugo Brizuela,0,166.0,0,0,2,1,3,Chile
5016,Hugo Coscia,0,29.0,0,0,0,1,1,Brazil
5017,Hugo Eduardo Rubio,0,99.0,0,0,6,0,6,Chile
5018,Hugo Galeano,0,30.0,1,0,1,0,1,Paraguay
5019,Hugo González,0,56.0,1,0,0,1,1,Chile
5020,Hugo Hovenkamp,1,49.0,0,0,1,1,2,Netherlands
5021,Hugo Kiesse,0,103.0,0,0,0,2,2,Ecuador
5022,Hugo Morales,0,86.0,0,0,0,1,1,Venezuela
5023,Hugo Pérez,0,49.0,0,1,1,0,1,United States
5024,Hugo Rodallega,0,88.0,0,0,0,2,2,Peru
5025,Hugo Sotil,1,179.0,0,0,3,1,4,Peru
5026,Hugo Sánchez,0,174.0,0,1,2,2,4,Mexico
5027,Hugo Talavera,0,57.0,0,0,1,1,2,Ecuador
5028,Hugo Viana,0,86.0,0,0,1,0,1,Portugal
5029,Hugues Guillaume,0,113.0,0,0,2,0,2,Haiti
5030,Huh Jung-Moo,1,294.0,0,0,5,1,6,South Korea
5031,Humam Tariq,1,60.0,0,0,1,0,1,Iraq
5032,Humberto Coelho,0,112.0,0,0,3,0,3,Portugal
5033,Humberto Francisco Scovino,0,46.0,0,0,1,0,1,Venezuela
5034,Humberto Maschio,9,471.0,0,2,9,0,9,Argentina
5035,Humberto Moreno,0,47.0,0,0,1,0,1,Chile
5036,Humberto Recanatini,2,80.0,0,2,2,0,2,Argentina
5037,Humberto Scovino,1,59.0,0,0,0,1,1,Bolivia
5038,Humberto Suazo,4,779.0,0,4,6,9,15,Ecuador
5039,Humberto Álvarez,1,19.0,0,1,1,0,1,Colombia
5040,Humphrey Edobor,1,35.0,0,0,2,1,3,Nigeria
5041,Hung Kai-chun,0,65.0,0,0,0,1,1,Thailand
5042,Husain Ali,1,475.0,0,0,4,5,9,Thailand
5043,Hussain Al-Hadhri,0,8.0,0,0,1,0,1,Oman
5044,Hussain Al-Musawi,0,90.0,0,0,1,0,1,Kuwait
5045,Hussain Ali Baba,1,31.0,0,1,0,1,1,Yemen
5046,Hussain Fadhel,0,62.0,0,0,1,1,2,Kuwait
5047,Hussain Seraj,0,12.0,0,0,1,0,1,Kuwait
5048,Hussam Fawzi,2,263.0,0,0,3,3,6,Iran
5049,Hussein Abdulghani,0,102.0,0,0,2,1,3,Saudi Arabia
5050,Hussein Ahmad Satter,2,81.0,0,0,2,0,2,Singapore
5051,Hussein Ali Al-Saedi,1,53.0,0,0,1,0,1,Iraq
5052,Hussein Hamdan,0,90.0,0,0,1,0,1,Lebanon
5053,Hussein Saeed,2,452.0,0,0,3,4,7,Qatar
5054,Hussein Yassin,0,84.0,0,0,1,0,1,Djibouti
5055,Hutson Charles,0,146.0,0,0,1,1,2,Barbados
5056,Huub Stevens,0,65.0,0,0,1,0,1,Netherlands
5057,Huỳnh Quang Thanh,0,152.0,0,0,1,2,3,Vietnam
5058,Hwang Hee-chan,2,312.0,0,1,5,1,6,Qatar
5059,Hwang In-beom,0,47.0,0,0,1,0,1,South Korea
5060,Hwang Jae-won,1,120.0,0,0,0,1,1,Japan
5061,Hwang Sang-hoi,2,158.0,0,0,1,1,2,North Korea
5062,Hwang Seok-keun,0,47.0,0,0,0,1,1,Kuwait
5063,Hwang Sun-hong,9,632.0,0,0,13,4,17,South Korea
5064,Hwang Ui-jo,2,162.0,0,1,4,0,4,South Korea
5065,Hwangbo Kwan,4,236.0,0,0,2,3,5,Malaysia
5066,Hysen Zmijani,0,173.0,1,0,2,1,3,France
5067,Hà Vương Ngầu Nại,1,61.0,0,0,1,0,1,Vietnam
5068,Håkan Mild,1,97.0,0,0,1,1,2,Austria
5069,Håkan Sandberg,0,31.0,0,0,1,0,1,Sweden
5070,Håvard Flo,1,46.0,0,0,0,1,1,Scotland
5071,Håvard Nielsen,0,72.0,0,0,1,0,1,Norway
5072,Håvard Nordtveit,0,111.0,1,0,0,2,2,Azerbaijan
5073,Héctor Altamirano,2,140.0,0,2,3,1,4,Mexico
5074,Héctor Bailetti,1,40.0,0,0,0,1,1,Chile
5075,Héctor Castro,7,643.0,0,0,2,10,12,Chile
5076,Héctor Chumpitaz,1,135.0,1,0,1,1,2,Bolivia
5077,Héctor De Bourgoing,1,15.0,0,1,1,0,1,France
5078,Héctor Demarco,2,89.0,0,0,0,3,3,Peru
5079,Héctor Facundo,1,4.0,0,0,1,0,1,Argentina
5080,Héctor González,1,250.0,0,0,2,2,4,Peru
5081,Héctor Hernández,1,305.0,0,1,1,3,4,Mexico
5082,Héctor Herrera,2,402.0,0,0,4,1,5,Mexico
5083,Héctor Hurtado,1,79.0,0,0,1,0,1,Colombia
5084,Héctor Magliano,4,189.0,0,0,0,4,4,Chile
5085,Héctor Marchena,0,59.0,1,0,1,0,1,United States
5086,Héctor Moreno,1,316.0,1,0,0,5,5,Mexico
5087,Héctor Ortiz,1,103.0,0,1,2,0,2,Mexico
5088,Héctor Puebla,0,21.0,0,0,1,0,1,Chile
5089,Héctor Ramos,0,158.0,0,0,4,0,4,Puerto Rico
5090,Héctor Scarone,9,552.0,0,0,4,10,14,Uruguay
5091,Héctor Silva,0,216.0,0,0,4,1,5,Uruguay
5092,Héctor Socorro,3,264.0,0,0,3,2,5,Haiti
5093,Héctor Tapia,0,70.0,0,0,0,1,1,Venezuela
5094,Héctor Yazalde,2,83.0,0,0,2,0,2,Argentina
5095,Héctor Zelaya,0,8.0,0,0,0,1,1,Spain
5096,Hédi Berkhissa,1,41.0,0,0,2,0,2,Tunisia
5097,Hélder,0,74.0,0,0,1,0,1,Portugal
5098,Hélder Costa,0,25.0,0,0,1,0,1,Angola
5099,Hélder Cristóvão,0,75.0,0,0,0,1,1,Albania
5100,Hélder Pelembe,0,54.0,0,0,1,0,1,Mozambique
5101,Hélder Postiga,2,1206.0,0,0,12,6,18,Portugal
5102,Hélder Vicente,0,18.0,0,0,1,0,1,Angola
5103,Hélder Vicente de Jesus Serafin,1,90.0,1,0,0,1,1,Angola
5104,Héldon Ramos,2,278.0,0,1,4,1,5,Cape Verde
5105,Hérita Ilunga,0,44.0,0,0,0,1,1,Egypt
5106,Hörður Björgvin Magnússon,0,163.0,0,0,1,1,2,Hungary
5107,Hồ Tấn Tài,1,89.0,0,0,1,1,2,China PR
5108,I Kadek Agung Widnyana,1,39.0,0,0,0,1,1,Thailand
5109,I. M. Vijayan,2,157.0,0,0,1,3,4,Hong Kong
5110,Iago Aspas,1,204.0,0,0,1,2,3,Liechtenstein
5111,Iain Dowie,0,388.0,0,3,7,4,11,Northern Ireland
5112,Iain Hume,0,353.0,0,0,0,5,5,United States
5113,Iain Ramsay,1,216.0,0,0,1,2,3,Yemen
5114,Iamel Kabeu,0,30.0,0,0,1,0,1,New Caledonia
5115,Ian Azzopardi,0,82.0,1,0,0,1,1,Malta
5116,Ian Edwards,0,164.0,0,0,4,0,4,Wales
5117,Ian Evans,0,53.0,1,0,2,0,2,Wales
5118,Ian Gaynair,0,40.0,0,0,0,1,1,United States
5119,Ian Goodison,0,206.0,0,0,3,0,3,Jamaica
5120,Ian Gray,0,149.0,0,0,2,0,2,Australia
5121,Ian Harte,1,198.0,0,3,3,4,7,Liechtenstein
5122,Ian Hunter,3,450.0,0,0,3,2,5,New Caledonia
5123,Ian Lake,0,488.0,0,0,6,4,10,United States Virgin Islands
5124,Ian Rush,0,871.0,0,0,13,5,18,Wales
5125,Ian St. John,2,129.0,0,0,1,2,3,Scotland
5126,Ian Stewart,0,72.0,0,0,2,0,2,Northern Ireland
5127,Ian Walsh,0,199.0,0,0,1,2,3,Iceland
5128,Ian Wright,4,468.0,0,0,2,5,7,Poland
5129,Ianis Hagi,0,95.0,0,0,1,1,2,Romania
5130,Ianis Zicu,0,78.0,0,0,1,0,1,Romania
5131,Iau Tuan Naukoot,1,37.0,0,0,0,1,1,Solomon Islands
5132,Iban Iyanga,0,169.0,0,0,2,1,3,Equatorial Guinea
5133,Iban Salvador,0,144.0,0,1,2,0,2,Equatorial Guinea
5134,Ibrahim Afellay,0,223.0,0,0,3,1,4,Netherlands
5135,Ibrahim Al Duraihem,3,186.0,0,1,0,3,3,South Korea
5136,Ibrahim Al Farhan,0,73.0,0,1,0,1,1,Qatar
5137,Ibrahim Al-Harbi,0,73.0,0,0,1,0,1,Saudi Arabia
5138,Ibrahim Al-Hardan,0,65.0,0,0,1,1,2,Yemen DPR
5139,Ibrahim Al-Maadani,0,61.0,0,0,1,0,1,Libya
5140,Ibrahim Al-Rumaihi,1,52.0,1,0,1,0,1,Kuwait
5141,Ibrahim Al-Shahrani,3,256.0,0,0,1,3,4,Taiwan
5142,Ibrahim Amada,1,9.0,0,0,1,0,1,Madagascar
5143,Ibrahim Aoudou,1,60.0,0,1,2,0,2,Cameroon
5144,Ibrahim Bayesh,0,22.0,0,0,0,1,1,Cambodia
5145,Ibrahim Din,2,113.0,0,0,2,0,2,Malaysia
5146,Ibrahim Farhan,0,59.0,0,0,0,2,2,Yemen DPR
5147,Ibrahim Fazeel,0,169.0,0,0,3,0,3,Maldives
5148,Ibrahim Hassan,0,96.0,0,0,2,0,2,Egypt
5149,Ibrahim Kargbo,0,38.0,0,1,1,0,1,Sierra Leone
5150,Ibrahim Kassum,0,57.0,0,0,1,0,1,Ghana
5151,Ibrahim Koroma,0,58.0,0,0,1,0,1,Sierra Leone
5152,Ibrahim Mahudhee,0,27.0,0,0,0,1,1,Guam
5153,Ibrahim Said,0,89.0,0,0,0,1,1,Namibia
5154,Ibrahim Sangaré,2,124.0,0,0,1,1,2,Malawi
5155,Ibrahim Sekagya,0,131.0,0,0,2,0,2,Uganda
5156,Ibrahim Sowed,0,94.0,0,0,2,1,3,Saudi Arabia
5157,Ibrahim Sunday,4,256.0,0,0,3,2,5,Ghana
5158,Ibrahim Suwayed,0,93.0,0,0,0,2,2,Iran
5159,Ibrahim Yahia El-Kawarty,1,90.0,0,0,0,1,1,Nigeria
5160,Ibrahima Bakayoko,2,632.0,0,1,9,4,13,Ivory Coast
5161,Ibrahima Baldé,0,33.0,0,0,1,0,1,Senegal
5162,Ibrahima Diawara,1,82.0,0,0,0,1,1,Algeria
5163,Ibrahima Koné,6,355.0,0,4,4,4,8,Mali
5164,Ibrahima Sonko,0,8.0,0,0,1,0,1,Senegal
5165,Ibrahima Sory Touré,0,66.0,0,1,1,0,1,Guinea
5166,Ibrahima Tallé,0,86.0,0,0,1,0,1,Burkina Faso
5167,Ibrahima Traoré,2,190.0,0,0,1,3,4,Botswana
5168,Ibraime Cassamá,0,45.0,0,0,1,0,1,Guinea-Bissau
5169,Ibroihim Djoudja,0,49.0,0,0,1,0,1,Comoros
5170,Ich Narding,0,96.0,0,0,2,0,2,Thailand
5171,Idan Tal,0,26.0,0,0,1,1,2,Liechtenstein
5172,Idris Abdul Karim,0,87.0,0,0,1,0,1,Malaysia
5173,Idrissa Gueye,2,156.0,0,0,2,1,3,Senegal
5174,Idrissa Sylla,1,43.0,0,0,1,0,1,Guinea
5175,Ifeanyi Onyedika,0,35.0,0,0,1,0,1,Nigeria
5176,Igli Tare,0,345.0,0,0,5,2,7,Germany
5177,Ignace Muwawa,1,19.0,0,0,0,1,1,Congo
5178,Ignacio Ambríz,0,157.0,0,0,4,0,4,Mexico
5179,Ignacio Jáuregui,0,81.0,0,0,0,1,1,Jamaica
5180,Ignacio Prieto,0,204.0,0,1,3,1,4,Chile
5181,Ignatius Lwipa,0,132.0,0,0,0,2,2,Liberia
5182,Igor Armaș,0,141.0,1,0,2,1,3,Finland
5183,Igor Avdeyev,1,217.0,1,0,4,0,4,Kazakhstan
5184,Igor Belanov,4,391.0,0,3,7,1,8,Russia
5185,Igor Bugaiov,0,165.0,0,1,3,2,5,Bosnia and Herzegovina
5186,Igor Chislenko,3,346.0,0,0,4,4,8,Colombia
5187,Igor Demo,0,297.0,0,0,4,0,4,Slovakia
5188,Igor Diveyev,0,28.0,0,0,0,1,1,Slovenia
5189,Igor Dobrovolski,4,285.0,0,3,4,2,6,Russia
5190,Igor Kolyvanov,0,545.0,0,0,4,5,9,Russia
5191,Igor Korneev,0,87.0,0,0,1,0,1,Russia
5192,Igor Mitreski,0,68.0,1,0,0,1,1,North Macedonia
5193,Igor Netto,1,68.0,0,0,1,1,2,Russia
5194,Igor Nikolovski,0,111.0,0,0,0,2,2,Malta
5195,Igor Oprea,0,62.0,0,0,0,3,3,Georgia
5196,Igor Picușceac,0,1.0,0,0,1,0,1,Moldova
5197,Igor Semshov,0,77.0,0,0,1,1,2,Wales
5198,Igor Sergeyev,1,335.0,0,0,3,3,6,Uzbekistan
5199,Igor Shalimov,0,229.0,0,1,1,3,4,Russia
5200,Igor Shitov,0,57.0,1,0,1,0,1,Finland
5201,Igor Shkvyrin,1,201.0,0,0,4,1,5,China PR
5202,Igor Simutenkov,0,90.0,0,0,1,1,2,Cyprus
5203,Igor Tudor,2,231.0,1,0,2,2,4,Croatia
5204,Igor Yanovsky,0,45.0,0,0,1,0,1,Russia
5205,Igor Štimac,0,56.0,0,0,1,0,1,Croatia
5206,Igoris Morinas,0,79.0,0,0,0,2,2,Faroe Islands
5207,Igors Stepanovs,0,90.0,0,0,0,1,1,Georgia
5208,Igors Tarasovs,0,116.0,1,0,2,0,2,Latvia
5209,Ihaab Boussefi,2,89.0,0,0,2,0,2,Libya
5210,Ihar Hurynovich,0,88.0,0,0,0,1,1,Czech Republic
5211,Ihar Stasevich,0,90.0,0,0,0,2,2,Kazakhstan
5212,Ikechi Anya,0,126.0,0,0,0,2,2,North Macedonia
5213,Ikechukwu Uche,0,247.0,0,0,4,1,5,Nigeria
5214,Ikhsan Fandi,1,91.0,0,0,2,1,3,Singapore
5215,Ildar Amirov,0,158.0,1,0,2,0,2,Kyrgyzstan
5216,Ildefons Lima,0,390.0,2,4,5,3,8,Andorra
5217,Ildefonso López,7,386.0,0,0,1,6,7,Paraguay
5218,Ildefonso Sanabria,1,11.0,0,0,0,1,1,Bolivia
5219,Ildemaro Fernández,0,65.0,0,0,1,0,1,Venezuela
5220,Ildo Maneiro,1,23.0,0,0,0,1,1,Israel
5221,Ilham Jaya Kesuma,0,184.0,0,0,4,1,5,Sri Lanka
5222,Ilhomjon Suyunov,0,89.0,0,0,0,1,1,Taiwan
5223,Ilia Gruev,0,68.0,0,0,0,1,1,Russia
5224,Ilia Kovalenko,1,160.0,0,0,1,1,2,Singapore
5225,Ilian Iliev,0,70.0,0,0,0,1,1,Cyprus
5226,Ilias Chair,0,49.0,0,0,1,0,1,Morocco
5227,Ilias Yfantis,0,48.0,0,0,0,1,1,France
5228,Ilie Balaci,0,56.0,0,0,1,0,1,Romania
5229,Ilie Dumitrescu,3,356.0,0,0,7,1,8,Romania
5230,Ilija Najdoski,0,21.0,0,0,1,0,1,Yugoslavia
5231,Ilija Nestorovski,0,343.0,0,1,3,2,5,North Macedonia
5232,Ilija Petković,1,100.0,0,0,3,0,3,Yugoslavia
5233,Ilija Vukotić,0,82.0,0,0,1,0,1,Montenegro
5234,Ilir Kepa,0,67.0,0,0,1,0,1,Albania
5235,Ilir Përnaska,0,144.0,0,0,2,1,3,Albania
5236,Iliyan Mitsanski,0,31.0,0,0,1,1,2,Azerbaijan
5237,Ilja Antonov,0,75.0,0,0,1,0,1,Estonia
5238,Ilya Tsymbalar,1,154.0,0,0,1,2,3,Faroe Islands
5239,Ilčo Naumoski,0,281.0,0,1,4,2,6,Andorra
5240,Im Seung-Hwi,1,58.0,0,0,1,0,1,North Korea
5241,Imad Zatara,1,71.0,0,0,0,1,1,Iraq
5242,Iman Mobali,1,84.0,0,0,0,1,1,Iraq
5243,Imants Bleidelis,0,249.0,0,0,5,1,6,Georgia
5244,Imed Ben Younes,3,142.0,0,0,2,1,3,Ghana
5245,Imed Mhedhebi,0,210.0,0,0,2,2,4,Tunisia
5246,Imowa Malgbanga,0,149.0,0,0,1,1,2,Madagascar
5247,Imran Louza,0,135.0,0,1,2,0,2,Morocco
5248,Imre Boda,0,171.0,0,1,1,2,3,Greece
5249,Imre Garaba,0,44.0,0,0,1,0,1,Hungary
5250,Imre Markos,0,89.0,0,0,0,1,1,Bulgaria
5251,Imre Szabics,0,405.0,0,0,5,2,7,Hungary
5252,Imrich Stacho,0,4.0,0,1,1,0,1,Czechoslovakia
5253,Imthyas Raheem,3,115.0,0,0,0,3,3,Thailand
5254,Imtiaz Ahmed Nakib,1,90.0,0,0,0,1,1,Taiwan
5255,Inder Singh,2,102.0,0,0,1,1,2,India
5256,Indra Putra Mahayuddin,0,74.0,0,0,1,0,1,Malaysia
5257,Indra Sahdan Daud,0,135.0,0,0,2,0,2,Singapore
5258,Indrek Zelinski,0,322.0,0,0,4,2,6,Estonia
5259,Indriði Sigurðsson,0,132.0,0,0,0,2,2,Hungary
5260,Inge Danielsson,0,156.0,0,0,1,2,3,Portugal
5261,Ingemar Erlandsson,0,70.0,0,1,1,0,1,Sweden
5262,Ingemar Teever,0,86.0,0,0,1,1,2,Estonia
5263,Ingi Björn Albertsson,0,33.0,0,0,1,0,1,Iceland
5264,Ingvar Svensson,0,90.0,0,0,1,0,1,Sweden
5265,Iniesta,0,12.0,0,0,0,1,1,Guinea-Bissau
5266,Inoel Navarro,0,77.0,0,0,3,0,3,Dominican Republic
5267,Inyong Lolumbuman,0,73.0,0,0,0,1,1,North Korea
5268,Ioan Andone,0,25.0,0,0,1,0,1,Romania
5269,Ioan Lupescu,0,131.0,0,0,4,0,4,Romania
5270,Ioan Sabău,0,124.0,0,0,3,0,3,Romania
5271,Ioannis Amanatidis,0,140.0,0,0,1,1,2,Turkey
5272,Ioannis Fetfatzidis,0,72.0,0,0,2,0,2,Greece
5273,Ioannis Kousoulos,0,188.0,0,0,1,3,4,Cyprus
5274,Ioannis Okkas,0,895.0,0,0,11,6,17,Bulgaria
5275,Ioannis Pittas,0,42.0,0,0,1,0,1,Cyprus
5276,Ion Dumitru,0,18.0,0,0,1,1,2,Albania
5277,Ion Geolgău,0,148.0,0,0,0,2,2,Czechoslovakia
5278,Ion Ionescu,0,133.0,0,0,2,0,2,Romania
5279,Ion Nicolaescu,0,159.0,0,0,1,2,3,Moldova
5280,Ion Nunweiller,0,81.0,1,0,1,0,1,Spain
5281,Ion Pârcălab,0,1.0,0,0,1,0,1,Romania
5282,Ion Testemițanu,0,61.0,0,1,1,1,2,Moldova
5283,Ion Vlădoiu,0,50.0,0,0,1,0,1,Romania
5284,Ionel Augustin,0,30.0,0,0,0,1,1,Cyprus
5285,Ionel Ganea,1,573.0,0,1,4,5,9,Romania
5286,Ionuţ Mazilu,0,87.0,0,0,1,0,1,Romania
5287,Iosif Petschovsky,0,51.0,0,1,1,0,1,Romania
5288,Iosif Vigu,0,2.0,0,0,1,0,1,Romania
5289,Ipojucan Lins de Araújo,1,87.0,0,0,1,0,1,Brazil
5290,Iraj Danaeifard,2,117.0,0,0,2,0,2,Iran
5291,Ireneo Hermosilla,0,70.0,0,0,1,0,1,Paraguay
5292,Ireneusz Jeleń,0,78.0,0,0,1,1,2,Northern Ireland
5293,Irfan Bachdim,0,84.0,0,0,1,0,1,Indonesia
5294,Irfan Fandi,1,88.0,1,0,1,0,1,Uzbekistan
5295,Irvin Herrera,0,41.0,0,0,0,1,1,Saint Kitts and Nevis
5296,Irwan Fadzli Idrus,1,56.0,0,0,1,0,1,Malaysia
5297,Isa Bakar,2,36.0,0,0,2,0,2,Malaysia
5298,Isa Halim,1,27.0,0,0,0,1,1,Iraq
5299,Isaac Andrade,1,61.0,0,0,0,1,1,Paraguay
5300,Isaac Angking,1,56.0,0,1,1,1,2,Puerto Rico
5301,Isaac Boakye,2,396.0,0,0,2,3,5,Liberia
5302,Isaac Boelua Lokuli,0,123.0,0,0,2,0,2,Angola
5303,Isaac Chauvet,0,220.0,0,0,4,0,4,Haiti
5304,Isaac Kiese Thelin,0,78.0,0,0,1,0,1,Sweden
5305,Isaac Mina,0,12.0,0,0,0,1,1,Venezuela
5306,Isaac Ngoma,1,72.0,0,0,0,2,2,Cape Verde
5307,Isaac Terrazas,1,74.0,0,0,0,1,1,Brazil
5308,Isaac Tondo,0,245.0,0,0,2,1,3,Liberia
5309,Isabelino Gradín,4,281.0,0,0,0,5,5,Chile
5310,Isco,1,219.0,0,0,6,1,7,Spain
5311,Ishmael Addo,0,89.0,0,0,1,0,1,Ghana
5312,Ishmael Wadi,1,38.0,0,0,0,1,1,Malawi
5313,Isiah Lagutang,0,23.0,0,0,1,0,1,Guam
5314,Isidoro Díaz,1,284.0,0,0,5,2,7,Mexico
5315,Isidro Gutiérrez,0,26.0,0,0,1,1,2,Costa Rica
5316,Isidro Lángara,1,295.0,0,1,5,3,8,Spain
5317,Isidro Matute,3,131.0,0,0,3,0,3,Ecuador
5318,Islam Batran,0,85.0,0,0,1,0,1,Palestine
5319,Islam Slimani,8,1212.0,0,2,12,11,23,Algeria
5320,Islambek Kuat,0,328.0,0,0,3,2,5,Kazakhstan
5321,Islom Inomov,0,79.0,0,0,0,1,1,Taiwan
5322,Islom Tukhtakhujaev,0,72.0,0,0,1,0,1,Uzbekistan
5323,Ismaeel Mohammad,0,75.0,0,0,1,0,1,Qatar
5324,Ismaeil Bakhit,0,157.0,0,0,2,0,2,Sudan
5325,Ismael Alassane,0,3.0,0,0,1,0,1,Niger
5326,Ismael Alvariza,0,53.0,0,0,0,1,1,Chile
5327,Ismael Dyfan,0,134.0,0,0,1,1,2,Nigeria
5328,Ismael Díaz,1,49.0,0,0,1,0,1,Panama
5329,Ismael Fuentes,0,48.0,0,0,1,0,1,Chile
5330,Ismael Rivero,3,119.0,0,0,0,3,3,Ecuador
5331,Ismael Sylla,0,77.0,0,0,1,0,1,Guinea
5332,Ismael Urzaiz,0,206.0,0,0,5,1,6,Spain
5333,Ismail Abdullatif,5,917.0,0,3,13,3,16,Bahrain
5334,Ismail Al Hammadi,0,270.0,0,0,3,1,4,South Korea
5335,Ismail Al-Ajmi,0,197.0,0,0,2,2,4,Thailand
5336,Ismail Al-Amour,1,88.0,0,0,0,1,1,Afghanistan
5337,Ismail Isa,0,3.0,0,0,0,1,1,Czech Republic
5338,Ismail Matar,0,524.0,0,1,4,6,10,United Arab Emirates
5339,Ismail Mohammed Sharif,0,108.0,0,0,1,1,2,Somalia
5340,Ismail Naseem,0,67.0,0,0,0,1,1,Cambodia
5341,Ismail Rashid Ismail,0,89.0,0,0,1,0,1,United Arab Emirates
5342,Ismaël Bangoura,1,263.0,0,0,5,1,6,Guinea
5343,Ismaël Bennacer,0,48.0,0,0,0,1,1,Niger
5344,Ismaël Diakité,0,90.0,0,0,1,0,1,Mauritania
5345,Ismaël Koudou,1,10.0,0,0,0,1,1,Egypt
5346,Ismaïla Sarr,3,332.0,0,1,3,4,7,Burkina Faso
5347,Ismed Sofyan,0,101.0,0,0,0,2,2,Maldives
5348,Ismo Lius,0,71.0,0,0,1,0,1,Finland
5349,Israel Castro,0,19.0,0,0,1,0,1,Mexico
5350,Issa Ba,1,80.0,0,0,0,1,1,Zimbabwe
5351,Issa Djibrilla,0,172.0,0,0,2,0,2,Niger
5352,Issa Kaboré,1,51.0,0,0,0,1,1,Djibouti
5353,Issah Gabriel Ahmed,1,60.0,1,0,0,1,1,Ghana
5354,Issam Al Sabhi,0,133.0,0,0,1,1,2,Japan
5355,Issam El Adoua,0,10.0,0,0,0,1,1,South Africa
5356,Issam Jemâa,2,414.0,0,0,4,5,9,Kenya
5357,Issam Mahrous,1,66.0,1,0,1,0,1,Kuwait
5358,Issam Said Saleh,0,83.0,0,0,1,0,1,Jordan
5359,Issey Nakajima-Farran,0,32.0,0,0,0,1,1,Saint Vincent and the Grenadines
5360,Issiaga Sylla,1,35.0,0,0,1,0,1,Guinea
5361,Issiaka Ouédraogo,1,90.0,0,0,0,1,1,Sudan
5362,Issouf Traoré,1,53.0,0,0,1,0,1,Burkina Faso
5363,Issoufou Dayo,3,246.0,0,2,3,2,5,Cape Verde
5364,István Halász,0,43.0,0,0,0,1,1,Bolivia
5365,István Juhász,0,75.0,0,0,1,0,1,Hungary
5366,István Pisont,0,88.0,0,0,0,1,1,Azerbaijan
5367,István Szőke,1,94.0,0,0,1,1,2,Romania
5368,István Vincze,0,147.0,0,0,2,2,4,Hungary
5369,Isuru Perera,0,47.0,0,0,1,0,1,Sri Lanka
5370,Iswadi Idris,1,127.0,0,0,0,3,3,Australia
5371,Isâad Bourahli,0,21.0,0,0,1,1,2,Algeria
5372,Italo Vassalo,0,101.0,0,0,1,0,1,Ethiopia
5373,Itamunua Keimuine,1,89.0,1,0,1,0,1,Morocco
5374,Itay Shechter,0,154.0,0,0,2,0,2,Israel
5375,Itumeleng Duiker,0,37.0,0,0,0,1,1,Niger
5376,Itzhak Peretz,0,54.0,0,0,1,0,1,Israel
5377,Itzhak Shum,2,131.0,0,0,2,0,2,Israel
5378,Itzik Zohar,0,290.0,0,0,0,5,5,Austria
5379,Iulian Apostol,0,16.0,0,0,1,0,1,Romania
5380,Iuliu Barátky,1,88.0,0,0,0,1,1,Cuba
5381,Iurie Miterev,0,85.0,0,0,2,0,2,Moldova
5382,Ivan Bek,3,157.0,0,0,0,3,3,Brazil
5383,Ivan Buljan,0,102.0,0,0,0,2,2,Norway
5384,Ivan Davidov,1,43.0,1,0,0,1,1,Bulgaria
5385,Ivan Gudelj,0,37.0,0,0,1,1,2,Spain
5386,Ivan Hašek,1,141.0,0,0,0,5,5,Denmark
5387,Ivan Iliev,0,84.0,0,0,0,1,1,Denmark
5388,Ivan Ivanov,0,86.0,0,0,1,1,2,Switzerland
5389,Ivan Klasnić,2,299.0,0,0,3,2,5,Croatia
5390,Ivan Kolev,0,203.0,0,1,1,3,4,Bulgaria
5391,Ivan Matteoni,0,83.0,1,0,0,1,1,San Marino
5392,Ivan Mráz,0,18.0,0,0,2,0,2,Czechoslovakia
5393,Ivan Obradović,0,24.0,0,0,0,1,1,Austria
5394,Ivan Perišić,10,1201.0,0,0,12,13,25,Belgium
5395,Ivan Rakitić,2,486.0,0,2,5,4,9,Andorra
5396,Ivan Schranz,0,75.0,0,0,1,1,2,Slovakia
5397,Ivan Tričkovski,0,65.0,0,0,1,1,2,Republic of Ireland
5398,Ivan Vicelich,0,227.0,0,0,4,1,5,New Zealand
5399,Ivan Vutsov,2,82.0,2,0,1,1,2,Belgium
5400,Ivan Yaremchuk,1,66.0,0,0,1,0,1,Russia
5401,Ivaylo Chochev,0,229.0,0,0,2,1,3,Bulgaria
5402,Ivaylo Petkov,0,68.0,0,0,1,0,1,Bulgaria
5403,Ivaylo Yordanov,0,104.0,0,0,1,1,2,Bulgaria
5404,Ivelin Popov,0,429.0,0,0,6,4,10,Bulgaria
5405,Iver Fossum,0,8.0,0,0,1,0,1,Norway
5406,Ivica Grlić,0,68.0,0,0,0,1,1,Moldova
5407,Ivica Horvat,1,9.0,1,0,1,0,1,Germany
5408,Ivica Olić,3,502.0,0,0,5,7,12,Italy
5409,Ivica Osim,0,192.0,0,0,3,0,3,Yugoslavia
5410,Ivica Vastić,1,560.0,0,1,6,3,9,Austria
5411,Ivica Šurjak,2,306.0,0,1,2,6,8,Greece
5412,Ivo Basay,4,306.0,0,0,5,0,5,Chile
5413,Ivo Knoflíček,0,149.0,0,0,2,1,3,Czechoslovakia
5414,Ivo Raimundo Traça,0,57.0,0,0,1,0,1,Angola
5415,Ivor Allchurch,2,542.0,0,0,5,5,10,Wales
5416,Ivor Broadis,2,102.0,0,0,0,3,3,Scotland
5417,Iván Córdoba,1,117.0,0,2,2,1,3,Argentina
5418,Iván Guerrero,0,158.0,0,0,1,2,3,Honduras
5419,Iván Helguera,0,89.0,0,0,2,0,2,Spain
5420,Iván Hurtado,1,137.0,1,0,1,1,2,Peru
5421,Iván Kaviedes,3,528.0,0,0,4,5,9,Argentina
5422,Iván Valenciano,0,171.0,0,0,3,1,4,Colombia
5423,Iván Zamorano,3,1338.0,0,5,19,6,25,Venezuela
5424,Izet Hajrović,0,239.0,0,0,1,3,4,Slovakia
5425,Iļja Vestermans,0,123.0,0,0,1,2,3,Latvia
5426,J. P. Rodrigues,0,51.0,1,0,1,0,1,Mexico
5427,Jaap Stam,0,32.0,0,0,1,0,1,Netherlands
5428,Jaba Kankava,1,175.0,0,0,0,5,5,Croatia
5429,Jabarry Chandler,0,90.0,0,0,0,1,1,United States Virgin Islands
5430,Jabra Al-Zarqa,0,70.0,0,0,1,0,1,Syria
5431,Jabu Pule,0,71.0,0,0,0,1,1,Lesotho
5432,Jacek Bąk,0,3.0,0,0,1,0,1,Poland
5433,Jacek Góralski,0,81.0,0,0,1,0,1,Poland
5434,Jacek Krzynówek,0,593.0,0,0,2,6,8,Northern Ireland
5435,Jacek Ziober,0,85.0,0,0,0,1,1,Albania
5436,Jacinto Barquín,1,42.0,0,0,0,1,1,United States
5437,Jacinto João,0,73.0,0,0,1,1,2,Portugal
5438,Jacinto Santos,0,93.0,0,0,2,0,2,Portugal
5439,Jack Chamangwana,0,88.0,1,0,1,0,1,Zambia
5440,Jack Charlton,0,168.0,0,0,2,0,2,England
5441,Jack Froggatt,0,25.0,0,0,1,0,1,England
5442,Jack Grealish,1,176.0,0,0,1,1,2,Andorra
5443,Jack Michael Morillo,0,79.0,0,0,1,0,1,Dominican Republic
5444,Jack Rowley,0,167.0,0,0,4,0,4,England
5445,Jack Samani,2,249.0,0,0,3,1,4,Solomon Islands
5446,Jack Wilshere,0,130.0,0,0,0,2,2,Slovenia
5447,Jackie Henderson,0,89.0,0,0,0,1,1,Northern Ireland
5448,Jackie Milburn,0,129.0,0,0,0,3,3,Wales
5449,Jackie Mudie,1,280.0,0,0,4,2,6,Scotland
5450,Jackner Louis,0,90.0,0,0,0,1,1,Turks and Caicos Islands
5451,Jackson Irvine,1,155.0,0,0,1,4,5,Australia
5452,Jackson Martínez,2,296.0,0,0,2,3,5,Colombia
5453,Jacky Novi,0,43.0,1,0,0,1,1,France
5454,Jacky Valette,1,90.0,0,0,0,1,1,Fiji
5455,Jacob Bruun Larsen,0,63.0,0,0,1,0,1,Denmark
5456,Jacob Ewane,0,90.0,0,0,1,0,1,Cameroon
5457,Jacob Mulenga,3,256.0,0,0,5,2,7,Zambia
5458,Jacob Ngwira,0,64.0,0,0,1,0,1,Malawi
5459,Jacob Xowie,0,62.0,0,0,1,0,1,New Caledonia
5460,Jacobo Kouffati,0,2.0,0,0,1,0,1,Venezuela
5461,Jacques Faivre,0,47.0,0,0,2,0,2,France
5462,Jacques Fatton,0,341.0,0,0,3,3,6,Switzerland
5463,Jacques Foix,0,57.0,0,0,1,0,1,France
5464,Jacques Haeko,6,478.0,0,0,5,2,7,Tahiti
5465,Jacques Mamounoubala,1,80.0,0,0,1,0,1,Congo
5466,Jacques Ndomba,1,65.0,0,0,1,0,1,Congo
5467,Jacques Stockman,0,277.0,0,0,1,4,5,Yugoslavia
5468,Jacques Teugels,0,87.0,0,1,0,1,1,Iceland
5469,Jacques Tuyisenge,0,108.0,0,0,3,0,3,Rwanda
5470,Jacques Vergnes,0,33.0,0,0,0,1,1,Norway
5471,Jacques Zimako,0,164.0,0,0,1,1,2,Cyprus
5472,Jacques-Désiré Périatambée,0,45.0,0,0,0,1,1,Egypt
5473,Jadallah Kheirelseid,0,43.0,0,0,0,1,1,Nigeria
5474,Jaden Servania,0,66.0,0,0,1,0,1,Puerto Rico
5475,Jadon Sancho,0,89.0,0,0,2,0,2,England
5476,Jafar Irismetov,3,489.0,0,0,8,3,11,Uzbekistan
5477,Jafet Soto,4,301.0,0,2,4,2,6,Mexico
5478,Jaffar Omran,1,90.0,0,0,1,0,1,Iraq
5479,Jagajeet Shrestha,0,89.0,0,0,1,0,1,Nepal
5480,Jagdoul,0,80.0,0,0,1,0,1,Sudan
5481,Jahid Hasan Ameli,0,138.0,0,0,3,0,3,Bangladesh
5482,Jahn Ivar Jakobsen,0,46.0,0,0,1,0,1,Norway
5483,Jahongir Ergashev,0,17.0,0,0,0,1,1,Kyrgyzstan
5484,Jaime Alas,0,96.0,0,0,1,1,2,El Salvador
5485,Jaime Arrascaita,0,47.0,0,0,1,0,1,Bolivia
5486,Jaime Ayoví,1,35.0,0,0,2,0,2,Ecuador
5487,Jaime Belmonte,1,166.0,0,0,2,0,2,Mexico
5488,Jaime Castrillón,3,149.0,0,0,1,2,3,Mexico
5489,Jaime Colomé,1,156.0,0,1,1,3,4,Panama
5490,Jaime González,0,90.0,0,0,2,0,2,Colombia
5491,Jaime Graça,0,138.0,0,0,3,0,3,Portugal
5492,Jaime Gutiérrez,1,32.0,0,0,2,0,2,Colombia
5493,Jaime Lozano,2,551.0,0,0,6,5,11,Dominica
5494,Jaime Moreno,1,241.0,0,0,3,3,6,Bolivia
5495,Jaime Morón,0,86.0,0,0,1,0,1,Colombia
5496,Jaime Patricio Ramírez,1,10.0,0,0,0,1,1,Bolivia
5497,Jaime Pizarro,1,68.0,0,1,0,1,1,Bolivia
5498,Jaime Ramírez,4,443.0,0,1,7,2,9,Chile
5499,Jaime Riveros,0,39.0,0,0,0,1,1,Colombia
5500,Jaime Vera,2,260.0,0,0,3,0,3,Chile
5501,Jaime Vladimir Cubías,0,89.0,0,0,0,1,1,Saint Vincent and the Grenadines
5502,Jaime de Almeida,1,38.0,0,0,1,0,1,Brazil
5503,Jaimes McKee,0,76.0,0,0,2,0,2,Hong Kong
5504,Jair,4,556.0,0,1,15,0,15,Brazil
5505,Jair Catuy,1,155.0,0,0,2,0,2,Panama
5506,Jair García,1,31.0,0,0,0,1,1,El Salvador
5507,Jairo Arreola,0,55.0,0,0,1,0,1,Guatemala
5508,Jairo Arrieta,1,71.0,0,0,1,0,1,Costa Rica
5509,Jairo Castillo,0,173.0,0,0,1,2,3,Bolivia
5510,Jairo Henríquez,1,43.0,0,0,0,3,3,Trinidad and Tobago
5511,Jairo Jiménez,1,85.0,0,0,1,0,1,Panama
5512,Jairo Patiño,3,194.0,0,0,2,1,3,Jamaica
5513,Jairo Quinteros,1,40.0,1,0,0,1,1,Bolivia
5514,Jairzinho,9,707.0,0,0,9,3,12,Paraguay
5515,Jaka Ihbeisheh,2,176.0,0,0,3,0,3,Palestine
5516,Jake Gosling,0,87.0,0,0,0,1,1,Poland
5517,Jakkaphan Kaewprom,0,18.0,0,0,1,0,1,Thailand
5518,Jakob Johansson,0,61.0,0,0,1,0,1,Sweden
5519,Jakob Poulsen,0,165.0,0,0,2,0,2,Denmark
5520,Jakub Brabec,0,68.0,0,0,2,0,2,Czech Republic
5521,Jakub Błaszczykowski,2,388.0,0,3,4,6,10,Poland
5522,Jakub Jankto,1,74.0,0,0,1,1,2,Czech Republic
5523,Jakub Kosecki,0,90.0,0,0,1,0,1,Poland
5524,Jakub Moder,0,58.0,0,0,0,1,1,England
5525,Jakub Pešek,0,38.0,0,0,1,0,1,Czech Republic
5526,Jakub Wawrzyniak,0,81.0,0,0,1,0,1,Poland
5527,Jalal Hosseini,1,179.0,0,0,2,3,5,Iran
5528,Jaloliddin Masharipov,4,99.0,0,1,2,2,4,Turkmenistan
5529,Jamal Abu Abed,0,146.0,0,0,1,1,2,Jordan
5530,Jamal Al-Holi,1,29.0,0,1,0,1,1,Malaysia
5531,Jamal Ballantyne,0,9.0,0,0,0,1,1,El Salvador
5532,Jamal Chandler,0,25.0,0,0,0,1,1,United States Virgin Islands
5533,Jamal Charles,0,80.0,0,0,1,0,1,Grenada
5534,Jamal Kazem,0,6.0,0,0,1,0,1,Syria
5535,Jamal Keshek,2,93.0,0,0,1,1,2,Bangladesh
5536,Jamal Mohamed,0,44.0,0,1,1,0,1,Kenya
5537,Jamal Mubarak,0,67.0,0,0,1,0,1,Kuwait
5538,Jamal Musiala,0,83.0,0,0,0,1,1,North Macedonia
5539,Jamal Rashid,1,90.0,0,1,0,1,1,India
5540,Jamal Taha,0,53.0,0,0,1,0,1,Lebanon
5541,Jamal Willer,0,65.0,0,0,1,0,1,Montserrat
5542,Jamal Yaqoub,0,88.0,0,0,1,0,1,Kuwait
5543,Jameleddine Limam,0,245.0,0,0,4,1,5,Tunisia
5544,James Chamanga,4,159.0,0,0,1,3,4,Tunisia
5545,James Chewitt,0,412.0,0,0,3,4,7,Saint Vincent and the Grenadines
5546,James Collins,0,160.0,0,0,1,2,3,Cyprus
5547,James Debbah,1,258.0,0,1,3,1,4,Liberia
5548,James Ha,0,20.0,0,0,1,0,1,Hong Kong
5549,James Lawrence,0,17.0,1,0,1,0,1,Croatia
5550,James Marcelin,2,225.0,0,0,2,2,4,Haiti
5551,James McArthur,0,204.0,0,0,2,1,3,Scotland
5552,James McClean,0,349.0,0,0,2,4,6,Republic of Ireland
5553,James McFadden,0,594.0,0,0,7,3,10,Scotland
5554,James Milner,0,74.0,0,0,0,1,1,Moldova
5555,James Moga,0,166.0,0,0,2,1,3,Sudan
5556,James Morrison,0,27.0,0,0,0,1,1,Wales
5557,James Murphy,0,80.0,0,0,1,0,1,United States
5558,James Rodríguez,6,984.0,0,4,8,11,19,Peru
5559,James Troisi,1,237.0,0,0,2,1,3,Australia
5560,James Ward-Prowse,0,93.0,0,0,1,1,2,England
5561,James Wong,4,164.0,0,0,4,0,4,Malaysia
5562,James Wong Chye Fook,1,6.0,0,0,0,1,1,South Korea
5563,Jamie Browne,0,65.0,0,0,1,1,2,United States Virgin Islands
5564,Jamie Lawrence,0,14.0,0,0,0,1,1,United States
5565,Jamie Lowery,1,83.0,0,0,1,0,1,Canada
5566,Jamie Maclaren,2,289.0,0,2,5,3,8,Palestine
5567,Jamie Pace,0,44.0,0,0,1,1,2,Malta
5568,Jamie Thomas,0,86.0,0,0,1,0,1,Antigua and Barbuda
5569,Jamie Vardy,1,122.0,0,0,2,0,2,England
5570,Jamie Ward,0,148.0,0,0,3,1,4,Northern Ireland
5571,Jamil Joseph,0,114.0,0,0,3,0,3,Saint Lucia
5572,Jamil Kyambadde,0,89.0,0,0,1,0,1,Uganda
5573,Jamiro Monteiro,1,52.0,0,0,0,1,1,Liberia
5574,Jamiru Amidu,0,14.0,0,0,0,1,1,Ghana
5575,Jamshed Ismailov,0,2.0,0,0,1,0,1,Tajikistan
5576,Jamshid Iskanderov,0,53.0,0,0,1,0,1,Uzbekistan
5577,Jan Allan Müller,0,163.0,0,0,2,1,3,Scotland
5578,Jan Banaś,0,6.0,0,0,0,1,1,Albania
5579,Jan Bartram,0,58.0,0,1,1,1,2,Denmark
5580,Jan Bednarek,1,59.0,0,0,0,1,1,Japan
5581,Jan Berger,0,77.0,0,1,1,0,1,Czechoslovakia
5582,Jan Ceulemans,6,672.0,0,0,8,7,15,Belgium
5583,Jan Domarski,0,110.0,0,0,1,1,2,Poland
5584,Jan Eriksson,0,125.0,0,0,3,0,3,Sweden
5585,Jan Fuglset,0,55.0,0,1,1,0,1,Norway
5586,Jan Furtok,0,147.0,0,0,2,0,2,Poland
5587,Jan Heintze,0,74.0,0,0,1,1,2,Denmark
5588,Jan Koller,4,1675.0,0,2,18,15,33,Estonia
5589,Jan Kopic,0,62.0,0,0,1,1,2,Azerbaijan
5590,Jan Kristian Fjærestad,0,32.0,0,0,0,1,1,German DR
5591,Jan Liberda,0,54.0,0,0,1,0,1,Poland
5592,Jan Michaelsen,0,90.0,0,0,1,0,1,Denmark
5593,Jan Mulder,0,10.0,0,0,0,1,1,German DR
5594,Jan Mølby,0,69.0,0,0,1,1,2,Finland
5595,Jan Olsson,0,62.0,0,0,1,0,1,Sweden
5596,Jan Peters,0,89.0,0,0,1,0,1,Netherlands
5597,Jan Polák,0,294.0,0,0,5,0,5,Czech Republic
5598,Jan Rezek,0,128.0,0,0,1,2,3,Lithuania
5599,Jan Ríha,0,44.0,0,0,0,1,1,Bulgaria
5600,Jan Suchopárek,1,90.0,0,0,0,2,2,Norway
5601,Jan Svensson,0,128.0,0,0,1,1,2,Czechoslovakia
5602,Jan Szmidt,0,29.0,0,0,1,0,1,Poland
5603,Jan Sýkora,0,85.0,0,0,1,0,1,Czech Republic
5604,Jan Urban,0,86.0,0,0,1,0,1,Poland
5605,Jan Vertonghen,2,380.0,0,0,2,4,6,Belgium
5606,Jan Åge Fjørtoft,0,278.0,0,0,5,2,7,Norway
5607,Janek Meet,0,97.0,2,0,2,0,2,Scotland
5608,Jang Hyun-soo,0,104.0,0,1,1,1,2,Lebanon
5609,Jang Kuk-chol,0,83.0,0,0,1,1,2,North Korea
5610,Jang Song-Hyok,0,54.0,0,1,0,1,1,Tajikistan
5611,Janne Lindberg,0,78.0,0,0,0,1,1,Faroe Islands
5612,Janne Salli,0,63.0,0,0,1,0,1,Finland
5613,Jannick Buyla,1,57.0,0,0,0,1,1,Senegal
5614,Jannik Vestergaard,0,90.0,0,0,1,0,1,Denmark
5615,Jano Ananidze,0,78.0,0,0,1,0,1,Georgia
5616,Janus Guðlaugsson,0,61.0,0,0,1,1,2,Iceland
5617,Janusz Kupcewicz,1,118.0,0,0,1,1,2,Poland
5618,Janusz Żmijewski,0,147.0,0,0,0,3,3,Belgium
5619,Janício Martins,0,73.0,0,0,0,1,1,South Africa
5620,Jaouad Zairi,1,261.0,0,0,4,0,4,Morocco
5621,Jarchinio Antonia,0,45.0,0,0,1,0,1,Curaçao
5622,Jared Borgetti,12,1795.0,0,1,29,8,37,Mexico
5623,Jari Litmanen,0,1007.0,0,4,8,10,18,Finland
5624,Jari Rantanen,0,43.0,0,0,2,0,2,Finland
5625,Jari Vanhala,0,60.0,0,0,1,0,1,Finland
5626,Jarkko Hurme,0,55.0,0,0,1,0,1,Finland
5627,Jarmo Manninen,0,88.0,0,0,1,0,1,Finland
5628,Jaromír Zmrhal,0,47.0,0,0,1,0,1,Czech Republic
5629,Jaroslav Plašil,1,304.0,0,0,1,4,5,Germany
5630,Jaroslav Pollák,0,16.0,0,0,0,1,1,Finland
5631,Jaroslav Timko,0,147.0,0,0,3,0,3,Slovakia
5632,Jarvin Skeete,0,104.0,0,0,2,0,2,Saint Lucia
5633,Jasem Al-Huwaidi,13,959.0,0,0,11,10,21,Macau
5634,Jasem Yaqoub,1,535.0,0,3,6,5,11,Bahrain
5635,Jasim Al-Shaikh,0,51.0,0,0,1,0,1,Bahrain
5636,Jason Culina,0,20.0,0,0,1,0,1,Australia
5637,Jason Cunliffe,0,199.0,0,0,3,0,3,Guam
5638,Jason Davidson,0,14.0,0,0,1,0,1,Australia
5639,Jason Demetriou,0,80.0,0,0,0,1,1,Israel
5640,Jason François,0,87.0,0,0,2,0,2,Grenada
5641,Jason Koumas,0,208.0,0,2,4,0,4,Wales
5642,Jason Mayélé,0,108.0,0,0,3,0,3,DR Congo
5643,Jason McAteer,0,141.0,0,0,2,1,3,Republic of Ireland
5644,Jason Roberts,0,119.0,0,1,4,1,5,Guyana
5645,Jason Scotland,0,49.0,0,0,1,0,1,Trinidad and Tobago
5646,Jason de Vos,1,166.0,0,0,2,1,3,Canada
5647,Jasse Tuominen,0,21.0,0,0,1,0,1,Finland
5648,Jassem Al-Tamimi,1,165.0,0,0,2,0,2,Qatar
5649,Jassim Mohammed Ghulam,0,71.0,0,0,0,1,1,Pakistan
5650,Jassim Swadi,1,68.0,0,0,1,0,1,Iraq
5651,Jasur Khasanov,0,12.0,0,0,0,1,1,Lebanon
5652,Javad Kazemian,1,78.0,0,0,1,0,1,Iran
5653,Javad Manafi,1,90.0,0,0,0,1,1,Saudi Arabia
5654,Javad Nekounam,3,1032.0,0,2,12,5,17,Iran
5655,Javain Brown,0,43.0,1,0,1,0,1,Panama
5656,Javi Moreno,0,76.0,0,0,1,0,1,Spain
5657,Javid Huseynov,0,4.0,0,0,1,0,1,Azerbaijan
5658,Javier Ambrois,6,555.0,0,1,1,11,12,England
5659,Javier Astúa,0,210.0,0,0,4,0,4,Costa Rica
5660,Javier Balboa,0,334.0,0,2,4,0,4,Equatorial Guinea
5661,Javier Chevantón,1,302.0,0,1,3,3,6,Bolivia
5662,Javier Delgado,0,127.0,1,0,2,0,2,Mexico
5663,Javier Ferreira,0,115.0,0,0,2,0,2,Paraguay
5664,Javier Fragoso,0,148.0,0,0,3,0,3,Mexico
5665,Javier Guzmán,0,25.0,1,0,0,1,1,Mexico
5666,Javier Hernández,17,1430.0,0,2,10,14,24,France
5667,Javier Manjarín,1,84.0,0,0,1,1,2,Spain
5668,Javier Margas,0,154.0,0,0,1,2,3,Venezuela
5669,Javier Mascherano,2,154.0,0,0,2,0,2,Argentina
5670,Javier Pastore,1,26.0,0,0,1,0,1,Argentina
5671,Javier Patiño,0,66.0,0,0,2,0,2,Philippines
5672,Javier Saviola,5,377.0,0,0,6,0,6,Argentina
5673,Javier Tamayo,0,61.0,0,0,0,1,1,Venezuela
5674,Javier Valdivia,0,91.0,0,0,2,0,2,Mexico
5675,Javier Zanetti,1,89.0,0,0,2,0,2,Argentina
5676,Javokhir Sidikov,1,17.0,0,0,0,1,1,Turkmenistan
5677,Jawad Khalaf,0,42.0,0,0,0,1,1,Thailand
5678,Jawdat Suleiman,1,90.0,0,0,1,0,1,Syria
5679,Jawhar Mnari,1,73.0,0,0,1,1,2,Tunisia
5680,Jay-Jay Okocha,3,394.0,0,2,8,3,11,Nigeria
5681,Jaycee John Okwunwanne,1,68.0,0,0,1,1,2,Saudi Arabia
5682,Jaylee Hodgson,3,188.0,0,0,2,1,3,Montserrat
5683,Jaylon Bather,1,40.0,0,0,1,0,1,Bermuda
5684,Je-Vaughn Watson,1,132.0,1,0,2,1,3,Jamaica
5685,Jean Alexandre,0,143.0,0,0,2,0,2,Haiti
5686,Jean Beausejour,2,167.0,0,0,2,1,3,Chile
5687,Jean Capelle,1,15.0,0,0,0,1,1,Republic of Ireland
5688,Jean Desgranges,0,90.0,0,0,2,0,2,France
5689,Jean Djorkaeff,0,41.0,0,1,1,0,1,France
5690,Jean Dockx,0,60.0,0,0,1,0,1,Belgium
5691,Jean Foutika,2,121.0,0,0,2,0,2,Congo
5692,Jean Gallice,0,89.0,0,0,1,0,1,France
5693,Jean Hmae,2,180.0,0,0,2,0,2,New Caledonia
5694,Jean Jacques Radonamahafalison,0,15.0,0,0,0,1,1,Benin
5695,Jean Janssens,0,31.0,0,0,0,1,1,Norway
5696,Jean Kalala N'Tumba,3,283.0,0,0,3,4,7,Congo
5697,Jean Klein,0,85.0,0,0,0,1,1,France
5698,Jean Lomami,0,95.0,0,0,1,1,2,Rwanda
5699,Jean Luciano,1,83.0,0,0,1,0,1,France
5700,Jean Ludivion,1,82.0,0,0,0,1,1,Solomon Islands
5701,Jean Makoun,0,292.0,0,0,5,0,5,Cameroon
5702,Jean Maleb,3,299.0,0,0,0,4,4,American Samoa
5703,Jean Manga Onguéné,1,228.0,0,0,2,2,4,Cameroon
5704,Jean Meneses,0,56.0,0,0,0,1,1,Colombia
5705,Jean Michaël Seri,1,90.0,0,0,1,0,1,Ivory Coast
5706,Jean Monuma,0,61.0,0,0,1,0,1,Haiti
5707,Jean Márquez,0,83.0,0,0,1,0,1,Guatemala
5708,Jean Nako Naprapol,2,122.0,0,0,3,0,3,Vanuatu
5709,Jean Nicolas,1,370.0,0,1,2,5,7,Luxembourg
5710,Jean Paul Farrugia,0,14.0,0,0,1,0,1,Malta
5711,Jean Petit,0,38.0,0,0,1,0,1,France
5712,Jean Seri,0,64.0,0,0,1,0,1,Ivory Coast
5713,Jean Sony Alcénat,0,40.0,0,0,1,0,1,Haiti
5714,Jean Tigana,1,62.0,0,0,0,1,1,Hungary
5715,Jean Tsaralaza,0,79.0,0,0,1,0,1,Madagascar
5716,Jean Vincent,2,528.0,0,0,12,0,12,France
5717,Jean Xowie,1,216.0,0,0,2,1,3,New Zealand
5718,Jean-Alain Boumsong,0,42.0,0,0,1,0,1,France
5719,Jean-Baptiste N'Doga,0,49.0,0,0,2,0,2,Cameroon
5720,Jean-Brice Wadriako,1,53.0,0,0,1,0,1,New Caledonia
5721,Jean-Charles Castelletto,1,29.0,0,0,1,0,1,Cameroon
5722,Jean-Claude Bras,0,82.0,0,0,2,0,2,France
5723,Jean-Claude Désir,0,20.0,0,0,0,1,1,El Salvador
5724,Jean-Claude Iranzi,0,70.0,0,0,1,0,1,Rwanda
5725,Jean-Eudes Maurice,2,301.0,0,2,2,6,8,Haiti
5726,Jean-François Domergue,0,138.0,0,0,2,0,2,France
5727,Jean-François Larios,0,196.0,0,2,1,2,3,France
5728,Jean-Jacques Marcel,0,104.0,0,0,1,1,2,Austria
5729,Jean-Jacques Missé-Missé,0,63.0,0,0,0,1,1,Togo
5730,Jean-Jacques N'Domba,0,141.0,0,0,0,2,2,Cameroon
5731,Jean-Kasongo Banza,0,88.0,0,0,0,1,1,Burkina Faso
5732,Jean-Louis Bozon,1,15.0,0,0,0,1,1,Algeria
5733,Jean-Louis Straetmans,0,37.0,0,0,0,1,1,Sweden
5734,Jean-Loup Rousseau,6,339.0,0,1,6,1,7,Tahiti
5735,Jean-Marc Ferreri,1,27.0,0,0,1,0,1,France
5736,Jean-Marc Guillou,0,173.0,0,0,3,0,3,France
5737,Jean-Marie Mbuyi,0,30.0,0,0,0,1,1,Sierra Leone
5738,Jean-Marie Tsébo,1,55.0,0,0,1,1,2,Cameroon
5739,Jean-Michel Larqué,0,66.0,0,0,0,1,1,Republic of Ireland
5740,Jean-Michel M'Bono,5,251.0,0,0,5,1,6,Congo
5741,Jean-Paul,0,119.0,0,0,2,0,2,Madagascar
5742,Jean-Paul Akono,0,4.0,0,1,1,0,1,Cameroon
5743,Jean-Paul Brigger,0,149.0,0,1,2,1,3,Switzerland
5744,Jean-Paul Girres,0,57.0,0,0,1,0,1,Luxembourg
5745,Jean-Philippe Durand,0,89.0,0,0,1,0,1,France
5746,Jean-Philippe Peguero,2,56.0,0,0,2,0,2,Haiti
5747,Jean-Philippe Saïko,1,95.0,0,0,0,2,2,Papua New Guinea
5748,Jean-Pierre Fiala,0,88.0,0,0,1,0,1,Cameroon
5749,Jean-Pierre Fiedler,0,5.0,0,0,0,1,1,Netherlands
5750,Jean-Pierre Guede Akenon,0,71.0,0,1,1,0,1,Ivory Coast
5751,Jean-Pierre Papin,4,968.0,0,4,10,10,20,Canada
5752,Jean-Pierre Tokoto,0,40.0,0,0,0,1,1,Morocco
5753,Jean-Pierre Vanek,0,82.0,0,0,1,0,1,Luxembourg
5754,Jean-Robert Menelas,0,151.0,0,0,4,0,4,Haiti
5755,Jean-Sebastien Bax,0,88.0,0,0,0,1,1,Egypt
5756,Jean-Silvestre N'Keoua,0,29.0,0,0,0,1,1,Equatorial Guinea
5757,Jean-Yves Randriamarozaka,0,61.0,0,0,1,0,1,Madagascar
5758,Jeannot Reiter,0,60.0,0,0,1,1,2,Luxembourg
5759,Jeff Agoos,1,171.0,1,0,2,1,3,United States
5760,Jeff Campbell,0,325.0,0,0,5,0,5,New Zealand
5761,Jeff Gellineau,0,2.0,0,0,1,0,1,Trinidad and Tobago
5762,Jeff Hendrick,0,52.0,0,0,0,2,2,Serbia
5763,Jeff Strasser,0,75.0,0,0,1,2,3,Luxembourg
5764,Jeff Whitley,0,69.0,0,0,0,2,2,Finland
5765,Jefferson Farfán,1,975.0,0,1,14,4,18,Peru
5766,Jefferson Lerma,0,6.0,0,0,0,1,1,Chile
5767,Jefferson Montero,0,214.0,0,0,3,2,5,Peru
5768,Jeffrey Bruma,0,78.0,0,0,1,0,1,Netherlands
5769,Jeffrey Edmond,0,66.0,0,0,0,1,1,Antigua and Barbuda
5770,Jeffrey Kwaomae,1,43.0,0,0,0,1,1,Tahiti
5771,Jeffrey Talan,0,71.0,0,0,1,0,1,Netherlands
5772,Jehad Al-Hussain,0,236.0,0,1,3,2,5,Syria
5773,Jehad Muntasser,0,21.0,0,0,1,1,2,Libya
5774,Jeison Murillo,1,36.0,0,0,0,1,1,Brazil
5775,Jeje Lalpekhlua,1,182.0,0,0,1,2,3,India
5776,Jelle Vossen,0,85.0,0,0,2,0,2,Belgium
5777,Jens Erik Rasmussen,0,9.0,0,0,1,0,1,Faroe Islands
5778,Jens Jeremies,0,31.0,0,0,1,0,1,Germany
5779,Jens Jørn Bertelsen,0,68.0,0,0,1,0,1,Denmark
5780,Jens Kristian Hansen,0,135.0,0,0,2,1,3,Faroe Islands
5781,Jens Petersen,0,18.0,0,1,1,0,1,Denmark
5782,Jens Stryger Larsen,0,35.0,0,0,1,0,1,Denmark
5783,Jensy Muñoz,0,31.0,0,0,0,1,1,United States
5784,Jenílson Ângelo de Souza,1,64.0,0,0,0,1,1,Costa Rica
5785,Jenő Vincze,1,79.0,0,0,1,1,2,Egypt
5786,Jeong Gang-Ji,0,57.0,0,0,2,0,2,South Korea
5787,Jeong Sang-bin,0,77.0,0,0,1,0,1,South Korea
5788,Jeong Woo-yeong,1,80.0,0,0,0,1,1,Iraq
5789,Jeremain Lens,0,193.0,0,0,2,3,5,Hungary
5790,Jeremy Bokila,2,141.0,0,0,1,1,2,DR Congo
5791,Jeremy Charles,0,72.0,0,0,1,0,1,Wales
5792,Jeremy Christie,0,69.0,0,0,1,0,1,New Zealand
5793,Jeris Tadrus,3,147.0,0,0,3,1,4,Jordan
5794,Jerko Leko,0,76.0,0,0,1,0,1,Croatia
5795,Jermain Defoe,1,698.0,0,0,9,5,14,Poland
5796,Jermaine Anderson,0,90.0,0,0,1,0,1,Jamaica
5797,Jermaine Beckford,0,89.0,0,0,1,0,1,Jamaica
5798,Jermaine Hue,2,92.0,0,0,1,1,2,Guatemala
5799,Jermaine Jones,1,150.0,0,0,3,0,3,United States
5800,Jerome Ramatlhakwane,0,110.0,0,1,1,1,2,Botswana
5801,Jerren Nixon,2,242.0,0,0,3,2,5,Trinidad and Tobago
5802,Jerry Akaminko,0,90.0,0,0,1,0,1,Ghana
5803,Jerry Alexander,0,315.0,0,0,4,3,7,Barbados
5804,Jerry Bengtson,4,598.0,0,0,8,5,13,Grenada
5805,Jerry Donga,1,64.0,0,0,0,2,2,Vanuatu
5806,Jerry Louis,0,89.0,0,0,1,0,1,Mauritius
5807,Jerry Sitoe,0,45.0,0,0,1,0,1,Mozambique
5808,Jerry Tondelua,3,249.0,0,2,2,2,4,DR Congo
5809,Jerson Tegete,0,90.0,0,0,1,2,3,Mauritius
5810,Jersson González,0,68.0,0,0,1,0,1,Colombia
5811,Jerzy Brzęczek,0,46.0,0,0,1,1,2,Poland
5812,Jerzy Gorgoń,1,31.0,0,0,0,1,1,Haiti
5813,Jerzy Sadek,0,287.0,0,0,3,1,4,Scotland
5814,Jerzy Wilim,0,64.0,0,0,1,0,1,Poland
5815,Jerzy Wostal,0,59.0,0,0,1,0,1,Poland
5816,Jesdaporn Na Phatalung,3,121.0,0,1,1,2,3,Malaysia
5817,Jesper Blomqvist,0,64.0,1,0,1,0,1,Switzerland
5818,Jesper Grønkjær,1,95.0,0,0,1,1,2,Denmark
5819,Jesper Olsen,3,334.0,0,2,5,0,5,Denmark
5820,Jesse August,1,47.0,0,0,1,0,1,Belize
5821,Jesse John,0,15.0,0,0,1,0,1,Bahrain
5822,Jesse Lingard,1,132.0,0,0,3,0,3,England
5823,Jesus Correia,0,53.0,0,0,1,0,1,Portugal
5824,Jesús Arellano,1,142.0,0,0,1,3,4,Chile
5825,Jesús Dátolo,0,65.0,0,0,1,0,1,Argentina
5826,Jesús Ferreira,0,27.0,0,0,1,0,1,United States
5827,Jesús Julio,1,30.0,0,0,0,1,1,Honduras
5828,Jesús Julián Lucendo,0,85.0,0,1,0,1,1,Armenia
5829,Jesús Manuel Corona,2,386.0,0,0,2,4,6,Jamaica
5830,Jesús María Zamora,0,82.0,0,0,1,0,1,Spain
5831,Jesús Navas,1,192.0,0,0,1,2,3,Croatia
5832,Jesús Peláez Miranda,0,2.0,0,0,0,1,1,Uruguay
5833,Jesús Reynaldo,0,179.0,0,0,3,0,3,Bolivia
5834,Jesús Zavala,0,112.0,0,0,0,2,2,El Salvador
5835,Jevgeni Novikov,0,86.0,0,0,1,0,1,Estonia
5836,Jevgeņijs Miļevskis,0,87.0,0,0,1,0,1,Latvia
5837,Jevon Francis,0,12.0,0,0,0,1,1,Saint Lucia
5838,Jeyab Bashafal,0,55.0,0,0,1,0,1,Yemen
5839,Jhasmani Campos,2,192.0,0,0,1,2,3,Peru
5840,Jhoan Sánchez,0,27.0,0,0,1,0,1,Dominican Republic
5841,Jhon Chancellor,0,116.0,0,0,0,2,2,Bolivia
5842,Jhon Murillo,0,51.0,0,0,0,1,1,Argentina
5843,Jhonny Acosta,0,69.0,0,0,1,1,2,Costa Rica
5844,Ji Dong-won,4,303.0,0,0,5,2,7,South Korea
5845,Ji Yun-nam,1,89.0,0,0,0,1,1,Brazil
5846,Jia Xiuquan,2,132.0,0,0,3,2,5,Singapore
5847,Jiana Raoelijaona,0,85.0,0,0,1,0,1,Madagascar
5848,Jiang Ning,0,176.0,0,0,3,0,3,China PR
5849,Jim Allevinah,2,236.0,0,0,3,1,4,Gabon
5850,Jim Bett,0,86.0,0,0,0,1,1,Iceland
5851,Jim Brennan,0,250.0,0,0,3,0,3,Canada
5852,Jim Brown,1,89.0,0,0,0,1,1,Argentina
5853,Jim Holton,0,40.0,0,0,1,0,1,Scotland
5854,Jim Kremer,0,38.0,0,0,1,0,1,Luxembourg
5855,Jim Magilton,0,48.0,0,0,1,1,2,Northern Ireland
5856,Jim McCalliog,0,87.0,0,0,0,1,1,England
5857,Jim McLaughlin,0,85.0,0,0,2,0,2,Northern Ireland
5858,Jimmy Ben,2,53.0,0,0,0,2,2,Tahiti
5859,Jimmy Bermúdez,0,85.0,0,0,0,1,1,Sierra Leone
5860,Jimmy Bone,0,20.0,0,0,0,1,1,Denmark
5861,Jimmy Conway,0,23.0,0,0,1,0,1,Republic of Ireland
5862,Jimmy Dickinson,1,94.0,1,0,1,0,1,Belgium
5863,Jimmy Doña,0,20.0,0,0,1,0,1,Philippines
5864,Jimmy Dunne,1,59.0,0,0,1,1,2,Norway
5865,Jimmy Durmaz,0,89.0,0,0,2,0,2,Sweden
5866,Jimmy Floyd Hasselbaink,1,156.0,0,1,2,2,4,Andorra
5867,Jimmy Gatete,0,53.0,0,0,1,0,1,Rwanda
5868,Jimmy Greaves,1,252.0,0,0,0,4,4,Luxembourg
5869,Jimmy Johnstone,0,3.0,0,0,0,1,1,Germany
5870,Jimmy Kaierea,0,38.0,1,0,1,0,1,Australia
5871,Jimmy Mackay,1,113.0,0,0,3,0,3,Australia
5872,Jimmy Marín,0,3.0,0,0,1,0,1,Costa Rica
5873,Jimmy Mason,0,80.0,0,0,0,1,1,Northern Ireland
5874,Jimmy McIlroy,0,233.0,0,1,2,2,4,Northern Ireland
5875,Jimmy Modeste,0,26.0,0,0,1,0,1,Cape Verde
5876,Jimmy Muguwa,1,85.0,0,0,0,1,1,Guinea
5877,Jimmy Mulisa,0,27.0,0,0,1,0,1,Rwanda
5878,Jimmy Mullen,0,126.0,0,0,0,2,2,Scotland
5879,Jimmy Murray,1,49.0,0,0,1,0,1,Scotland
5880,Jimmy Nicholl,0,111.0,1,0,1,1,2,Northern Ireland
5881,Jimmy Nicholson,0,223.0,0,0,2,3,5,Scotland
5882,Jimmy Quinn,0,351.0,0,1,7,2,9,Romania
5883,Jimmy Rooney,2,137.0,0,0,3,0,3,Australia
5884,Jimmy Zakazaka,0,6.0,0,0,1,0,1,Malawi
5885,Jin Jingdao,0,39.0,0,0,1,0,1,China PR
5886,Jiří Feureisl,1,69.0,0,0,0,1,1,Argentina
5887,Jiří Hledík,1,70.0,0,0,1,0,1,Czechoslovakia
5888,Jiří Novotný,0,73.0,0,0,1,0,1,Czech Republic
5889,Jiří Sloup,0,26.0,0,0,0,1,1,Italy
5890,Jiří Sobotka,1,49.0,0,0,1,0,1,Czechoslovakia
5891,Jiří Štajner,0,82.0,0,0,1,0,1,Czech Republic
5892,Jo Inge Berget,0,51.0,0,0,1,0,1,Norway
5893,Jo Paul Ancheri,0,188.0,0,0,1,3,4,Yemen
5894,Joachim Streich,2,1367.0,0,2,16,9,25,German DR
5895,Joakim Mæhle,1,435.0,0,0,4,3,7,Austria
5896,Joan Capdevila,0,21.0,0,0,2,0,2,Spain
5897,Joan Morales,0,34.0,1,0,1,0,1,Grenada
5898,Joan Oumari,2,145.0,0,0,3,0,3,Lebanon
5899,Joao Rafael Elias,0,43.0,0,0,1,0,1,Rwanda
5900,Joao Rojas,0,90.0,0,0,0,1,1,Paraguay
5901,Joaquim Alberto Silva,2,269.0,0,0,2,2,4,Egypt
5902,Joaquim Santana,0,30.0,0,0,1,0,1,Portugal
5903,Joaquim Santos,0,72.0,0,0,1,0,1,United States Virgin Islands
5904,Joaquín,0,189.0,0,0,2,1,3,Albania
5905,Joaquín Botero,0,760.0,0,1,14,3,17,Bolivia
5906,Joaquín Correa,0,150.0,0,0,0,2,2,Bolivia
5907,Joaquín Peiró,1,145.0,0,0,1,1,2,Spain
5908,Joaquín Rivas,3,219.0,0,0,1,2,3,El Salvador
5909,Joaquín Sierra,0,86.0,0,0,1,0,1,Spain
5910,Joaquín del Olmo,0,52.0,0,0,1,0,1,Mexico
5911,Joash Leader,0,36.0,0,0,0,2,2,Turks and Caicos Islands
5912,Job,0,135.0,0,0,1,1,2,Angola
5913,Jobby Crossan,0,182.0,0,2,5,0,5,Northern Ireland
5914,Jobi McAnuff,1,48.0,0,0,0,1,1,Costa Rica
5915,Jocelyn Ahouéya,0,91.0,0,0,2,0,2,Benin
5916,Jocelyn Angloma,2,27.0,0,0,0,2,2,Canada
5917,Jodel Dossou,0,43.0,0,0,1,0,1,Benin
5918,Joe Aisa,0,35.0,0,1,0,1,1,New Zealand
5919,Joe Allen,0,66.0,0,0,1,1,2,Wales
5920,Joe Bell,1,50.0,0,0,0,1,1,Solomon Islands
5921,Joe Cole,3,276.0,0,0,1,5,6,England
5922,Joe Corona,0,123.0,0,0,3,0,3,United States
5923,Joe Emerson Bizera,1,22.0,0,0,1,0,1,Uruguay
5924,Joe Gaetjens,1,38.0,0,0,0,1,1,England
5925,Joe Harper,0,131.0,0,0,0,2,2,Denmark
5926,Joe Haverty,0,52.0,0,0,0,1,1,Scotland
5927,Joe Jordan,4,297.0,0,0,4,5,9,Scotland
5928,Joe Ledley,0,103.0,0,0,0,2,2,San Marino
5929,Joe Maca,1,48.0,0,1,0,1,1,Chile
5930,Joe Masiga,0,108.0,0,0,1,2,3,Kenya
5931,Joe Royle,0,51.0,0,0,1,0,1,England
5932,Joe Spiteri,0,51.0,0,0,1,0,1,Australia
5933,Joe-Max Moore,2,479.0,0,3,7,2,9,Colombia
5934,Joel Antônio Martins,2,111.0,0,0,2,0,2,Brazil
5935,Joel Campbell,6,691.0,0,0,7,6,13,Costa Rica
5936,Joel Estrada,0,107.0,0,0,2,0,2,El Salvador
5937,Joel Konofilla,1,89.0,0,0,1,0,1,Solomon Islands
5938,Joel Lindpere,0,201.0,0,0,1,2,3,Liechtenstein
5939,Joel Lupahla,1,71.0,0,0,0,1,1,Algeria
5940,Joel Minko,0,24.0,0,0,1,0,1,Gabon
5941,Joel Mogorosi,0,109.0,0,0,2,1,3,Eritrea
5942,Joel Pohjanpalo,0,524.0,0,0,4,4,8,Greece
5943,Joel Porter,6,290.0,0,0,6,0,6,Australia
5944,Joerisse Cexome,1,79.0,0,0,1,0,1,New Caledonia
5945,Joetex Asamoah Frimpong,0,5.0,0,0,0,1,1,Cape Verde
5946,Joevin Jones,1,360.0,0,1,5,2,7,Trinidad and Tobago
5947,Joey Jones,0,70.0,0,0,0,1,1,Yugoslavia
5948,Johan Cruyff,3,1131.0,0,0,20,5,25,Netherlands
5949,Johan Cruz,0,66.0,0,0,0,1,1,El Salvador
5950,Johan Devrindt,0,556.0,0,0,8,4,12,Belgium
5951,Johan Djourou,0,113.0,1,1,2,0,2,Switzerland
5952,Johan Elmander,0,396.0,0,0,2,6,8,Sweden
5953,Johan Fano,0,178.0,0,0,3,0,3,Peru
5954,Johan Mjällby,0,119.0,0,0,2,1,3,Sweden
5955,Johan Neeskens,4,423.0,0,5,7,5,12,Netherlands
5956,Johan Venegas,1,158.0,0,0,2,2,4,Costa Rica
5957,Johan Vonlanthen,1,141.0,0,0,4,1,5,Switzerland
5958,Johan Walem,1,7.0,0,0,1,0,1,Belgium
5959,Johann Eigenstiller,0,51.0,1,0,0,1,1,Austria
5960,Johann Horvath,2,110.0,0,0,5,0,5,Austria
5961,Johann Krankl,0,279.0,0,2,3,2,5,Austria
5962,Johann Lonfat,0,64.0,0,0,1,0,1,Switzerland
5963,Johann Obiang,0,75.0,1,0,1,0,1,Egypt
5964,Johann Paul,0,66.0,0,0,1,0,1,Madagascar
5965,Johann Schmidradner,0,4.0,0,1,0,1,1,Republic of Ireland
5966,Johanna Omolo,1,163.0,0,0,1,2,3,Mauritius
5967,Johannes Ortmann,0,80.0,0,0,1,0,1,Namibia
5968,John Aldridge,1,856.0,0,4,10,7,17,Malta
5969,John Aloisi,5,1230.0,0,1,17,5,22,Australia
5970,John Arne Riise,0,373.0,0,1,7,2,9,Norway
5971,John Atyeo,0,293.0,0,0,2,2,4,England
5972,John Banda,0,132.0,0,0,2,0,2,Malawi
5973,John Baraza,1,133.0,0,0,2,1,3,Burkina Faso
5974,John Barnes,0,236.0,0,0,4,4,8,Turkey
5975,John Barry Nusum,0,528.0,0,0,7,5,12,Bermuda
5976,John Bosman,3,798.0,0,0,9,6,15,Cyprus
5977,John Boye,3,198.0,1,0,1,3,4,Niger
5978,John Brooks,1,86.0,0,0,0,1,1,Ghana
5979,John Bunyenyezi,1,16.0,0,0,0,1,1,Egypt
5980,John Byrne,0,66.0,0,0,0,2,2,Turkey
5981,John Carew,0,746.0,0,1,10,5,15,Norway
5982,John Catliff,0,160.0,0,2,2,2,4,Honduras
5983,John Charles,1,244.0,0,0,1,3,4,Scotland
5984,John Chiedozie,0,26.0,0,0,0,2,2,Tanzania
5985,John Collins,1,470.0,0,2,5,5,10,Scotland
5986,John Connelly,0,5.0,0,0,1,0,1,England
5987,John Dempsey,0,58.0,1,0,1,0,1,Czechoslovakia
5988,John Doyle,0,48.0,0,0,1,0,1,United States
5989,John Ebow Essien,1,28.0,0,0,1,0,1,Ghana
5990,John Egan,0,45.0,0,0,0,1,1,Portugal
5991,John Eriksen,1,62.0,0,0,1,0,1,Denmark
5992,John Greig,0,138.0,0,0,1,1,2,Finland
5993,John Guidetti,0,80.0,0,0,1,0,1,Sweden
5994,John Hartson,0,436.0,0,1,6,4,10,Armenia
5995,John Heitinga,0,63.0,0,0,1,1,2,North Macedonia
5996,John Hewie,0,41.0,0,1,1,0,1,Scotland
5997,John Holland,0,151.0,2,0,2,0,2,Germany
5998,John Hughes,0,39.0,0,0,1,0,1,Scotland
5999,John Jensen,1,128.0,0,0,4,0,4,Denmark
6000,John Kosmina,1,727.0,0,1,11,2,13,Taiwan
6001,John Kramer,0,33.0,0,0,0,1,1,Czechoslovakia
6002,John Krogh,0,60.0,0,0,0,1,1,Sweden
6003,John Lauridsen,1,84.0,0,0,1,0,1,Denmark
6004,John Limniatis,1,60.0,0,0,0,1,1,Jamaica
6005,John Lungu,0,44.0,0,0,0,1,1,Ghana
6006,John Maduka,0,78.0,0,0,0,1,1,Burkina Faso
6007,John Mahoney,0,69.0,0,0,0,1,1,Hungary
6008,John Matkin,0,49.0,0,0,0,1,1,Maldives
6009,John McClelland,0,18.0,0,0,1,0,1,Northern Ireland
6010,John McGinlay,0,40.0,0,0,2,1,3,Scotland
6011,John McGinn,0,461.0,0,0,10,1,11,Scotland
6012,John McPhail,0,25.0,0,0,1,0,1,Scotland
6013,John Mensah,2,34.0,0,0,2,0,2,Ghana
6014,John Metgod,0,138.0,0,0,2,1,3,Netherlands
6015,John Morris Williams,0,90.0,0,0,0,1,1,Indonesia
6016,John Moshoeu,0,249.0,0,0,4,0,4,South Africa
6017,John Méndez,0,89.0,0,0,1,0,1,Guatemala
6018,John O'Brien,1,136.0,0,0,3,0,3,United States
6019,John O'Hare,0,41.0,0,0,3,0,3,Scotland
6020,John O'Neill,0,44.0,0,0,1,0,1,Northern Ireland
6021,John O'Shea,0,163.0,1,0,1,2,3,Republic of Ireland
6022,John Pareanga,1,59.0,0,0,0,1,1,Tonga
6023,John Petersen,1,162.0,0,1,2,3,5,Serbia
6024,John Restrepo,0,156.0,0,0,2,0,2,Colombia
6025,John Robertson,1,373.0,0,4,7,1,8,Norway
6026,John Robinson,0,59.0,0,0,2,0,2,Wales
6027,John Sheridan,0,139.0,0,0,1,2,3,Republic of Ireland
6028,John Shore,0,82.0,0,0,0,1,1,Mauritius
6029,John Sivebæk,0,57.0,0,0,0,1,1,Republic of Ireland
6030,John Smith,0,159.0,0,0,2,0,2,Saint Kitts and Nevis
6031,John Souttar,0,35.0,0,0,1,0,1,Scotland
6032,John Souza,1,75.0,0,0,1,1,2,Mexico
6033,John Stones,2,85.0,0,0,3,0,3,England
6034,John Terry,0,85.0,0,0,1,0,1,England
6035,John Toshack,0,353.0,0,0,3,4,7,German DR
6036,John Utaka,2,191.0,0,0,1,2,3,Nigeria
6037,John Wark,2,259.0,0,0,5,0,5,Scotland
6038,John Wilkinson,1,219.0,0,0,1,2,3,Palestine
6039,John de Wolf,0,137.0,0,0,2,0,2,Netherlands
6040,John van 't Schip,0,47.0,0,0,1,0,1,Netherlands
6041,John van den Brom,0,2.0,0,0,1,0,1,Netherlands
6042,John-Patrick Strauß,0,149.0,0,0,0,2,2,Guam
6043,Johnnier Montaño,1,87.0,0,0,0,1,1,Argentina
6044,Johnny Crossan,0,8.0,0,0,1,0,1,Northern Ireland
6045,Johnny Descouines,3,138.0,0,0,3,0,3,Haiti
6046,Johnny Ekström,1,502.0,0,0,4,5,9,Sweden
6047,Johnny Gavin,0,80.0,0,1,2,0,2,Republic of Ireland
6048,Johnny Giles,0,41.0,0,0,1,0,1,Republic of Ireland
6049,Johnny Hall,0,99.0,0,0,0,2,2,Tonga
6050,Johnny Halsdorf,0,34.0,0,0,0,1,1,Netherlands
6051,Johnny Haynes,1,146.0,0,0,0,3,3,Denmark
6052,Johnny Leverón,1,86.0,0,0,1,0,1,Honduras
6053,Johnny N'Wadioha,0,74.0,0,0,1,0,1,Nigeria
6054,Johnny Nicholls,0,50.0,0,0,0,1,1,Scotland
6055,Johnny Rep,8,591.0,0,1,3,8,11,Uruguay
6056,Johnny Russell,0,74.0,0,0,0,1,1,San Marino
6057,Johnny Squires,0,44.0,0,0,0,1,1,Netherlands
6058,Johnny Thio,0,324.0,0,0,4,1,5,Belgium
6059,Johnny Warren,1,17.0,0,0,0,1,1,Zimbabwe
6060,Johnny Watkiss,0,125.0,0,0,1,1,2,South Korea
6061,Johnson Bwalya,2,268.0,0,0,4,1,5,Zambia
6062,Johny Léonard,0,131.0,0,1,0,3,3,Denmark
6063,Joleon Lescott,1,30.0,0,0,0,1,1,France
6064,Jomard Moussa,0,197.0,0,0,3,0,3,Syria
6065,Jon Andoni Goikoetxea,2,132.0,0,0,1,2,3,Spain
6066,Jon Dahl Tomasson,9,1833.0,0,5,16,20,36,Wales
6067,Jon Kwang-ik,0,90.0,0,0,1,0,1,North Korea
6068,Jonah Ebanks,1,30.0,0,1,1,0,1,Cayman Islands
6069,Jonas Bahamboula,1,82.0,0,0,1,1,2,Congo
6070,Jonas Hector,0,97.0,0,0,0,2,2,San Marino
6071,Jonas Hofmann,0,116.0,0,0,1,1,2,Germany
6072,Jonas Mendes,0,3.0,1,0,1,0,1,Togo
6073,Jonas Ogandaga,0,5.0,0,0,0,1,1,Eswatini
6074,Jonas Okétola,0,33.0,0,0,1,0,1,Benin
6075,Jonas Paulionis,0,162.0,0,0,1,1,2,Latvia
6076,Jonas Svensson,0,57.0,0,0,0,1,1,Gibraltar
6077,Jonas Wind,0,152.0,0,0,0,2,2,Israel
6078,Jonatan Johansson,0,474.0,0,0,6,5,11,Finland
6079,Jonathan Akpoborie,0,113.0,0,0,1,1,2,Kenya
6080,Jonathan Ayité,1,45.0,0,0,0,1,1,Ivory Coast
6081,Jonathan Barrios,0,9.0,0,0,1,0,1,El Salvador
6082,Jonathan Bolingi,1,139.0,0,1,2,1,3,DR Congo
6083,Jonathan Bornstein,0,90.0,0,0,1,0,1,United States
6084,Jonathan Bru,0,78.0,0,0,1,0,1,Mauritius
6085,Jonathan Buatu,0,90.0,0,0,1,0,1,Angola
6086,Jonathan Cantillana,1,121.0,0,0,3,0,3,Palestine
6087,Jonathan David,10,862.0,0,1,11,4,15,Canada
6088,Jonathan Fabbro,0,33.0,0,1,1,1,2,Argentina
6089,Jonathan Faña,0,109.0,0,0,2,1,3,Dominican Republic
6090,Jonathan Ikoné,0,85.0,0,0,1,0,1,France
6091,Jonathan Kodjia,2,152.0,0,0,3,0,3,Ivory Coast
6092,Jonathan Niva,0,44.0,0,0,0,1,1,Cameroon
6093,Jonathan Osorio,1,62.0,0,0,1,1,2,Canada
6094,Jonathan Perry,1,144.0,0,0,2,0,2,New Zealand
6095,Jonathan Pitroipa,2,367.0,0,1,6,1,7,Burkina Faso
6096,Jonathan Sogbie,0,55.0,0,0,0,1,1,DR Congo
6097,Jonathan Tah,0,66.0,1,0,0,1,1,Germany
6098,Jonathan Tehau,5,269.0,1,0,2,4,6,Samoa
6099,Jonathan Walters,0,492.0,0,3,7,3,10,Estonia
6100,Jonathan dos Santos,1,104.0,0,0,1,1,2,United States
6101,Jones Chilengi,1,23.0,1,0,1,1,2,Cameroon
6102,Jones Mwewa,0,71.0,0,0,2,0,2,Zambia
6103,Jones Nkhwazi,0,88.0,0,0,1,0,1,Malawi
6104,Jong Chol-min,0,173.0,0,0,1,3,4,Mongolia
6105,Jong Il-gwan,0,207.0,0,1,4,1,5,Bahrain
6106,Jong Tae-Se,0,72.0,0,0,0,1,1,Iran
6107,Joni,1,64.0,0,1,2,0,2,Angola
6108,Jonny Evans,0,105.0,0,0,3,0,3,Northern Ireland
6109,Jonny Magallón,0,63.0,0,0,1,0,1,Mexico
6110,Joona Toivio,0,148.0,1,0,2,0,2,Finland
6111,Joonas Kolkka,0,324.0,0,0,6,0,6,Finland
6112,Joonas Tamm,3,195.0,0,0,0,3,3,Gibraltar
6113,Jope Namawa Leka,1,4.0,0,0,0,1,1,Tonga
6114,Jordan Adéoti,0,33.0,0,0,1,0,1,Benin
6115,Jordan Ayew,3,412.0,0,1,4,3,7,Ghana
6116,Jordan Henderson,2,187.0,1,0,2,2,4,England
6117,Jordan Johnson,0,52.0,0,0,0,1,1,Dominica
6118,Jordan Morris,0,228.0,0,0,3,0,3,United States
6119,Jordan Perez,0,52.0,1,0,1,0,1,Republic of Ireland
6120,Jordan Wetria,1,78.0,0,0,1,0,1,New Caledonia
6121,Jordi Alba,3,168.0,0,0,2,4,6,Spain
6122,Jordi Cruyff,1,66.0,0,0,0,1,1,Switzerland
6123,Jordy Caicedo,0,85.0,0,1,0,1,1,Paraguay
6124,Jordy Delem,1,84.0,0,0,1,0,1,Martinique
6125,Jorge Alcalde,2,266.0,0,0,5,2,7,Chile
6126,Jorge Amado Nunes,0,82.0,0,0,0,1,1,Bolivia
6127,Jorge Andrade,0,87.0,1,0,1,1,2,Portugal
6128,Jorge Aravena,0,260.0,0,0,3,3,6,Chile
6129,Jorge Bengoché,0,88.0,0,0,1,0,1,Honduras
6130,Jorge Benjamín Araya,3,96.0,0,0,1,2,3,Chile
6131,Jorge Bermúdez,0,50.0,0,0,1,1,2,Colombia
6132,Jorge Bolaño,1,7.0,0,0,0,1,1,Chile
6133,Jorge Bolaños,1,100.0,0,0,0,2,2,Bolivia
6134,Jorge Burruchaga,3,505.0,0,1,4,3,7,Ecuador
6135,Jorge Cadete,0,372.0,0,0,5,0,5,Portugal
6136,Jorge Campos,1,65.0,1,0,0,1,1,Mexico
6137,Jorge Ceciliano,1,13.0,0,0,1,0,1,Brazil
6138,Jorge Claros,1,93.0,1,0,2,0,2,Honduras
6139,Jorge Contreras,1,121.0,0,1,1,1,2,Venezuela
6140,Jorge Costa,1,29.0,1,0,1,0,1,United States
6141,Jorge Dely Valdés,2,550.0,1,0,4,8,12,Canada
6142,Jorge Duilio Benitez,6,394.0,0,0,0,7,7,Colombia
6143,Jorge Estuardo Vargas,0,85.0,0,0,1,0,1,Guatemala
6144,Jorge Gáspari,0,15.0,0,0,1,0,1,Argentina
6145,Jorge Hirano,4,280.0,0,0,2,3,5,Peru
6146,Jorge Hugo Fernández,1,11.0,0,0,1,0,1,Argentina
6147,Jorge Insfran,0,92.0,0,0,1,1,2,Bolivia
6148,Jorge Larraz,5,189.0,0,4,2,3,5,Ecuador
6149,Jorge Laurido,1,75.0,1,0,0,1,1,Ecuador
6150,Jorge Lino Romero,2,130.0,0,0,1,1,2,France
6151,Jorge Luis Alarcón,0,9.0,0,0,1,0,1,Ecuador
6152,Jorge Luis Campos,1,156.0,0,0,1,1,2,Paraguay
6153,Jorge López Caballero,1,58.0,0,0,1,0,1,Colombia
6154,Jorge Martín Núñez,0,68.0,0,0,1,0,1,Paraguay
6155,Jorge Monge,0,127.0,0,0,1,3,4,Guatemala
6156,Jorge Muñoz Luna,0,80.0,0,0,1,0,1,Chile
6157,Jorge Orlando Aravena Plaza,0,252.0,0,0,4,1,5,Chile
6158,Jorge Oyarbide,0,279.0,0,0,4,0,4,Uruguay
6159,Jorge Peredo,0,201.0,0,0,3,1,4,Venezuela
6160,Jorge Peñaloza,0,51.0,0,0,0,1,1,Ecuador
6161,Jorge Plácido,0,88.0,0,0,2,0,2,Portugal
6162,Jorge Ramírez Gallego,0,89.0,0,0,0,1,1,Brazil
6163,Jorge Rodríguez,0,284.0,0,2,6,1,7,Mexico
6164,Jorge Rojas,0,7.0,0,0,1,0,1,Paraguay
6165,Jorge Sarmiento,0,41.0,0,0,1,0,1,Peru
6166,Jorge Sota,0,24.0,0,0,1,0,1,Mexico
6167,Jorge Soto,2,396.0,0,1,6,1,7,Peru
6168,Jorge Sánchez,0,21.0,0,0,1,0,1,Mexico
6169,Jorge Toro,0,129.0,0,0,2,0,2,Chile
6170,Jorge Valdano,4,136.0,0,0,5,0,5,Argentina
6171,Jorge Valdivia,1,85.0,0,0,1,1,2,Colombia
6172,Jorge Vickers,0,19.0,0,0,1,0,1,Guatemala
6173,Jorge Álvarez,1,59.0,0,0,1,0,1,Honduras
6174,Jorginho,0,217.0,0,3,2,1,3,Finland
6175,Jorginho Putinatti,0,23.0,0,0,1,0,1,Brazil
6176,Joris Marveaux,1,45.0,0,0,0,1,1,Cuba
6177,Joris Mathijsen,0,41.0,0,0,1,1,2,Luxembourg
6178,Jorma Vaihela,0,179.0,0,0,1,1,2,Finland
6179,Jorman Aguilar,0,31.0,0,0,1,0,1,Panama
6180,Josateki Kurivitu,1,90.0,0,0,1,0,1,Fiji
6181,Jose Albornoz,0,90.0,0,0,0,1,1,Venezuela
6182,Jose Maria Garcia,2,91.0,0,0,0,2,2,Paraguay
6183,Jose Neves,0,60.0,0,0,1,0,1,Angola
6184,Jose Tognola,1,77.0,0,0,0,1,1,Brazil
6185,Joseba Etxeberria,1,496.0,0,0,2,6,8,Israel
6186,Josef Bican,1,109.0,0,0,1,0,1,Austria
6187,Josef Gauchel,1,168.0,0,0,3,0,3,Germany
6188,Josef Hickersberger,0,99.0,0,0,3,0,3,Austria
6189,Josef Hügi,0,346.0,0,0,6,2,8,Switzerland
6190,Josef Jelínek,0,31.0,0,0,1,0,1,Czechoslovakia
6191,Josef Jurkanin,0,73.0,0,0,1,0,1,Czechoslovakia
6192,Josef Kadraba,1,88.0,0,0,2,0,2,Czechoslovakia
6193,Josef Košťálek,1,93.0,0,0,1,0,1,Czechoslovakia
6194,Josef Ludl,0,73.0,0,0,1,0,1,Czechoslovakia
6195,Josef Martínez,2,449.0,0,0,5,3,8,Venezuela
6196,Josef Masopust,1,85.0,0,0,1,2,3,Romania
6197,Josef Novák,0,52.0,0,0,0,1,1,Germany
6198,Josef Rasselnberg,0,183.0,0,0,0,4,4,Luxembourg
6199,Josef Shirdel,1,79.0,0,0,1,0,1,Afghanistan
6200,Josef Silný,0,33.0,0,0,0,1,1,Poland
6201,Josef Stering,0,122.0,0,0,3,0,3,Austria
6202,Josef Zeman,1,111.0,0,0,1,0,1,Czechoslovakia
6203,Josef Šural,0,35.0,0,0,0,1,1,Netherlands
6204,Joselito Vaca,0,84.0,0,0,1,0,1,Bolivia
6205,Josep Maria Fusté,1,38.0,0,0,1,1,2,Spain
6206,Joseph Aghoghovbia,0,47.0,0,0,1,0,1,Nigeria
6207,Joseph Bassey,1,82.0,0,0,0,1,1,Egypt
6208,Joseph Bléziri,1,66.0,0,0,0,1,1,Ghana
6209,Joseph Chahrestan,3,223.0,0,0,2,1,3,Syria
6210,Joseph Chipolina,0,29.0,1,0,1,0,1,Republic of Ireland
6211,Joseph Enakarhire,0,28.0,0,0,0,1,1,Zimbabwe
6212,Joseph Francis,0,17.0,0,0,0,1,1,Saint Vincent and the Grenadines
6213,Joseph Ghartey,1,40.0,0,0,0,1,1,Benin
6214,Joseph Kaboré,2,114.0,0,0,2,0,2,Burkina Faso
6215,Joseph Kamwendo,0,66.0,0,0,1,0,1,Malawi
6216,Joseph Maluka,0,35.0,0,0,2,0,2,Angola
6217,Joseph Mapulanga,1,157.0,0,0,2,1,3,Zambia
6218,Joseph Marrero,0,87.0,0,0,1,0,1,Puerto Rico
6219,Joseph Mbarga,0,64.0,0,0,1,0,1,Cameroon
6220,Joseph Mbong,0,102.0,0,0,2,0,2,Malta
6221,Joseph Mendes,1,279.0,0,1,3,1,4,São Tomé and Príncipe
6222,Joseph Mounoundzi,0,66.0,0,1,1,0,1,Congo
6223,Joseph Obas,0,155.0,0,0,2,1,3,Haiti
6224,Joseph Ouattara,0,52.0,0,0,0,1,1,Mauritania
6225,Joseph Sam,0,51.0,0,0,0,1,1,DR Congo
6226,Joseph Ujlaki,0,316.0,0,0,0,5,5,Republic of Ireland
6227,Joseph Urpani,0,39.0,0,0,1,0,1,Malta
6228,Joseph Wamba,0,76.0,0,0,1,0,1,Congo
6229,Joseph Yegba Maya,0,64.0,0,0,1,0,1,Cameroon
6230,Joseph Yobo,2,303.0,2,0,3,3,6,Nigeria
6231,Joseph-Désiré Job,3,251.0,0,0,3,1,4,Cameroon
6232,Joses Nawo,0,59.0,0,0,1,0,1,Solomon Islands
6233,Josh Magennis,0,526.0,0,0,3,4,7,Northern Ireland
6234,Josh Parker,0,162.0,0,0,2,0,2,Antigua and Barbuda
6235,Josh Simpson,0,112.0,0,0,3,0,3,Canada
6236,Josh Wolff,0,179.0,0,0,4,1,5,United States
6237,Joshua John,2,115.0,0,0,0,2,2,Cayman Islands
6238,Joshua Kennedy,0,455.0,0,0,6,2,8,Australia
6239,Joshua Kimmich,0,131.0,0,0,0,2,2,Norway
6240,Joshua King,0,722.0,0,5,6,8,14,Cyprus
6241,Joshua Pérez,0,123.0,0,0,1,2,3,United States Virgin Islands
6242,Josimar,2,97.0,0,0,1,1,2,Northern Ireland
6243,Josip Brekalo,0,90.0,0,0,1,0,1,Croatia
6244,Josip Bukal,0,199.0,0,0,0,4,4,Finland
6245,Josip Drmić,1,393.0,0,0,4,1,5,Lithuania
6246,Josip Iličić,0,608.0,0,4,5,8,13,Cyprus
6247,Josip Katalinski,2,312.0,1,1,6,2,8,Greece
6248,Josip Skoblar,1,136.0,0,2,3,1,4,Uruguay
6249,Josip Skoko,1,151.0,0,0,1,4,5,Mexico
6250,Josip Šimunić,0,86.0,0,0,1,1,2,Andorra
6251,Joslin Kamatuka,1,146.0,0,0,1,1,2,Namibia
6252,Jostein Flo,0,271.0,0,0,2,3,5,San Marino
6253,Josué Anunciado de Oliveira,1,68.0,0,0,0,1,1,Chile
6254,Josué Duverger,1,46.0,1,0,1,0,1,Canada
6255,Josué Martínez,1,59.0,0,0,0,1,1,Bolivia
6256,Josy Kirchens,0,38.0,0,0,1,0,1,Luxembourg
6257,José Alfredo Castillo,0,367.0,0,1,3,3,6,Peru
6258,José Altafini,2,201.0,0,0,0,3,3,Austria
6259,José Anthony Torres,0,90.0,1,0,1,0,1,United States
6260,José Antonio Castro,0,79.0,0,0,0,1,1,United States
6261,José Antonio Reyes,0,177.0,0,0,0,2,2,Armenia
6262,José Antonio Vázquez,1,37.0,0,0,0,1,1,Brazil
6263,José Ariel Núñez,0,18.0,0,0,1,0,1,Paraguay
6264,José Artetxe,1,11.0,0,0,0,1,1,Turkey
6265,José Augusto Torres,3,338.0,1,0,3,2,5,Hungary
6266,José Augusto de Almeida,3,166.0,0,0,0,4,4,Hungary
6267,José Aveiro,6,250.0,0,0,3,3,6,Chile
6268,José Avendaño,3,113.0,0,0,2,1,3,Brazil
6269,José Batista,0,9.0,0,0,1,0,1,Uruguay
6270,José Borello,3,221.0,0,0,3,0,3,Argentina
6271,José Bustamante,0,27.0,0,0,0,2,2,Peru
6272,José Cardona,1,19.0,0,0,1,0,1,Honduras
6273,José Cardozo,4,979.0,0,2,11,7,18,Argentina
6274,José Carlos Guimarães,1,53.0,0,0,1,0,1,Brazil
6275,José Cea,0,128.0,0,0,2,0,2,Uruguay
6276,José Chamot,1,54.0,0,0,0,1,1,Japan
6277,José Ciprian Alfonso,1,57.0,0,0,0,2,2,United States
6278,José Claramunt,0,122.0,0,1,1,2,3,Greece
6279,José Clayton,0,123.0,0,3,4,0,4,Tunisia
6280,José Coelho,0,66.0,0,0,1,0,1,Portugal
6281,José Domingo Insfrán,0,59.0,1,0,0,1,1,Paraguay
6282,José Durand Laguna,0,10.0,0,0,1,0,1,Argentina
6283,José Emilio Amavisca,0,49.0,0,0,0,1,1,Armenia
6284,José Eulogio Gárate,0,196.0,0,0,4,0,4,Spain
6285,José Fabián Paz y Miño,0,81.0,0,0,1,0,1,Ecuador
6286,José Fajardo,1,85.0,0,0,0,1,1,Dominica
6287,José Fernández,4,201.0,0,0,1,3,4,Chile
6288,José Filipe Correia Semedo,0,34.0,0,0,0,1,1,Tanzania
6289,José Francisco Rojo,1,116.0,0,0,1,1,2,Spain
6290,José Gabriel Chaparro,0,59.0,0,0,1,0,1,Colombia
6291,José García,3,223.0,0,0,0,4,4,Colombia
6292,José Gaslini,1,75.0,0,0,1,0,1,Argentina
6293,José Gavica,1,133.0,0,0,1,1,2,Ecuador
6294,José Gayà,0,14.0,0,0,1,0,1,Spain
6295,José Gómez,1,28.0,0,0,1,0,1,Cuba
6296,José Hmae,2,39.0,0,0,2,0,2,New Caledonia
6297,José Iraragorri,2,43.0,0,1,0,2,2,Brazil
6298,José Jacinto Vega,0,89.0,0,0,1,0,1,Ecuador
6299,José Javier del Aguila,1,16.0,0,0,1,0,1,Guatemala
6300,José João Pereira,0,47.0,0,0,0,1,1,Nepal
6301,José Kanté,1,48.0,0,0,1,0,1,Guinea
6302,José Leal,0,34.0,0,0,1,0,1,Portugal
6303,José Leandro Andrade,1,69.0,0,0,0,1,1,Peru
6304,José Luis Aussin,0,14.0,0,0,1,0,1,Mexico
6305,José Luis Brown,1,23.0,0,0,1,0,1,Argentina
6306,José Luis Caminero,4,518.0,0,0,2,6,8,Albania
6307,José Luis Capón,0,85.0,0,0,1,0,1,Spain
6308,José Luis Chilavert,1,506.0,0,5,5,3,8,Paraguay
6309,José Luis Dolgetta,4,358.0,0,0,0,6,6,Ecuador
6310,José Luis Ferraro,2,161.0,0,0,2,0,2,Argentina
6311,José Luis Garcés,2,132.0,0,0,3,1,4,Panama
6312,José Luis Gayà,0,71.0,0,0,0,1,1,Faroe Islands
6313,José Luis González Dávila,0,53.0,0,0,2,1,3,Mexico
6314,José Luis Lamadrid,1,257.0,0,0,2,3,5,Haiti
6315,José Luis Panizo,0,15.0,0,0,1,0,1,Spain
6316,José Luis Pineda,1,72.0,0,0,1,1,2,Honduras
6317,José Luis Rodríguez,2,91.0,0,0,2,0,2,Panama
6318,José Luis Sierra,3,56.0,0,0,2,1,3,Brazil
6319,José Luis Veloso,0,79.0,0,0,1,1,2,Spain
6320,José Luis Violeta,0,86.0,0,0,0,1,1,Cyprus
6321,José Luís,0,83.0,0,0,1,0,1,Portugal
6322,José Macia,3,98.0,0,0,3,0,3,Brazil
6323,José Magriñá,1,69.0,0,0,1,0,1,Cuba
6324,José Manuel Abundis,0,166.0,0,0,6,0,6,Mexico
6325,José Manuel Contreras,1,158.0,0,0,2,0,2,Guatemala
6326,José Manuel Moreno,12,493.0,0,0,12,1,13,Argentina
6327,José Manuel Rey,0,280.0,1,0,3,2,5,Venezuela
6328,José Manuel Velázquez,1,10.0,0,0,0,1,1,Mexico
6329,José Manuel de la Torre,1,134.0,0,0,2,1,3,Canada
6330,José Mari Bakero,0,257.0,0,0,6,1,7,Spain
6331,José Maria da Cruz Martins,1,89.0,0,0,1,0,1,Macau
6332,José María Carranza,0,26.0,0,0,0,1,1,Peru
6333,José María Carrasco,0,66.0,1,0,1,0,1,Brazil
6334,José María García Lavilla,0,20.0,0,0,1,0,1,Spain
6335,José María Giménez,3,183.0,0,0,2,1,3,Uruguay
6336,José María Jiménez,2,167.0,0,0,4,1,5,Ecuador
6337,José María Lavalle,1,43.0,0,0,0,1,1,Paraguay
6338,José María Medina,7,263.0,0,0,0,7,7,Chile
6339,José María Ortiz,1,75.0,0,0,0,1,1,Colombia
6340,José Mendoza,1,62.0,0,0,0,1,1,Argentina
6341,José Miguel Cubero,0,31.0,0,0,0,1,1,El Salvador
6342,José Milton Melgar,0,357.0,0,1,4,1,5,Colombia
6343,José Mora,1,75.0,0,0,0,1,1,Peru
6344,José Naranjo,0,195.0,0,0,3,0,3,Mexico
6345,José Orlando Martínez Peña,0,14.0,0,0,1,0,1,El Salvador
6346,José Orlando Semedo,0,44.0,0,0,0,1,1,Switzerland
6347,José Oscar Herrera,0,59.0,0,0,0,1,1,Venezuela
6348,José Parodi,2,229.0,0,0,3,1,4,Paraguay
6349,José Pedro Fuenzalida,3,108.0,0,0,0,3,3,Argentina
6350,José Pereda,1,110.0,0,0,0,3,3,Paraguay
6351,José Perácio,3,195.0,0,0,3,0,3,Brazil
6352,José Piendibene,4,212.0,0,0,1,3,4,Chile
6353,José Pérez,3,202.0,0,0,0,4,4,Chile
6354,José Quintanilla,1,129.0,0,0,1,1,2,El Salvador
6355,José Rafael,0,50.0,0,0,1,0,1,Portugal
6356,José Ramos Delgado,0,35.0,1,0,1,0,1,Bolivia
6357,José Reinaldo de Lima,1,105.0,0,0,1,1,2,Brazil
6358,José Ricardo Taylor,0,85.0,0,0,1,0,1,Honduras
6359,José Ruvalcaba,0,41.0,0,0,1,0,1,Mexico
6360,José Sanfilippo,8,624.0,0,1,9,1,10,Argentina
6361,José Sasía,9,575.0,0,0,0,9,9,Ecuador
6362,José Taboada,1,28.0,0,0,0,1,1,Argentina
6363,José Torrealba,0,152.0,0,0,2,0,2,Venezuela
6364,José Touré,0,93.0,0,0,2,1,3,France
6365,José Travassos,0,51.0,0,0,1,0,1,Portugal
6366,José Ufarte,1,80.0,0,0,0,1,1,Republic of Ireland
6367,José Urquia,0,18.0,0,0,1,0,1,Honduras
6368,José Urruzmendi,0,182.0,0,0,3,1,4,Peru
6369,José Vargas,2,84.0,0,0,1,1,2,Ecuador
6370,José Velásquez,3,198.0,0,0,3,2,5,Peru
6371,José Vicente Balseca,0,25.0,0,0,1,0,1,Ecuador
6372,José Vieira Dias Paulino do Carmo,0,79.0,0,0,0,1,1,Sudan
6373,José Walter Roque,1,105.0,0,0,1,1,2,Uruguay
6374,José del Solar,8,599.0,3,3,5,7,12,Paraguay
6375,José Águas,0,158.0,0,0,2,1,3,Austria
6376,José Ángel Iribar,0,61.0,1,0,1,0,1,Republic of Ireland
6377,Jovan Aćimović,0,14.0,0,0,1,0,1,Yugoslavia
6378,Jovan Kirovski,1,163.0,0,0,2,1,3,United States
6379,Jovan Kostovski,0,85.0,0,0,1,0,1,North Macedonia
6380,Jozef Adamec,1,322.0,0,0,6,1,7,Czechoslovakia
6381,Jozef Barmoš,1,66.0,1,0,1,0,1,England
6382,Jozef Chovanec,0,80.0,1,0,0,2,2,Luxembourg
6383,Jozef Majoroš,0,195.0,0,0,3,0,3,Slovakia
6384,Jozef Móder,0,161.0,0,0,1,2,3,Czechoslovakia
6385,Jozef Štibrányi,1,80.0,0,0,1,0,1,Czechoslovakia
6386,Jozy Altidore,1,1256.0,0,2,20,4,24,United States
6387,João Cancelo,0,134.0,0,0,1,1,2,Portugal
6388,João Carlos dos Santos,1,8.0,0,0,1,0,1,Brazil
6389,João Domingos Pinto,0,135.0,0,0,4,0,4,Portugal
6390,João Elias,0,41.0,0,0,0,1,1,Tunisia
6391,João Félix,1,78.0,0,0,1,0,1,Portugal
6392,João Moutinho,0,315.0,0,0,2,2,4,Portugal
6393,João Palhinha,0,149.0,0,0,1,1,2,Luxembourg
6394,João Paulo,2,81.0,0,0,1,1,2,Brazil
6395,João Pedro,0,52.0,0,0,0,1,1,Malaysia
6396,João Resende Alves,0,55.0,0,0,1,1,2,Portugal
6397,João Vieira Pinto,2,813.0,0,0,12,6,18,Portugal
6398,Joël Kimwaki,1,81.0,0,0,0,1,1,Congo
6399,Joël Matip,0,26.0,0,0,0,1,1,Brazil
6400,Joël Tiéhi,10,727.0,0,1,9,5,14,Gambia
6401,Joško Gvardiol,1,87.0,0,0,1,1,2,Cyprus
6402,Ju Manu Rai,0,129.0,0,0,2,0,2,Nepal
6403,Ju Yingzhi,0,42.0,0,0,1,0,1,Hong Kong
6404,Juan,4,183.0,0,0,4,2,6,Brazil
6405,Juan Alberto Schiaffino,4,273.0,0,0,0,5,5,Bolivia
6406,Juan Alcántara,0,407.0,0,0,5,1,6,Chile
6407,Juan Amarilla,1,5.0,0,0,0,1,1,Chile
6408,Juan Américo Díaz,0,18.0,0,0,1,0,1,Bolivia
6409,Juan Angel Romero,1,17.0,0,0,0,1,1,Bolivia
6410,Juan Antonio Pizzi,0,274.0,0,0,4,0,4,Spain
6411,Juan Antonio Señor,1,234.0,0,1,3,1,4,Spain
6412,Juan Arango,1,840.0,0,0,8,6,14,Venezuela
6413,Juan Arremón,1,43.0,0,0,0,1,1,Bolivia
6414,Juan Ayala,3,206.0,0,0,1,2,3,Uruguay
6415,Juan Barrera,2,195.0,0,0,2,3,5,Nicaragua
6416,Juan Bassa,0,83.0,0,0,1,0,1,Peru
6417,Juan Bautista Agüero,2,241.0,0,0,4,1,5,Colombia
6418,Juan Bautista Coronel,1,20.0,1,0,1,0,1,Bolivia
6419,Juan Bautista Villalba,9,500.0,0,0,3,6,9,Bolivia
6420,Juan Bernat,0,88.0,0,0,0,1,1,Luxembourg
6421,Juan Caballero,0,106.0,0,0,1,1,2,Colombia
6422,Juan Camilo Zúñiga,0,90.0,0,0,1,0,1,Colombia
6423,Juan Carlos Arce,1,473.0,0,3,7,3,10,Venezuela
6424,Juan Carlos Arguedas,0,91.0,0,0,2,1,3,United States
6425,Juan Carlos Arteche,0,67.0,0,0,0,1,1,Albania
6426,Juan Carlos Carone,1,26.0,0,0,1,0,1,Argentina
6427,Juan Carlos Cubillas,0,43.0,0,0,1,0,1,Panama
6428,Juan Carlos Espinoza,1,34.0,0,0,0,1,1,Canada
6429,Juan Carlos García,0,40.0,0,0,1,0,1,Honduras
6430,Juan Carlos Heguy,1,10.0,0,0,0,1,1,Chile
6431,Juan Carlos Heredia,1,12.0,0,0,1,0,1,Argentina
6432,Juan Carlos Irurieta,0,63.0,0,0,1,0,1,Argentina
6433,Juan Carlos Lallana,1,58.0,0,0,1,0,1,Argentina
6434,Juan Carlos Letelier,8,529.0,0,0,7,3,10,Algeria
6435,Juan Carlos Mariño,1,131.0,0,0,1,2,3,Uruguay
6436,Juan Carlos Oblitas,0,305.0,0,0,7,1,8,Peru
6437,Juan Carlos Orellana,0,76.0,0,0,0,1,1,Uruguay
6438,Juan Carlos Padilla,0,17.0,0,0,1,0,1,El Salvador
6439,Juan Carlos Paredes,0,25.0,1,0,0,1,1,Ecuador
6440,Juan Carlos Pedraza,0,60.0,0,0,1,0,1,Spain
6441,Juan Carlos Plata,6,674.0,0,0,9,5,14,Nicaragua
6442,Juan Carlos Portillo,0,30.0,0,0,0,1,1,United States Virgin Islands
6443,Juan Carlos Rojas,2,203.0,0,1,1,3,4,Paraguay
6444,Juan Carlos Salvini,0,159.0,0,0,2,0,2,Argentina
6445,Juan Carlos Sarnari,1,36.0,0,0,1,0,1,Argentina
6446,Juan Carlos Sánchez,0,74.0,0,0,0,1,1,Brazil
6447,Juan Carlos Valerón,2,218.0,0,0,2,2,4,Spain
6448,Juan Carlos Villamayor,2,90.0,0,0,2,0,2,Paraguay
6449,Juan Carreño,1,70.0,0,0,0,1,1,France
6450,Juan Carreño López,0,84.0,0,0,1,0,1,Chile
6451,Juan Castillo,1,73.0,0,0,0,1,1,Bolivia
6452,Juan Cayasso,3,235.0,0,0,3,1,4,Costa Rica
6453,Juan Contrera,0,147.0,0,0,2,0,2,Dominican Republic
6454,Juan Cruz Sol,0,39.0,0,0,1,0,1,Spain
6455,Juan Cuadrado,3,228.0,0,2,0,5,5,Japan
6456,Juan Domingo Brown,0,122.0,0,2,2,0,2,Argentina
6457,Juan Emilio Salinas,1,70.0,0,0,0,2,2,Ecuador
6458,Juan Enrique García,0,151.0,0,0,3,0,3,Venezuela
6459,Juan Fernando Quintero,2,109.0,0,0,2,0,2,Colombia
6460,Juan Flores Madariaga,0,143.0,0,0,3,2,5,Saint Vincent and the Grenadines
6461,Juan Francisco Barraza,0,170.0,0,0,2,0,2,El Salvador
6462,Juan Francisco Riveros,1,62.0,0,0,0,1,1,Chile
6463,Juan Francisco Rodríguez Herrera,0,40.0,0,0,1,0,1,Spain
6464,Juan Fuenmayor,0,41.0,1,0,0,1,1,Venezuela
6465,Juan González Soto,0,27.0,0,0,0,1,1,Suriname
6466,Juan Gutiérrez Moreno,0,34.0,0,0,0,1,1,Estonia
6467,Juan Hernández,0,90.0,0,0,1,0,1,Mexico
6468,Juan Hohberg,3,183.0,0,0,0,3,3,Hungary
6469,Juan Ignacio Basaguren,0,83.0,0,0,1,0,1,Mexico
6470,Juan Jairo Galeano,0,27.0,0,0,0,1,1,Argentina
6471,Juan José Jayo,0,38.0,0,0,0,1,1,Chile
6472,Juan José Muñante,0,70.0,0,0,0,1,1,Chile
6473,Juan José Pizzuti,1,177.0,0,0,4,0,4,Argentina
6474,Juan Joya,2,108.0,0,0,2,0,2,Peru
6475,Juan Loyarte,1,78.0,0,0,1,0,1,Argentina
6476,Juan Maglio,0,47.0,0,0,0,2,2,Peru
6477,Juan Manuel Asensi,1,266.0,0,0,4,1,5,Belgium
6478,Juan Manuel Funes,2,109.0,0,0,3,0,3,Guatemala
6479,Juan Manuel Vargas,1,235.0,0,0,2,1,3,Peru
6480,Juan Marvezzi,5,146.0,0,0,5,0,5,Argentina
6481,Juan Mata,3,621.0,0,1,4,5,9,Spain
6482,Juan Mujica,1,50.0,0,0,0,1,1,Israel
6483,Juan Pablo Rodríguez,0,83.0,0,0,1,0,1,Mexico
6484,Juan Pablo Sorín,2,445.0,0,0,2,5,7,Venezuela
6485,Juan Pablo Vargas,1,121.0,0,0,2,0,2,Costa Rica
6486,Juan Pablo Ángel,0,465.0,0,2,6,2,8,Peru
6487,Juan Pajuelo,1,207.0,0,0,1,2,3,Ecuador
6488,Juan Pedro Riephoff,1,96.0,0,0,0,2,2,Peru
6489,Juan Píriz,2,196.0,0,0,0,3,3,Peru
6490,Juan Ramón Epitié,0,57.0,0,0,1,0,1,Equatorial Guinea
6491,Juan Ramón Martínez,3,356.0,0,0,4,3,7,El Salvador
6492,Juan Reynoso Guzmán,2,213.0,0,0,3,1,4,Paraguay
6493,Juan Riephoff,1,25.0,0,0,0,1,1,Colombia
6494,Juan Rodrigo Rojas,1,77.0,1,0,0,1,1,Paraguay
6495,Juan Román Riquelme,7,719.0,0,4,12,3,15,Argentina
6496,Juan Sebastián Verón,0,252.0,0,1,3,3,6,Paraguay
6497,Juan Seminario,2,217.0,0,0,1,2,3,Peru
6498,Juan Soto Mura,2,68.0,0,0,0,2,2,Bolivia
6499,Juan Soto Quiros,0,32.0,0,0,1,0,1,Costa Rica
6500,Juan Ulloa,0,280.0,0,0,4,2,6,Costa Rica
6501,Juanito,1,70.0,0,1,1,2,3,Yugoslavia
6502,Juanpi,0,34.0,0,0,1,0,1,Venezuela
6503,Juary Soares,0,90.0,0,0,0,1,1,Gabon
6504,Judd Molea,0,41.0,0,0,0,1,1,Papua New Guinea
6505,Jude Bellingham,1,35.0,0,0,1,0,1,England
6506,Judelin Aveska,0,60.0,0,0,1,0,1,Haiti
6507,Judikael Ixoée,1,25.0,0,1,1,0,1,New Caledonia
6508,Juhani Peltonen,0,252.0,0,1,3,3,6,Scotland
6509,Jukka Ikäläinen,0,47.0,1,0,1,0,1,Portugal
6510,Julen Guerrero,0,417.0,0,0,5,5,10,Lithuania
6511,Jules Alberto,0,83.0,0,0,2,0,2,India
6512,Jules Bocandé,1,187.0,0,0,2,1,3,Mozambique
6513,Jules Kadeba,0,73.0,0,0,1,0,1,Burkina Faso
6514,Jules Lagadeau,0,180.0,0,0,2,0,2,Suriname
6515,Juli Fernandez,1,84.0,0,0,0,1,1,Israel
6516,Juli Sánchez,0,73.0,0,0,0,1,1,Russia
6517,Julian Brandt,0,162.0,0,0,2,0,2,Germany
6518,Julian Draxler,2,148.0,0,1,4,1,5,Germany
6519,Julian Green,1,107.0,0,0,0,1,1,Belgium
6520,Julian Johnsson,0,87.0,0,0,1,1,2,Faroe Islands
6521,Julian Wade,2,99.0,0,0,1,1,2,Dominica
6522,Julian de Guzman,2,177.0,0,0,1,2,3,Costa Rica
6523,Juliano Belletti,2,146.0,1,0,1,1,2,Brazil
6524,Julien Cools,1,130.0,0,0,2,0,2,Belgium
6525,Julien Escudé,0,55.0,1,0,0,1,1,France
6526,Julien Nsengiyumva,0,75.0,0,0,1,0,1,Rwanda
6527,Julinho,1,69.0,0,0,1,0,1,Brazil
6528,Julio Abbadie,5,250.0,0,0,0,5,5,Scotland
6529,Julio Asad,0,11.0,0,0,0,1,1,Brazil
6530,Julio Crisosto,0,78.0,0,0,2,0,2,Chile
6531,Julio César Baldivieso,0,529.0,0,3,8,3,11,Argentina
6532,Julio César Britos,3,182.0,0,0,0,3,3,Colombia
6533,Julio César Cortés,1,75.0,0,0,1,1,2,France
6534,Julio César Cáceres,0,54.0,0,0,1,0,1,Paraguay
6535,Julio César Enciso,0,62.0,0,0,0,1,1,Venezuela
6536,Julio César Romero,1,563.0,0,0,6,4,10,Brazil
6537,Julio César Uribe,0,197.0,0,1,1,2,3,Peru
6538,Julio César de Andrade Moura,0,75.0,0,0,1,1,2,Peru
6539,Julio César de León,1,457.0,0,1,4,4,8,Haiti
6540,Julio Dely Valdés,0,582.0,0,1,6,5,11,Belize
6541,Julio Enrique Martínez,0,100.0,0,0,1,1,2,El Salvador
6542,Julio Francia,4,219.0,0,1,4,0,4,Argentina
6543,Julio Gallardo,2,55.0,0,0,2,1,3,Chile
6544,Julio Libonatti,1,158.0,0,0,4,0,4,Argentina
6545,Julio Meléndez,0,10.0,1,0,0,1,1,Peru
6546,Julio Montero Castillo,0,44.0,0,0,1,0,1,Uruguay
6547,Julio Morales,0,168.0,0,1,2,0,2,Uruguay
6548,Julio Palacios Lozano,0,22.0,0,0,1,0,1,El Salvador
6549,Julio Pérez,2,137.0,0,0,0,2,2,Bolivia
6550,Julio Ramírez,1,5.0,0,0,0,1,1,Chile
6551,Julio Rodas,2,93.0,0,0,2,0,2,Guatemala
6552,Julio Salinas,3,471.0,0,0,4,10,14,Northern Ireland
6553,Julio Valentín González,1,29.0,0,0,0,1,1,Brazil
6554,Julio dos Santos,1,85.0,0,1,0,1,1,Costa Rica
6555,Julius Aghahowa,4,639.0,0,0,5,5,10,Nigeria
6556,Julius James,0,26.0,1,0,1,0,1,Costa Rica
6557,Julius Owino,0,8.0,0,0,1,0,1,Kenya
6558,Julián Álvarez,4,256.0,0,0,3,2,5,Ecuador
6559,Juma Darwish Al-Mashri,0,87.0,0,0,1,0,1,Oman
6560,Juma Marzouq,1,44.0,0,0,0,1,1,Hong Kong
6561,Juma Mkambi,0,54.0,0,0,0,1,1,Nigeria
6562,Jumah Salem Joher,0,32.0,0,0,1,0,1,Qatar
6563,Junaedi Abdillah,1,70.0,0,0,0,1,1,Thailand
6564,Jung Jae-Kwon,0,76.0,0,0,1,0,1,South Korea
6565,Jung Woo-young,0,82.0,0,0,0,1,1,Turkmenistan
6566,Jung Yong-Hwan,0,30.0,0,0,0,1,1,Japan
6567,Junichi Inamoto,0,118.0,0,0,2,0,2,Japan
6568,Juninho Bacuna,0,36.0,0,0,2,0,2,Curaçao
6569,Juninho Paulista,0,28.0,0,0,0,1,1,Venezuela
6570,Juninho Pernambucano,2,159.0,0,0,1,2,3,Brazil
6571,Junior Agogo,2,387.0,0,0,5,2,7,Ghana
6572,Junior Bukaudi,1,49.0,0,0,1,0,1,Fiji
6573,Junior Flemmings,1,87.0,0,0,0,1,1,Guadeloupe
6574,Junior Hoilett,7,463.0,0,2,4,4,8,Jamaica
6575,Junior Kabananga,3,112.0,0,0,1,2,3,DR Congo
6576,Junior Michael,1,198.0,0,1,2,1,3,American Samoa
6577,Junior Pukoku,1,13.0,0,0,1,0,1,Cook Islands
6578,Junya Ito,0,361.0,0,0,4,2,6,Japan
6579,Juozas Gudelis,0,79.0,0,0,0,1,1,Latvia
6580,Jupp Heynckes,0,224.0,0,0,4,0,4,Germany
6581,Juraj Kucka,0,225.0,1,0,4,3,7,Slovakia
6582,Juraj Piroska,0,54.0,0,0,0,1,1,North Macedonia
6583,Juraj Szikora,0,15.0,0,0,0,1,1,Republic of Ireland
6584,Jurgen Cavens,0,83.0,0,0,0,1,1,Latvia
6585,Jurgen Degabriele,0,90.0,0,0,0,1,1,Cyprus
6586,Jurgen Kohler,0,55.0,1,0,0,1,1,Germany
6587,Jurica Jerković,0,47.0,0,0,1,1,2,Yugoslavia
6588,Jurijs Ševļakovs,0,119.0,0,0,2,0,2,Latvia
6589,Jurijs Žigajevs,0,44.0,0,0,1,0,1,Latvia
6590,Juris Laizāns,0,500.0,0,1,4,5,9,Poland
6591,Juriën Gaari,1,90.0,0,0,0,1,1,Jamaica
6592,Just Fontaine,13,980.0,0,0,20,1,21,France
6593,Justas Lasickas,0,18.0,0,0,1,0,1,Lithuania
6594,Justin Cochrane,0,47.0,0,0,0,1,1,United States Virgin Islands
6595,Justin Donawa,0,127.0,0,0,0,2,2,Bahamas
6596,Justin Manao,1,116.0,0,0,1,1,2,Tonga
6597,Justin Meram,1,158.0,0,1,1,2,3,Iraq
6598,Justo Jacquet,0,34.0,0,0,1,0,1,Paraguay
6599,Justo Ruiz,0,129.0,0,2,2,0,2,Andorra
6600,Juvenal Edjogo-Owono,0,276.0,0,3,4,2,6,South Africa
6601,Juvenal Olmos,2,53.0,0,0,1,1,2,Bolivia
6602,Juvencio Osorio,0,61.0,0,0,2,0,2,Paraguay
6603,Jyn Tson,0,90.0,0,0,1,0,1,Taiwan
6604,Jyrki Nieminen,0,128.0,0,0,1,1,2,England
6605,Jádson,1,38.0,0,0,1,0,1,Brazil
6606,Jákup Thomsen,0,90.0,0,0,0,1,1,Malta
6607,Ján Greguš,0,41.0,0,0,0,1,1,Malta
6608,Ján Kapko,0,65.0,1,0,1,0,1,Italy
6609,Ján Kozák,0,421.0,0,0,3,4,7,Czechoslovakia
6610,Ján Čapkovič,0,223.0,0,0,0,4,4,Wales
6611,Ján Ďurica,0,354.0,3,1,3,3,6,Germany
6612,Ján Švehlík,1,8.0,0,0,1,0,1,Czechoslovakia
6613,János Farkas,1,381.0,0,0,8,2,10,Hungary
6614,János Göröcs,0,240.0,0,0,3,1,4,Russia
6615,János Hrutka,0,82.0,0,0,1,0,1,Hungary
6616,János Mátyus,0,83.0,0,0,1,1,2,Hungary
6617,Jérémie Boga,1,90.0,0,0,0,1,1,Malawi
6618,Jérémy Doku,0,42.0,0,0,1,0,1,Belgium
6619,Jérémy Ménez,0,53.0,0,0,0,1,1,Ukraine
6620,Jérôme Boateng,1,8.0,0,0,1,0,1,Germany
6621,Jérôme Doté,0,80.0,0,0,1,0,1,Togo
6622,Jérôme Lèbre Mamahou,0,115.0,0,0,3,0,3,Ivory Coast
6623,Jérôme Rothen,0,66.0,0,0,0,1,1,Faroe Islands
6624,Jóan Símun Edmundsson,0,195.0,0,0,1,3,4,Estonia
6625,Jóhann Berg Guðmundsson,0,283.0,0,0,2,4,6,Switzerland
6626,Jóhannes Eðvaldsson,0,12.0,0,0,1,0,1,Iceland
6627,Jón Dagur Þorsteinsson,0,54.0,0,0,0,1,1,North Macedonia
6628,Jón Daði Böðvarsson,1,175.0,1,0,4,0,4,Iceland
6629,Jón Rói Jacobsen,0,30.0,1,0,1,0,1,Serbia
6630,Józef Wandzik,0,53.0,1,0,1,0,1,Romania
6631,József Bencsics,1,69.0,0,0,1,0,1,Hungary
6632,József Bozsik,1,57.0,0,0,2,0,2,Hungary
6633,József Horváth,0,18.0,0,0,0,1,1,Luxembourg
6634,József Kardos,0,89.0,0,0,1,1,2,Greece
6635,József Kiprich,0,479.0,0,2,5,6,11,Austria
6636,József Nemes,0,126.0,0,0,3,0,3,Hungary
6637,József Pecsovszky,0,50.0,0,0,2,0,2,Romania
6638,József Póczik,0,158.0,0,0,0,3,3,Luxembourg
6639,József Sebők,0,17.0,0,0,1,0,1,Hungary
6640,József Solti,0,133.0,0,0,2,0,2,Hungary
6641,József Szalma,0,15.0,0,0,0,1,1,Cyprus
6642,József Tóth,2,125.0,0,0,1,1,2,Germany
6643,József Varga,1,27.0,0,0,0,1,1,Belgium
6644,Jô,0,180.0,0,0,2,0,2,Brazil
6645,Jörgen Pettersson,0,53.0,0,0,1,0,1,Sweden
6646,Jørgen Kristensen,0,75.0,0,0,1,0,1,Denmark
6647,Jørn Andersen,0,90.0,0,0,1,1,2,Norway
6648,Júlio Baptista,3,180.0,0,0,2,3,5,Chile
6649,Júlio Botelho,6,343.0,0,0,4,4,8,Bolivia
6650,Júlio Tavares,2,132.0,0,0,1,2,3,Central African Republic
6651,Július Šimon,0,154.0,0,1,3,0,3,Slovakia
6652,Júnior Alonso,1,119.0,0,0,1,1,2,Paraguay
6653,Júnior Baiano,1,66.0,0,0,1,0,1,Brazil
6654,Júnior Díaz,0,16.0,0,0,1,0,1,Costa Rica
6655,Júnior Izaguirre,1,42.0,0,0,0,1,1,Uruguay
6656,Júnior Moraes,0,80.0,0,0,1,0,1,Ukraine
6657,Jürgen Damm,0,72.0,0,0,0,1,1,Honduras
6658,Jürgen Grabowski,0,191.0,0,0,2,1,3,Germany
6659,Jürgen Heun,0,71.0,0,0,1,0,1,German DR
6660,Jürgen Klinsmann,15,1357.0,0,2,19,11,30,Germany
6661,Jürgen Nöldner,0,126.0,0,0,2,1,3,German DR
6662,Jürgen Pommerenke,0,48.0,0,0,0,1,1,Iceland
6663,Jürgen Sparwasser,0,454.0,0,0,4,3,7,German DR
6664,Jānis Ikaunieks,0,40.0,0,0,1,0,1,Latvia
6665,K. Appalaraju,1,2.0,0,0,1,0,1,India
6666,Kaan Ayhan,0,182.0,0,0,2,1,3,Turkey
6667,Kaba Diawara,2,348.0,0,0,5,2,7,Guinea
6668,Kabamba Musasa,0,86.0,0,0,1,0,1,DR Congo
6669,Kabasu Babo,1,51.0,0,0,0,1,1,Nigeria
6670,Kabeu,1,22.0,0,0,1,0,1,New Caledonia
6671,Kadell Daniel,1,54.0,0,0,1,0,1,Guyana
6672,Kader Mangane,0,67.0,0,0,1,0,1,Senegal
6673,Kadhim Waal,1,84.0,0,0,1,0,1,Iraq
6674,Kagiso Dikgacoi,0,99.0,0,0,2,0,2,South Africa
6675,Kahraba,1,88.0,0,0,1,0,1,Egypt
6676,Kai Haaskivi,0,143.0,0,0,0,2,2,Italy
6677,Kai Havertz,2,347.0,0,0,3,4,7,Germany
6678,Kai Pahlman,0,80.0,0,1,1,1,2,Finland
6679,Kai Sjøberg,0,66.0,0,0,1,0,1,Norway
6680,Kaies Ghodhbane,1,236.0,0,0,1,3,4,Zambia
6681,Kaimar Saag,0,180.0,0,0,2,0,2,Estonia
6682,Kairat Ashirbekov,0,47.0,0,0,1,0,1,Kazakhstan
6683,Kairat Nurdauletov,0,172.0,0,2,2,1,3,Belgium
6684,Kais Yâakoubi,0,82.0,0,0,1,0,1,Tunisia
6685,Kaiser Hamid,1,148.0,0,1,2,0,2,Bangladesh
6686,Kaitano Tembo,0,47.0,0,0,1,0,1,Zimbabwe
6687,Kaj Poulsen,0,4.0,0,0,0,1,1,Wales
6688,Kakha Gogoladze,3,177.0,0,0,1,3,4,Taiwan
6689,Kakha Kaladze,0,122.0,2,0,0,2,2,Georgia
6690,Kakhaber Tskhadadze,0,68.0,0,0,1,0,1,Georgia
6691,Kakhi Asatiani,1,120.0,0,0,0,3,3,Turkey
6692,Kakoko Etepé,2,309.0,0,0,3,4,7,Mali
6693,Kaká,6,829.0,0,2,8,9,17,Colombia
6694,Kalaje Gnipate,1,44.0,0,0,1,0,1,New Caledonia
6695,Kalen Damessi,0,8.0,0,0,1,0,1,Togo
6696,Kalevi Lehtovirta,0,187.0,0,0,3,0,3,Finland
6697,Kalidou Koulibaly,1,70.0,0,0,0,1,1,Ecuador
6698,Kalifa Coulibaly,1,106.0,0,0,1,1,2,Rwanda
6699,Kalin Bankov,0,76.0,0,0,1,0,1,Bulgaria
6700,Kaliova Bulinaceva,0,15.0,0,0,0,1,1,Vanuatu
6701,Kalu Uche,2,28.0,0,0,1,1,2,Greece
6702,Kalusha Bwalya,10,1104.0,0,2,11,8,19,Zambia
6703,Kama Dumbuya,0,105.0,0,0,2,0,2,Sierra Leone
6704,Kamal Abdel Wahab,1,37.0,0,0,0,1,1,Congo
6705,Kamal Kamyabinia,0,32.0,0,0,0,1,1,Guam
6706,Kamel Gabsi,1,60.0,0,0,0,1,1,Cameroon
6707,Kamel Seddik,0,42.0,1,0,1,0,1,Libya
6708,Kameli Kilalwaca,1,54.0,0,0,1,0,1,Fiji
6709,Kamil Al Aswad,0,166.0,0,0,3,1,4,Bahrain
6710,Kamil Glik,0,328.0,1,0,3,2,5,Poland
6711,Kamil Grosicki,2,170.0,0,0,4,4,8,Gibraltar
6712,Kamil Jóźwiak,0,72.0,0,0,0,2,2,Hungary
6713,Kamil Kopúnek,1,89.0,0,0,1,0,1,Slovakia
6714,Kamil Kosowski,0,88.0,0,0,3,0,3,Poland
6715,Kamil Zayatte,0,166.0,0,0,1,1,2,Guinea
6716,Kamilou Daouda,0,157.0,0,0,2,0,2,Niger
6717,Kamo Hovhannisyan,0,44.0,1,0,0,2,2,Armenia
6718,Kamunda Tshinabu,0,88.0,0,1,1,0,1,DR Congo
6719,Kamuran Yavuz,0,15.0,0,0,0,1,1,Germany
6720,Kanat Sardarov,1,76.0,0,0,1,0,1,Kyrgyzstan
6721,Kandia Traoré,1,168.0,0,0,0,2,2,Congo
6722,Kane Crichlow,3,179.0,0,0,2,1,3,Canada
6723,Kang Chul,0,51.0,0,0,1,0,1,South Korea
6724,Kanga Akalé,0,86.0,0,0,0,2,2,Sudan
6725,Kanika Matondo,0,90.0,0,0,0,1,1,Congo
6726,Kanku Mulekelayi,0,79.0,0,0,0,1,1,Ivory Coast
6727,Kanlaya Sysomvang,0,112.0,0,1,1,0,1,Laos
6728,Kaoru Mitoma,0,179.0,0,0,0,2,2,Australia
6729,Kara Mbodji,2,180.0,0,0,1,2,3,South Africa
6730,Karapet Mikaelyan,0,91.0,0,0,2,0,2,Armenia
6731,Karel Geraerts,0,109.0,0,0,1,2,3,Lithuania
6732,Karel Jarolím,0,35.0,0,0,1,0,1,Czechoslovakia
6733,Karel Kula,0,67.0,0,0,1,0,1,Czechoslovakia
6734,Karel Poborský,2,271.0,0,2,5,1,6,Czech Republic
6735,Karen Dokhoyan,0,60.0,0,0,1,0,1,Armenia
6736,Kari Ukkonen,0,59.0,0,0,1,1,2,Wales
6737,Karim Abdul Razak,0,112.0,0,0,2,0,2,Ghana
6738,Karim Adeyemi,0,90.0,0,0,1,0,1,Germany
6739,Karim Ansarifard,4,888.0,0,2,10,4,14,Iran
6740,Karim Bagheri,12,1594.0,0,1,15,17,32,Saudi Arabia
6741,Karim Bavi,0,62.0,0,0,0,3,3,Qatar
6742,Karim Bellarabi,1,57.0,0,0,0,1,1,Gibraltar
6743,Karim Benzema,7,1035.0,0,2,11,8,19,Faroe Islands
6744,Karim Boudiaf,0,134.0,0,0,1,2,3,Hong Kong
6745,Karim Haggui,1,163.0,0,0,2,1,3,Tunisia
6746,Karim Kamanzi,1,90.0,0,0,1,0,1,Rwanda
6747,Karim Maroc,1,73.0,0,0,1,0,1,Algeria
6748,Karim Matmour,1,99.0,0,0,1,1,2,Algeria
6749,Karim Mohammed Allawi,1,76.0,0,0,1,0,1,Iraq
6750,Karim Saddam,1,88.0,0,0,1,0,1,Iraq
6751,Karim Ziani,0,154.0,0,2,3,0,3,Algeria
6752,Karl Brauneder,0,81.0,0,0,1,0,1,Austria
6753,Karl Hohmann,2,258.0,0,0,2,3,5,Luxembourg
6754,Karl Kodat,0,11.0,0,0,0,1,1,Republic of Ireland
6755,Karl Koller,1,62.0,0,0,2,0,2,Austria
6756,Karl Namnganda,0,90.0,0,0,0,1,1,Nigeria
6757,Karl Odermatt,0,324.0,0,0,3,3,6,Romania
6758,Karl Sesta,1,54.0,0,0,1,0,1,Austria
6759,Karl Skerlan,0,60.0,0,0,1,0,1,Austria
6760,Karl Stotz,0,89.0,0,1,1,0,1,Austria
6761,Karl Toko Ekambi,0,416.0,0,0,7,1,8,Cameroon
6762,Karl Zischek,1,110.0,0,0,2,0,2,Austria
6763,Karl-Erik Palmér,3,223.0,0,0,1,5,6,Republic of Ireland
6764,Karl-Heinz Riedle,2,447.0,0,0,3,5,8,Finland
6765,Karl-Heinz Rummenigge,10,1719.0,0,3,25,7,32,Germany
6766,Karl-Heinz Schnellinger,1,90.0,0,0,1,0,1,Germany
6767,Karlen Mkrtchyan,0,30.0,0,0,0,1,1,Czech Republic
6768,Karlheinz Förster,0,126.0,0,0,1,1,2,Germany
6769,Karol Dobiaš,1,25.0,0,0,1,0,1,Czechoslovakia
6770,Karol Jokl,1,329.0,0,0,3,3,6,Czechoslovakia
6771,Karol Kisel,0,54.0,0,0,0,1,1,Luxembourg
6772,Karol Linetty,1,179.0,0,0,2,1,3,Poland
6773,Karol Świderski,0,252.0,0,0,3,2,5,Poland
6774,Karrar Jassim,3,113.0,0,0,3,0,3,Iraq
6775,Kaspars Gorkšs,0,249.0,0,0,0,5,5,Denmark
6776,Kasper Dolberg,3,341.0,0,1,4,4,8,Kazakhstan
6777,Kasper Hämäläinen,0,232.0,0,0,5,0,5,Finland
6778,Kasper Lorentzen,0,81.0,0,0,1,0,1,Denmark
6779,Kassahun Teka,0,79.0,0,1,0,1,1,Zambia
6780,Kassaly Daouda,0,53.0,1,0,1,0,1,Angola
6781,Kassim M'Dahoma,0,10.0,1,0,1,0,1,Togo
6782,Kassoum Ouédraogo,0,154.0,0,2,3,0,3,Burkina Faso
6783,Kastriot Dermaku,0,32.0,0,0,1,0,1,Albania
6784,Kasun Jayasuriya,2,113.0,0,0,3,0,3,Sri Lanka
6785,Katlego Mashego,1,90.0,0,0,0,1,1,Central African Republic
6786,Katlego Mphela,1,364.0,0,0,4,1,5,Tunisia
6787,Katsuyoshi Shinto,0,19.0,0,0,1,0,1,Japan
6788,Kaveh Rezaei,2,167.0,0,0,0,2,2,Cambodia
6789,Kazi Salahuddin,1,60.0,0,1,0,1,1,North Korea
6790,Kazimierz Deyna,4,631.0,0,2,9,5,14,Poland
6791,Kazushi Kimura,2,291.0,0,0,4,3,7,Singapore
6792,Kazuyoshi Miura,10,1519.0,0,1,23,7,30,Japan
6793,Kebede Asfaw,0,65.0,0,0,0,1,1,Sudan
6794,Kebede Metaferia,0,31.0,0,0,0,1,1,Israel
6795,Kees Kist,2,229.0,0,1,3,1,4,Netherlands
6796,Kees Rijvers,0,54.0,0,0,1,0,1,Netherlands
6797,Kees van Kooten,2,151.0,0,0,1,3,4,Cyprus
6798,Kei Kamara,0,93.0,0,0,2,0,2,Sierra Leone
6799,Keidi Bare,0,34.0,0,0,0,1,1,Moldova
6800,Keiji Tamada,3,372.0,0,0,3,4,7,Bahrain
6801,Keijo Kousa,0,169.0,0,0,2,0,2,Finland
6802,Keiran Murtagh,0,90.0,0,0,1,0,1,Antigua and Barbuda
6803,Keisuke Honda,11,920.0,0,7,12,9,21,Japan
6804,Keita Baldé,1,135.0,0,0,3,0,3,Senegal
6805,Keita Karamokoba,0,71.0,0,0,0,1,1,DR Congo
6806,Keita Suzuki,0,8.0,1,0,1,0,1,Vietnam
6807,Keith Andrews,0,13.0,0,0,0,1,1,Estonia
6808,Keith Fahey,0,76.0,0,0,0,1,1,Armenia
6809,Keith Fletcher,0,201.0,0,0,3,0,3,Grenada
6810,Keith Gillespie,0,140.0,1,0,2,1,3,Austria
6811,Keith Gumbs,0,370.0,0,2,5,2,7,Saint Kitts and Nevis
6812,Keith Mackay,0,48.0,0,0,1,0,1,New Zealand
6813,Keith Nelson,0,192.0,0,0,6,1,7,New Zealand
6814,Keith O'Neill,0,9.0,0,0,0,1,1,Liechtenstein
6815,Keith Rowland,0,36.0,0,0,1,0,1,Northern Ireland
6816,Keithroy Cornelius,0,51.0,0,0,0,1,1,Curaçao
6817,Keithroy Freeman,0,135.0,0,1,2,2,4,Bahamas
6818,Kelechi Emeteole,0,63.0,0,0,1,0,1,Nigeria
6819,Kelechi Iheanacho,1,215.0,0,0,4,1,5,Zambia
6820,Kelly Peters,0,85.0,0,0,0,1,1,Bahamas
6821,Kelvin Mutale,0,92.0,0,0,2,2,4,Zambia
6822,Kelvin Sebwe,2,232.0,0,1,3,3,6,DR Congo
6823,Kelvyn Peters,0,6.0,0,0,1,0,1,Dominica
6824,Kelyn Rowe,0,56.0,0,0,1,0,1,United States
6825,Kema Jack,1,85.0,0,0,1,0,1,Papua New Guinea
6826,Kemar Lawrence,1,88.0,0,0,0,1,1,Mexico
6827,Kemar Roofe,0,38.0,0,0,0,1,1,Honduras
6828,Kembo Uba Kembo,0,253.0,0,0,6,0,6,DR Congo
6829,Ken Boden,0,31.0,0,0,0,1,1,New Zealand
6830,Ken Naganuma,0,16.0,0,0,1,0,1,Japan
6831,Kenan Karaman,0,85.0,0,0,1,1,2,Turkey
6832,Kenan Kodro,1,65.0,0,0,0,1,1,Gibraltar
6833,Kenan Simambe,0,84.0,0,0,1,0,1,Zambia
6834,Kendall Velox,0,285.0,0,0,0,5,5,Saint Kitts and Nevis
6835,Kendall Waston,1,214.0,0,0,1,2,3,Honduras
6836,Kengo Nakamura,0,230.0,0,0,1,2,3,Thailand
6837,Kenji Gorré,2,147.0,0,0,0,2,2,British Virgin Islands
6838,Kenlyn Gonsalves,0,88.0,0,0,1,1,2,Saint Vincent and the Grenadines
6839,Kennedy Chihuri,0,16.0,0,0,1,0,1,Zimbabwe
6840,Kennedy Mweene,1,85.0,0,1,1,0,1,Zambia
6841,Kennedy Phillip,0,39.0,0,0,1,0,1,Grenada
6842,Kennedy Simiyu,0,30.0,0,0,1,1,2,Kenya
6843,Kennet Andersson,5,852.0,0,2,7,9,16,Sweden
6844,Kenneth Brylle Larsen,1,60.0,0,0,1,0,1,Denmark
6845,Kenneth Hughes,0,69.0,0,1,1,0,1,Anguilla
6846,Kenneth Kluivert,0,31.0,0,0,1,0,1,Suriname
6847,Kenneth Malitoli,4,263.0,0,0,3,2,5,Zambia
6848,Kenneth Olayombo,0,81.0,0,0,2,0,2,Nigeria
6849,Kenneth Omeruo,1,73.0,0,0,1,0,1,Nigeria
6850,Kenneth Thompson,0,21.0,0,0,0,1,1,Antigua and Barbuda
6851,Kenny Cooper,0,250.0,0,1,3,0,3,United States
6852,Kenny Dalglish,3,582.0,0,0,8,6,14,Scotland
6853,Kenny McLean,0,4.0,0,0,0,1,1,San Marino
6854,Kenny Miller,0,389.0,0,1,8,3,11,Scotland
6855,Kenny Rocha Santos,0,76.0,1,0,0,1,1,Cape Verde
6856,Kenny Sansom,0,88.0,0,0,1,0,1,England
6857,Kenroy Skinner,0,33.0,0,0,0,1,1,Saint Kitts and Nevis
6858,Kensuke Nagai,0,40.0,0,0,1,0,1,Japan
6859,Kent Nielsen,0,59.0,0,0,2,0,2,Denmark
6860,Kenta Hasegawa,0,24.0,0,0,1,0,1,Japan
6861,Kento Hashimoto,0,51.0,0,0,1,0,1,Japan
6862,Kentoine Jennings,0,130.0,0,0,1,1,2,Antigua and Barbuda
6863,Kenwin McPhee,1,73.0,0,0,2,0,2,Saint Lucia
6864,Kenwyne Jones,5,723.0,1,1,6,5,11,Trinidad and Tobago
6865,Kenzo Huur,2,167.0,0,0,0,2,2,Montserrat
6866,Keo Sokpheng,0,33.0,0,0,1,0,1,Cambodia
6867,Keon Daniel,1,289.0,0,0,2,4,6,Cuba
6868,Kerbi Rodríguez,0,64.0,0,0,1,0,1,Dominican Republic
6869,Kerem Aktürkoğlu,0,39.0,0,0,2,1,3,Turkey
6870,Kerem Demirbay,1,48.0,0,0,1,0,1,Germany
6871,Kermit Erasmus,0,28.0,0,0,1,0,1,South Africa
6872,Keron Cummings,2,122.0,0,0,2,0,2,Trinidad and Tobago
6873,Kerry Baptiste,0,170.0,0,1,2,1,3,Honduras
6874,Kerry Jamerson,0,72.0,0,0,1,0,1,Trinidad and Tobago
6875,Kerry Skepple,0,103.0,0,0,3,0,3,Antigua and Barbuda
6876,Kervens Belfort,0,308.0,0,1,3,2,5,United States Virgin Islands
6877,Kervin Severino,0,99.0,0,1,2,0,2,Dominican Republic
6878,Keung He-chi,1,78.0,0,0,1,0,1,Hong Kong
6879,Kevin Archer,0,48.0,0,0,0,1,1,Suriname
6880,Kevin Davies,0,109.0,0,0,1,1,2,Anguilla
6881,Kevin De Bruyne,2,877.0,0,1,11,7,18,Serbia
6882,Kevin Doyle,1,310.0,0,0,3,6,9,Republic of Ireland
6883,Kevin Edward,0,20.0,0,0,0,1,1,Aruba
6884,Kevin Gallacher,0,379.0,0,0,5,4,9,Estonia
6885,Kevin Gameiro,0,82.0,0,0,2,0,2,France
6886,Kevin Holness,2,90.0,0,0,2,0,2,Canada
6887,Kevin Kampl,0,68.0,0,0,2,0,2,Slovenia
6888,Kevin Keegan,0,385.0,0,1,6,7,13,Cyprus
6889,Kevin Kilbane,1,368.0,1,0,3,4,7,Andorra
6890,Kevin Kurányi,0,274.0,0,0,4,2,6,Germany
6891,Kevin Lafrance,0,105.0,0,0,0,2,2,Curaçao
6892,Kevin López,0,65.0,0,0,0,1,1,Panama
6893,Kevin McKenna,3,224.0,0,0,2,2,4,Haiti
6894,Kevin Mirallas,0,233.0,0,0,1,3,4,Belgium
6895,Kevin Molino,2,367.0,0,0,3,3,6,Bermuda
6896,Kevin Moran,0,138.0,0,0,2,0,2,Republic of Ireland
6897,Kevin Muscat,4,372.0,0,4,8,1,9,Australia
6898,Kevin Nemia,1,28.0,0,0,1,0,1,New Caledonia
6899,Kevin O'Callaghan,0,35.0,0,0,1,0,1,Republic of Ireland
6900,Kevin O'Flanagan,1,62.0,0,0,1,0,1,Republic of Ireland
6901,Kevin Sheedy,1,234.0,0,0,3,1,4,Republic of Ireland
6902,Kevin Strootman,0,54.0,0,0,1,1,2,Finland
6903,Kevin Vandenbergh,0,100.0,0,0,2,0,2,Belgium
6904,Kevin Volland,0,85.0,0,0,0,1,1,San Marino
6905,Kevin Weymouth,0,74.0,0,0,1,0,1,New Zealand
6906,Kevin Wilson,1,63.0,0,0,2,2,4,Faroe Islands
6907,Kevin Wimmer,0,45.0,1,0,0,1,1,Austria
6908,Kevin-Prince Boateng,1,93.0,0,0,0,2,2,United States
6909,Kewullay Conteh,0,45.0,0,0,2,0,2,Sierra Leone
6910,Keysher Fuller,1,82.0,0,0,0,2,2,United States
6911,Khader Yousef,0,63.0,0,0,0,1,1,Malaysia
6912,Khaibar Amani,2,129.0,0,0,2,0,2,Afghanistan
6913,Khairul Amri,0,157.0,0,0,2,1,3,Singapore
6914,Khalaf Al-Mutairi,1,142.0,0,0,1,1,2,Kyrgyzstan
6915,Khalaf Al-Salamah,0,75.0,0,0,1,0,1,Kuwait
6916,Khaled Adénon,0,2.0,0,0,1,0,1,Benin
6917,Khaled Al Zaher,2,343.0,0,0,3,2,5,Syria
6918,Khaled Al-Doseri,0,43.0,0,0,2,0,2,Bahrain
6919,Khaled Awad,0,156.0,0,0,1,1,2,Jordan
6920,Khaled Badra,1,289.0,0,2,3,3,6,Namibia
6921,Khaled Elfallah,0,105.0,0,0,2,0,2,Libya
6922,Khaled Hamieh,0,88.0,0,0,0,1,1,Vietnam
6923,Khaled Korbi,1,34.0,0,0,0,1,1,Morocco
6924,Khaled Lounici,1,2.0,0,0,0,1,1,Burkina Faso
6925,Khaled Massad,5,742.0,0,3,9,5,14,Saudi Arabia
6926,Khaled Mhemed,0,81.0,0,0,1,0,1,Libya
6927,Khaled Mobayed,0,30.0,0,0,0,1,1,Philippines
6928,Khaled Mouelhi,1,30.0,0,1,0,1,1,Togo
6929,Khaled Saad,1,90.0,0,0,1,0,1,Jordan
6930,Khaleel Mubarak,2,107.0,0,0,1,1,2,China PR
6931,Khaleem Hyland,1,231.0,0,0,2,1,3,Trinidad and Tobago
6932,Khalfan Ibrahim,3,410.0,0,2,5,4,9,Qatar
6933,Khalfan Mubarak,0,41.0,0,0,1,0,1,United Arab Emirates
6934,Khalfan Ngassa,0,74.0,0,0,1,0,1,Tanzania
6935,Khalid Ahmed Elmustafa,0,81.0,0,0,2,0,2,Sudan
6936,Khalid Al-Hajri,2,205.0,0,0,0,3,3,Bangladesh
6937,Khalid Al-Temawi,3,66.0,0,2,2,1,3,Saudi Arabia
6938,Khalid Bakhit,0,84.0,0,0,1,1,2,Sierra Leone
6939,Khalid Boutaïb,1,206.0,0,0,4,1,5,Morocco
6940,Khalid Ismaïl,2,127.0,0,0,1,3,4,United Arab Emirates
6941,Khalid Labied,3,212.0,0,0,1,3,4,Ghana
6942,Khalid Mohammed Sabbar,1,69.0,0,0,0,1,1,Iran
6943,Khalid Raghib,0,172.0,0,0,3,0,3,Morocco
6944,Khalid Salman,2,286.0,0,2,3,1,4,Qatar
6945,Khalifa Al-Sulaiti,1,20.0,0,0,0,1,1,China PR
6946,Khalifa Ayil,0,78.0,0,0,2,0,2,Oman
6947,Khalifa Khalifa,0,11.0,0,0,1,0,1,Libya
6948,Khalil Al-Malki,5,368.0,0,0,2,5,7,Qatar
6949,Khalil Allawi,2,122.0,0,0,2,0,2,Iraq
6950,Khalil Bani Attiah,0,45.0,0,0,1,0,1,Jordan
6951,Khalil Ibrahim,0,40.0,0,0,1,0,1,United Arab Emirates
6952,Khalilou Fadiga,1,125.0,0,1,2,2,4,Nigeria
6953,Khama Billiat,1,130.0,0,0,1,1,2,Uganda
6954,Khamees Saad Mubarak,3,548.0,0,0,6,2,8,United Arab Emirates
6955,Khamis Al-Zahrani,0,46.0,0,0,1,0,1,Saudi Arabia
6956,Khamis Eid,1,40.0,0,0,1,0,1,Bahrain
6957,Khamis Eid Rafe Thani,3,107.0,0,0,2,1,3,Bahrain
6958,Khamis Esmaeel,0,14.0,0,0,1,0,1,United Arab Emirates
6959,Khamis Mubarak,2,73.0,0,0,0,2,2,India
6960,Khampheng Sayavutthi,1,200.0,0,1,3,1,4,Laos
6961,Khan Thatat Songwuti,1,72.0,0,0,0,1,1,Malaysia
6962,Khandoker Wasim Iqbal,0,10.0,0,0,1,0,1,Bangladesh
6963,Khano Smith,0,317.0,0,2,3,3,6,Bermuda
6964,Khash-Erdene Tuya,0,39.0,1,0,1,0,1,Japan
6965,Khemais Labidi,0,109.0,0,0,2,0,2,Tunisia
6966,Khishigdalai Battulga,0,75.0,1,0,1,0,1,Maldives
6967,Khodadad Azizi,5,501.0,0,0,4,6,10,Saudi Arabia
6968,Khoren Bayramyan,0,74.0,0,0,1,0,1,Armenia
6969,Khoren Oganesian,3,145.0,0,0,2,1,3,Russia
6970,Khoun Laboravy,0,193.0,1,0,2,1,3,Cambodia
6971,Khuda Muyaba,1,20.0,0,0,0,1,1,Ivory Coast
6972,Khvicha Kvaratskhelia,0,260.0,0,0,3,1,4,Georgia
6973,Khürelbaataryn Tsend-Ayuush,0,48.0,0,0,1,0,1,Mongolia
6974,Ki Sung-yueng,2,251.0,1,2,2,6,8,North Korea
6975,Kiatisuk Senamuang,5,795.0,0,0,11,4,15,Thailand
6976,Kick Smit,1,244.0,0,0,4,1,5,Netherlands
6977,Kidumu Mantantu,1,154.0,0,0,1,2,3,DR Congo
6978,Kieffer Moore,0,153.0,0,0,2,3,5,Slovakia
6979,Kieran Trippier,1,5.0,0,0,0,1,1,Croatia
6980,Kiki Antenen,0,59.0,0,0,1,0,1,Switzerland
6981,Kiko,1,145.0,0,0,2,1,3,Spain
6982,Kily González,4,99.0,0,3,5,1,6,Uruguay
6983,Kily Álvarez,0,90.0,0,0,1,0,1,Equatorial Guinea
6984,Kim Bo-Kyung,0,78.0,0,0,2,0,2,South Korea
6985,Kim Bok-man,1,20.0,0,0,1,0,1,North Korea
6986,Kim Chi-Woo,0,176.0,0,0,1,1,2,South Korea
6987,Kim Chol-Ho,0,43.0,0,0,0,1,1,Bahrain
6988,Kim Christofte,1,2.0,0,1,0,1,1,Faroe Islands
6989,Kim Do-heon,1,321.0,0,1,2,4,6,South Korea
6990,Kim Do-hoon,4,244.0,1,0,3,4,7,South Korea
6991,Kim Gwan-Mo,1,90.0,0,0,0,1,1,Syria
6992,Kim Gwang-Un,1,90.0,0,0,0,1,1,Syria
6993,Kim Ho-Kon,0,22.0,0,0,1,0,1,South Korea
6994,Kim Jae-han,0,269.0,0,0,5,0,5,South Korea
6995,Kim Jaggy,0,11.0,0,0,0,1,1,United States Virgin Islands
6996,Kim Ji-sung,0,45.0,0,0,0,1,1,Hong Kong
6997,Kim Jin-su,2,158.0,0,0,1,1,2,South Korea
6998,Kim Jong-Boo,1,70.0,0,0,1,0,1,South Korea
6999,Kim Jong-Min,1,53.0,0,0,1,0,1,North Korea
7000,Kim Jong-man,1,88.0,0,0,1,0,1,North Korea
7001,Kim Joo-sung,2,264.0,0,0,2,3,5,South Korea
7002,Kim Jung-woo,0,116.0,0,0,1,1,2,Indonesia
7003,Kim Ki-bok,0,8.0,0,0,1,0,1,South Korea
7004,Kim Kuk-jin,0,10.0,0,0,1,0,1,North Korea
7005,Kim Kwang-min,2,164.0,0,1,1,3,4,Hong Kong
7006,Kim Kyong-il,2,131.0,0,0,2,0,2,North Korea
7007,Kim Källström,0,426.0,0,1,7,3,10,Sweden
7008,Kim Meng Leong,1,50.0,0,0,1,0,1,Macau
7009,Kim Min-jae,2,92.0,0,0,1,1,2,Kyrgyzstan
7010,Kim Nam-il,1,68.0,0,0,1,0,1,South Korea
7011,Kim Pan-Keun,1,40.0,0,0,0,1,1,Iraq
7012,Kim Pung-Il,1,139.0,0,0,3,0,3,North Korea
7013,Kim Sang-sik,1,90.0,0,0,0,1,1,Iran
7014,Kim Seung-il,2,93.0,0,0,0,2,2,Australia
7015,Kim Shin-wook,0,285.0,0,1,6,1,7,Qatar
7016,Kim Suk-won,0,36.0,0,0,1,0,1,South Korea
7017,Kim Suominen,0,58.0,0,0,0,2,2,Sweden
7018,Kim Tae-Young,0,107.0,0,0,2,0,2,South Korea
7019,Kim Vilfort,2,615.0,0,0,8,3,11,Denmark
7020,Kim Yong-Nam,3,257.0,0,0,3,0,3,North Korea
7021,Kim Yong-Se,1,163.0,0,0,2,2,4,South Korea
7022,Kim Yong-su,0,113.0,0,0,0,2,2,Thailand
7023,Kim Young-gwon,3,285.0,0,0,5,0,5,South Korea
7024,Kin Seng Chan,0,113.0,0,0,1,1,2,Thailand
7025,Kingsley Black,0,42.0,0,0,1,0,1,Northern Ireland
7026,Kingsley Coman,0,94.0,0,0,3,0,3,France
7027,Kinitoni Falatau,1,90.0,0,0,1,0,1,Tonga
7028,Kiril Despodov,0,110.0,0,0,1,1,2,Bulgaria
7029,Kiril Milanov,0,71.0,0,0,1,0,1,Bulgaria
7030,Kirk Broadfoot,0,18.0,0,0,0,1,1,Iceland
7031,Kit Leong Cheong,1,28.0,0,0,0,1,1,Nepal
7032,Kit Symons,0,163.0,0,0,2,0,2,Wales
7033,Kiyika Tokodi,0,112.0,0,2,2,0,2,DR Congo
7034,Kjell Kristiansen,0,78.0,0,0,1,0,1,Norway
7035,Kjetil Hasund,0,145.0,0,0,0,2,2,Bulgaria
7036,Kjetil Osvold,0,106.0,0,0,1,1,2,Cyprus
7037,Kjetil Rekdal,2,966.0,0,6,11,4,15,Norway
7038,Klaas Nuninga,0,5.0,0,0,1,0,1,Netherlands
7039,Klaas-Jan Huntelaar,3,1345.0,0,2,19,7,26,Netherlands
7040,Klas Ingesson,0,242.0,0,1,1,3,4,Sweden
7041,Klaus Allofs,5,581.0,0,0,6,4,10,Germany
7042,Klaus Berggreen,1,236.0,0,0,1,3,4,Luxembourg
7043,Klaus Fichtel,0,37.0,0,0,1,0,1,Germany
7044,Klaus Fischer,1,711.0,0,0,11,4,15,Wales
7045,Klaus Toppmöller,0,43.0,0,0,1,0,1,Germany
7046,Klaus-Dieter Sieloff,0,51.0,0,0,2,0,2,Germany
7047,Kleanthis Vikelidis,2,133.0,0,1,1,2,3,Israel
7048,Klemen Lavrič,0,147.0,0,1,1,4,5,Moldova
7049,Klemi Saban,0,45.0,0,0,0,1,1,Moldova
7050,Klodian Duro,0,142.0,0,0,2,1,3,Russia
7051,Klæmint Olsen,0,259.0,0,0,2,2,4,Faroe Islands
7052,Knory Scott,1,64.0,0,0,1,0,1,Bermuda
7053,Knowledge Musona,2,212.0,0,1,3,2,5,Egypt
7054,Knut Dahlen,0,15.0,0,0,1,0,1,Norway
7055,Knut Hansson,0,120.0,0,0,0,2,2,Lithuania
7056,Knut Kroon,1,86.0,0,0,1,1,2,Sweden
7057,Ko Itakura,0,90.0,0,0,1,0,1,Japan
7058,Ko Jae-wook,0,27.0,0,0,1,0,1,South Korea
7059,Ko Jeong-woon,3,242.0,0,0,2,2,4,Iran
7060,Ko Po Keung,0,118.0,0,0,2,0,2,Hong Kong
7061,Kobenan Kouman,3,322.0,0,0,6,1,7,Ivory Coast
7062,Kodjo Fo-Doh Laba,1,103.0,0,0,1,1,2,Togo
7063,Koen Daerden,0,150.0,0,0,3,0,3,Belgium
7064,Koffi Kossi,0,69.0,0,0,2,0,2,Togo
7065,Koh Traoré,1,81.0,0,0,1,0,1,Burkina Faso
7066,Koichi Hashiratani,0,47.0,0,0,0,1,1,Singapore
7067,Koji Miyoshi,2,84.0,0,0,0,2,2,Uruguay
7068,Koji Mori,1,19.0,0,0,0,1,1,Vietnam Republic
7069,Koji Nakata,1,113.0,0,0,0,2,2,Bahrain
7070,Koji Sasaki,0,26.0,0,0,0,1,1,South Korea
7071,Kokos Antoniou,0,88.0,0,0,1,0,1,Cyprus
7072,Kokouni Akpalo Gnavor,0,85.0,0,0,0,1,1,Senegal
7073,Kolbeinn Sigþórsson,1,566.0,0,0,8,5,13,Iceland
7074,Kole Hall,1,65.0,0,0,1,0,1,Bermuda
7075,Kolo Touré,0,60.0,0,0,0,1,1,Morocco
7076,Komlan Amewou,0,47.0,1,0,1,1,2,Libya
7077,Komlan Assignon,1,52.0,0,1,1,1,2,Tunisia
7078,Komron Tursunov,1,34.0,0,0,1,0,1,Tajikistan
7079,Konan Yoboué,1,35.0,0,0,1,0,1,Ivory Coast
7080,Konrad Laimer,0,106.0,0,0,1,1,2,Austria
7081,Konstantin Gorovenka,1,238.0,0,0,3,0,3,Kazakhstan
7082,Konstantin Vassiljev,0,784.0,0,2,7,7,14,Armenia
7083,Konstantin Zyryanov,1,213.0,0,0,1,3,4,Greece
7084,Konstantinos Galanopoulos,0,70.0,0,0,1,0,1,Greece
7085,Konstantinos Laifis,0,85.0,0,0,2,0,2,Cyprus
7086,Konstantinos Mitroglou,1,440.0,0,0,5,4,9,Greece
7087,Koo Ja-cheol,6,523.0,0,1,8,4,12,South Korea
7088,Koray Avcı,0,72.0,0,0,0,1,1,Georgia
7089,Koriak Upaiga,0,67.0,0,0,1,0,1,Papua New Guinea
7090,Korken Yenkibarian,1,82.0,0,0,0,1,1,Sri Lanka
7091,Kornel Saláta,0,24.0,0,0,1,1,2,Latvia
7092,Kossi Noutsoudje,0,138.0,0,0,2,0,2,Togo
7093,Kosta Barbarouses,1,109.0,0,0,2,1,3,New Zealand
7094,Kosta Tomašević,2,151.0,0,0,0,2,2,Switzerland
7095,Kostadin Kostadinov,0,162.0,0,0,1,2,3,Finland
7096,Kostakis Artymatas,0,75.0,0,0,0,1,1,San Marino
7097,Kostas Aidiniou,0,80.0,0,0,1,0,1,Greece
7098,Kostas Antoniou,0,51.0,0,0,1,1,2,Greece
7099,Kostas Batsinilas,0,73.0,0,0,0,1,1,Cyprus
7100,Kostas Davourlis,0,60.0,0,0,1,0,1,Greece
7101,Kostas Eleftherakis,0,167.0,0,0,2,1,3,Portugal
7102,Kostas Fortounis,1,241.0,0,1,1,3,4,Gibraltar
7103,Kostas Foti,0,25.0,0,0,1,0,1,Cyprus
7104,Kostas Frantzeskos,0,215.0,0,0,2,1,3,Greece
7105,Kostas Iosifidis,0,47.0,0,0,1,0,1,Greece
7106,Kostas Katsouranis,0,248.0,0,0,3,1,4,Greece
7107,Kostas Konstantinidis,0,89.0,0,0,0,1,1,Slovenia
7108,Kostas Mavridis,0,39.0,0,0,0,1,1,Denmark
7109,Kostas Mitroglou,0,104.0,0,0,2,1,3,Greece
7110,Kostas Nestoridis,0,28.0,0,0,0,1,1,Yugoslavia
7111,Kostas Panayiotou,0,96.0,2,0,0,2,2,Cyprus
7112,Kostas Stafylidis,0,65.0,0,0,1,1,2,Greece
7113,Kouassi N'Dri,1,152.0,0,0,2,0,2,Ivory Coast
7114,Kouch Sokumpheak,0,227.0,0,0,2,1,3,Cambodia
7115,Kouligo Zoma,0,32.0,0,0,0,1,1,Mauritania
7116,Kpah Sherman,1,86.0,0,0,1,0,1,Liberia
7117,Krasimir Balakov,0,387.0,0,4,6,5,11,Finland
7118,Krassimir Chomakov,0,108.0,0,0,2,0,2,Bulgaria
7119,Kresten Bjerre,0,258.0,0,2,4,0,4,Denmark
7120,Kris Bouckenooghe,0,27.0,0,0,0,1,1,Tahiti
7121,Kris Boyd,0,104.0,0,1,4,0,4,Scotland
7122,Kris Trajanovski,4,577.0,0,1,7,4,11,Tahiti
7123,Krishanu Dey,0,119.0,0,0,1,1,2,Indonesia
7124,Krissada Piandit,0,23.0,0,0,1,0,1,Thailand
7125,Kristaps Grebis,0,76.0,0,0,1,0,1,Latvia
7126,Kristen Nygaard,0,114.0,0,2,1,1,2,Denmark
7127,Kristen Viikmäe,0,144.0,0,0,3,1,4,Estonia
7128,Kristian Dimitrov,0,55.0,0,0,1,0,1,Bulgaria
7129,Kristian Laferla,0,79.0,0,0,0,2,2,Estonia
7130,Kristian Thorstvedt,0,109.0,0,0,1,2,3,Gibraltar
7131,Kristján Örn Sigurðsson,0,155.0,0,0,2,0,2,Iceland
7132,Kristofer Hæstad,0,31.0,0,0,1,0,1,Norway
7133,Krisztián Kenesei,0,65.0,0,0,0,2,2,Sweden
7134,Krisztián Lisztes,0,302.0,0,0,1,4,5,Lithuania
7135,Krisztián Németh,0,199.0,0,0,1,2,3,Hungary
7136,Kroekrit Thaweekarn,0,29.0,0,0,0,1,1,Vietnam
7137,Krum Yanev,0,59.0,0,0,1,0,1,Bulgaria
7138,Krzysztof Bukalski,0,74.0,0,1,1,0,1,Poland
7139,Krzysztof Mączyński,0,17.0,0,0,2,0,2,Poland
7140,Krzysztof Nowak,0,90.0,0,0,1,0,1,Poland
7141,Krzysztof Piątek,0,355.0,0,0,2,4,6,Austria
7142,Krzysztof Warzycha,0,211.0,0,1,2,1,3,Poland
7143,Krépin Diatta,1,64.0,0,0,1,0,1,Senegal
7144,Ku Kam Fai,0,60.0,0,0,0,1,1,China PR
7145,Kubilay Türkyilmaz,0,1492.0,0,8,15,11,26,Luxembourg
7146,Kudakwashe Mahachi,2,99.0,0,0,2,1,3,Algeria
7147,Kuliwa Tshikalu,0,19.0,1,0,0,1,1,DR Congo
7148,Kunishige Kamamoto,2,92.0,0,0,0,2,2,Vietnam Republic
7149,Kunle Awesu,0,77.0,0,0,1,0,1,Nigeria
7150,Kurapiah Gunalan,1,81.0,0,0,1,0,1,Malaysia
7151,Kurniawan Dwi Yulianto,0,139.0,0,0,2,2,4,Indonesia
7152,Kurt Frederick,0,155.0,0,1,1,1,2,Saint Lucia
7153,Kurt Hamrin,0,478.0,0,0,5,2,7,Sweden
7154,Kurt Jara,0,466.0,0,0,6,4,10,Austria
7155,Kurt Liebrecht,0,80.0,0,1,1,0,1,German DR
7156,Kurt Mørkøre,0,82.0,0,0,0,1,1,Luxembourg
7157,Kurt Müller,0,189.0,0,0,1,2,3,Greece
7158,Kurt Svanström,0,68.0,0,0,1,0,1,Sweden
7159,Kurt Welzl,0,312.0,0,0,4,3,7,Austria
7160,Kurt Zouma,0,60.0,0,0,0,1,1,Andorra
7161,Kuyangana Makukula,0,47.0,0,0,0,1,1,Morocco
7162,Kwadwo Asamoah,2,258.0,0,0,2,2,4,Mali
7163,Kwak Tae-hwi,0,187.0,0,0,2,1,3,South Korea
7164,Kwame Ayew,0,202.0,0,0,3,1,4,Ghana
7165,Kwame Nti,1,43.0,0,0,1,0,1,Ghana
7166,Kwame Quee,0,56.0,0,0,0,1,1,Liberia
7167,Kwame Steede,0,101.0,0,0,1,1,2,Cayman Islands
7168,Kwasi Owusu,4,358.0,0,1,2,6,8,DR Congo
7169,Kwesi Appiah,1,44.0,0,0,1,0,1,Ghana
7170,Kwok Ka-ming,3,252.0,0,0,1,3,4,Japan
7171,Kwok Yue Hung,0,93.0,0,0,0,1,1,Malaysia
7172,Kwon Chang-hoon,1,433.0,0,0,5,2,7,South Korea
7173,Kyaw Ko Ko,1,32.0,0,0,1,0,1,Myanmar
7174,Kyaw Zayar Win,0,85.0,0,0,0,1,1,Laos
7175,Kyle Beckerman,0,49.0,0,0,1,0,1,United States
7176,Kyle Lafferty,0,889.0,0,0,9,6,15,Northern Ireland
7177,Kyle Lightbourne,0,97.0,0,0,1,1,2,Bermuda
7178,Kyle Martino,0,51.0,0,0,1,0,1,United States
7179,Kylian Mbappé,12,1368.0,0,2,15,6,21,France
7180,Kyogo Furuhashi,0,171.0,0,0,3,0,3,Japan
7181,Kypros Christoforou,0,51.0,1,0,1,0,1,Belgium
7182,Kyriakos Papadopoulos,0,110.0,0,0,1,1,2,Greece
7183,Kyrian Nwoko,0,13.0,0,0,1,0,1,Malta
7184,Kálmán Kovács,0,147.0,0,0,1,3,4,Northern Ireland
7185,Kálmán Mészöly,2,291.0,0,4,3,3,6,Hungary
7186,Kári Reynheim,0,63.0,0,0,0,1,1,Northern Ireland
7187,Kári Árnason,0,120.0,0,0,2,2,4,Sweden
7188,Károly Csapó,0,9.0,0,0,0,1,1,Argentina
7189,Károly Sándor,1,230.0,0,0,4,2,6,Hungary
7190,Kévin Constant,1,15.0,0,1,1,0,1,Guinea
7191,Kévin Denkey,0,77.0,0,0,0,1,1,Congo
7192,Kévin Fortuné,2,137.0,0,0,1,1,2,Cuba
7193,Kévin Parsemain,3,274.0,0,1,3,2,5,Martinique
7194,Köbi Kuhn,0,132.0,0,1,2,1,3,Switzerland
7195,Köksal Mesçi,0,79.0,0,1,1,0,1,Turkey
7196,La'Vere Corbin-Ong,0,12.0,0,0,1,0,1,Malaysia
7197,Labama Bokota,0,298.0,0,1,4,0,4,Rwanda
7198,Lachezar Tanev,0,317.0,0,1,3,2,5,Belgium
7199,Lacina Traoré,0,25.0,0,0,0,2,2,Gambia
7200,Ladislao Kubala,0,152.0,0,0,1,3,4,Scotland
7201,Ladislas Douniama,0,5.0,0,0,0,1,1,São Tomé and Príncipe
7202,Ladislav Jurkemik,0,111.0,0,0,1,1,2,Italy
7203,Ladislav Kačáni,0,29.0,0,0,0,1,1,Denmark
7204,Ladislav Krejčí,0,56.0,0,0,0,1,1,Kazakhstan
7205,Ladislav Kuna,0,232.0,0,0,2,2,4,Spain
7206,Ladislav Novák,0,43.0,0,0,0,1,1,German DR
7207,Ladislav Pavlovič,0,154.0,0,0,1,1,2,Czechoslovakia
7208,Ladislav Petráš,2,150.0,0,0,3,2,5,Brazil
7209,Ladislav Vízek,1,508.0,0,1,7,3,10,Czechoslovakia
7210,Ladislav Šimůnek,0,189.0,0,0,3,0,3,Czechoslovakia
7211,Lahcen Abrami,0,60.0,0,1,1,0,1,Morocco
7212,Lahcen Chicha,0,64.0,0,0,0,1,1,Tunisia
7213,Lai Wing-Cheung,0,11.0,0,0,1,1,2,Hong Kong
7214,Laisiasa Gataurua,3,249.0,0,0,3,1,4,Fiji
7215,Laith Hussein,8,406.0,0,0,9,3,12,Yemen
7216,Lajos Csordás,0,91.0,0,0,2,0,2,Hungary
7217,Lajos Détári,1,323.0,0,1,5,3,8,Netherlands
7218,Lajos Kocsis,2,361.0,0,2,4,3,7,Hungary
7219,Lajos Kű,0,53.0,0,1,0,1,1,Belgium
7220,Lajos Puskás,0,68.0,0,0,1,0,1,Hungary
7221,Lajos Szűcs,0,91.0,0,0,2,0,2,Hungary
7222,Lajos Sătmăreanu,0,56.0,0,0,0,1,1,Hungary
7223,Lajos Tichy,6,704.0,0,1,5,10,15,Norway
7224,Lakhdar Belloumi,6,656.0,0,0,8,4,12,Algeria
7225,Lakis Glezos,0,88.0,0,0,0,1,1,Bulgaria
7226,Lakis Papaioannou,0,104.0,0,0,0,2,2,Hungary
7227,Lalawélé Atakora,0,35.0,0,0,1,0,1,Togo
7228,Lalaïna Nomenjanahary,1,103.0,0,0,1,2,3,Comoros
7229,Lam Ka Wai,0,199.0,0,1,3,0,3,Hong Kong
7230,Lamin Conteh,0,87.0,0,0,1,0,1,Sierra Leone
7231,Lamine Diatta,1,141.0,0,0,1,1,2,Egypt
7232,Lamnao Singto,0,74.0,0,0,2,0,2,Laos
7233,Lancaster Joseph,0,50.0,0,0,0,1,1,Belize
7234,Landon Donovan,7,2040.0,0,10,31,7,38,United States
7235,Landry N'Guémo,1,64.0,0,0,1,0,1,Cameroon
7236,Lantame Ouadja,1,66.0,0,0,1,1,2,Togo
7237,Larbi Chebbak,1,81.0,0,0,1,0,1,Morocco
7238,Larrymore Bedford,0,88.0,0,0,1,0,1,Saint Kitts and Nevis
7239,Lars Bastrup,0,234.0,0,0,1,3,4,Scotland
7240,Lars Bender,1,80.0,0,0,0,1,1,Denmark
7241,Lars Bohinen,0,223.0,0,0,2,3,5,Cyprus
7242,Lars Elstrup,1,123.0,0,0,2,1,3,Denmark
7243,Lars Granström,0,49.0,0,0,0,2,2,Cyprus
7244,Lars Jacobsen,0,7.0,0,0,0,1,1,Cyprus
7245,Lars Krogh Gerson,0,129.0,0,1,2,1,3,Romania
7246,Lars Olsen,0,13.0,0,0,1,0,1,Denmark
7247,Lars Stindl,3,66.0,0,0,1,2,3,Australia
7248,Laryea Kingston,1,82.0,0,0,1,1,2,Ghana
7249,Lasaad Abdelli,0,37.0,0,0,1,0,1,Tunisia
7250,Lascelles Dunkley,0,179.0,0,0,2,2,4,Jamaica
7251,Lassana Fané,0,23.0,0,0,0,1,1,Ghana
7252,Lasse Larsson,0,85.0,0,0,1,0,1,Sweden
7253,Lasse Schøne,0,60.0,0,0,0,1,1,Iceland
7254,Lasse Vibe,0,81.0,0,0,0,1,1,Albania
7255,Lassina Dao,0,29.0,0,0,1,0,1,Ivory Coast
7256,Lassina Diabaté,1,83.0,0,0,1,0,1,Ivory Coast
7257,Lassina Traoré,1,76.0,0,1,0,1,1,Niger
7258,Lau Wing Yip,1,516.0,0,0,5,4,9,Hong Kong
7259,Laughter Chilembe,1,52.0,0,0,1,0,1,Zambia
7260,Lauren,0,78.0,0,0,1,0,1,Cameroon
7261,Laurent Blanc,2,552.0,0,0,6,3,9,France
7262,Laurent Depoitre,0,64.0,0,0,0,1,1,Andorra
7263,Laurent Grimmonprez,0,51.0,0,0,1,0,1,Belgium
7264,Laurent Pokou,13,910.0,0,0,1,14,15,Algeria
7265,Laurenţiu Roşu,0,156.0,0,0,2,1,3,Romania
7266,Lauro Amado,1,29.0,0,0,1,0,1,Switzerland
7267,Lautaro Martínez,6,484.0,0,0,6,7,13,Qatar
7268,Lawrence Adjei,0,90.0,0,0,1,0,1,Ghana
7269,Lawrence Harvey,1,41.0,1,0,0,1,1,Turks and Caicos Islands
7270,Lawrence Reilly,0,82.0,0,0,1,1,2,Northern Ireland
7271,Lawrence Shankland,0,65.0,0,0,1,0,1,Scotland
7272,Lawrence Waya,0,51.0,0,0,1,0,1,Malawi
7273,Lazar Marković,0,55.0,0,0,0,1,1,Wales
7274,Lazar Tasić,0,87.0,0,0,1,0,1,Yugoslavia
7275,Lazaros Christodoulopoulos,0,20.0,0,0,0,1,1,Lithuania
7276,Lazarus Kaimbi,0,142.0,0,0,2,1,3,Djibouti
7277,Le Huynh Duc,0,38.0,0,0,1,0,1,Vietnam
7278,Leandro Bacuna,3,62.0,0,0,0,3,3,Honduras
7279,Leandro Barreiro,0,45.0,0,0,1,0,1,Luxembourg
7280,Leandro Machado,1,86.0,0,0,1,0,1,Brazil
7281,Leandro Paredes,0,8.0,0,0,0,1,1,Colombia
7282,Leandro Trossard,0,112.0,0,0,2,0,2,Belgium
7283,Leart Paqarada,1,60.0,1,0,0,1,1,Kosovo
7284,Ledian Memushaj,0,71.0,0,0,0,1,1,Israel
7285,Lee Casciaro,0,136.0,0,0,1,2,3,Scotland
7286,Lee Chun-soo,1,130.0,0,0,1,1,2,Vietnam
7287,Lee Chung-yong,2,185.0,0,0,2,2,4,Argentina
7288,Lee Dixon,0,9.0,0,0,1,0,1,England
7289,Lee Dong-gook,11,986.0,0,1,12,6,18,South Korea
7290,Lee Dong-gyeong,0,22.0,0,0,1,0,1,South Korea
7291,Lee Eul-yong,0,9.0,0,0,1,0,1,South Korea
7292,Lee Hak-Jong,1,31.0,0,0,0,1,1,Nepal
7293,Lee Hoi-taek,1,59.0,0,0,0,1,1,Cambodia
7294,Lee Jae-sung,2,176.0,0,0,2,2,4,Myanmar
7295,Lee Jeong-hyeop,0,90.0,0,0,1,0,1,South Korea
7296,Lee Jung-hyup,1,53.0,0,0,1,1,2,Australia
7297,Lee Jung-il,1,7.0,0,0,0,1,1,Qatar
7298,Lee Jung-soo,2,45.0,0,0,1,1,2,South Korea
7299,Lee Kang-Jo,1,84.0,0,0,1,0,1,South Korea
7300,Lee Keun-ho,1,569.0,0,0,4,5,9,South Korea
7301,Lee Kin Wo,2,99.0,0,0,2,1,3,India
7302,Lee McCulloch,0,10.0,0,0,1,0,1,Scotland
7303,Lee Min-sung,1,161.0,0,0,1,1,2,Japan
7304,Lee Sang-yoon,0,179.0,0,0,2,1,3,South Korea
7305,Lee Soon-myung,0,79.0,0,0,0,1,1,Israel
7306,Lee Tae-ho,6,531.0,0,2,4,5,9,South Korea
7307,Lee Wai-Shan,0,30.0,0,0,1,0,1,Hong Kong
7308,Lee Wilkie,0,71.0,0,0,1,0,1,Scotland
7309,Lee Yi-woo,0,45.0,0,0,1,0,1,South Korea
7310,Lee Young-Moo,0,116.0,0,0,0,2,2,Iran
7311,Lee Young-jin,0,38.0,0,0,1,0,1,South Korea
7312,Lee Young-pyo,1,166.0,0,0,3,0,3,South Korea
7313,Leen Vente,1,216.0,0,0,2,1,3,Netherlands
7314,Lefter Küçükandonyadis,2,239.0,0,1,3,2,5,Turkey
7315,Lefteris Makris,0,89.0,0,0,0,1,1,Hungary
7316,Leger Djime,1,109.0,0,0,1,1,2,Chad
7317,Lehlohonolo Majoro,0,62.0,0,0,1,0,1,South Africa
7318,Lehlohonolo Seema,1,90.0,0,0,1,0,1,Lesotho
7319,Lehlomela Ramabele,0,82.0,0,0,1,0,1,Lesotho
7320,Lei Clijsters,1,15.0,0,0,1,0,1,Belgium
7321,Leif Engqvist,0,89.0,0,0,1,0,1,Sweden
7322,Leif Eriksson,0,208.0,0,0,3,1,4,Sweden
7323,Leigh Griffiths,0,258.0,0,0,3,1,4,Scotland
7324,Leighton Baines,0,83.0,0,0,0,1,1,Moldova
7325,Leighton James,0,375.0,0,2,5,2,7,Wales
7326,Lejuan Simmons,1,60.0,0,0,1,0,1,Bermuda
7327,Leng Makara,1,70.0,1,0,1,0,1,Syria
7328,Lennart Bunke,0,192.0,0,0,4,0,4,Sweden
7329,Lennart Skoglund,0,32.0,0,0,1,0,1,Sweden
7330,Leo Houtsonen,0,61.0,0,0,1,0,1,Finland
7331,Leo Lainer,0,44.0,0,0,0,1,1,Northern Ireland
7332,Leo Leslie,0,81.0,0,0,1,0,1,Solomon Islands
7333,Leocadio Marín,3,304.0,0,0,2,4,6,Paraguay
7334,Leon Andreasen,0,33.0,0,0,1,1,2,Denmark
7335,Leon Bailey,0,39.0,0,1,1,0,1,Jamaica
7336,Leon Balogun,1,29.0,0,0,0,1,1,Central African Republic
7337,Leon Cort,0,81.0,0,0,1,0,1,Guyana
7338,Leon Goretzka,3,458.0,0,0,11,1,12,Australia
7339,Leon Goua G'Bize,0,92.0,0,0,1,1,2,Ivory Coast
7340,Leon Mupenzi,0,48.0,0,0,1,0,1,Rwanda
7341,Leonard Farrugia,0,124.0,0,0,2,0,2,Malta
7342,Leonard Piątek,0,23.0,0,0,2,0,2,Poland
7343,Leonard Wells,0,89.0,0,0,1,0,1,Honduras
7344,Leonardo Araújo,4,207.0,0,0,4,0,4,Brazil
7345,Leonardo Astrada,1,70.0,0,0,1,0,1,Argentina
7346,Leonardo Bonucci,1,303.0,0,1,0,5,5,Estonia
7347,Leonardo Palacios,1,49.0,0,0,0,1,1,Argentina
7348,Leonardo Pavoletti,0,76.0,0,0,1,0,1,Italy
7349,Leonardo Rodríguez,1,87.0,0,0,0,2,2,Saudi Arabia
7350,Leonardo Véliz,0,31.0,0,0,1,0,1,Chile
7351,Leone Vurukania,2,90.0,0,0,0,2,2,Tonga
7352,Leonel Duarte,0,85.0,0,0,0,1,1,Antigua and Barbuda
7353,Leonel Hernández,0,258.0,0,1,4,1,5,Costa Rica
7354,Leonel Justiniano,1,82.0,0,0,1,0,1,Bolivia
7355,Leonel Moreira,0,66.0,1,0,1,0,1,United States
7356,Leonel Saint-Preux,0,28.0,0,0,0,1,1,Suriname
7357,Leonel Sánchez,5,488.0,0,3,9,2,11,Brazil
7358,Leonel Vielma,0,72.0,0,0,0,1,1,Argentina
7359,Leong Ka Hang,0,111.0,0,1,2,0,2,Macau
7360,Leonhard Kass,0,47.0,0,0,0,1,1,Sweden
7361,Leonid Buryak,1,56.0,0,0,2,0,2,Russia
7362,Leonid Koshelev,0,93.0,0,0,1,1,2,Taiwan
7363,Leonid Kovel,0,86.0,0,0,1,0,1,Belarus
7364,Leonidas Flores,1,17.0,0,0,1,0,1,Costa Rica
7365,Leonson Lewis,1,179.0,0,0,2,1,3,United States
7366,Leopold Grausam,0,193.0,0,0,2,1,3,Austria
7367,Leopold Kielholz,3,68.0,0,0,0,3,3,Netherlands
7368,Leopoldo Luque,0,406.0,0,0,5,3,8,Venezuela
7369,Leopoldo Quiñónez,1,32.0,0,0,0,1,1,Ecuador
7370,Leotis Boateng,0,11.0,0,0,1,0,1,Nigeria
7371,Leovegildo Lins da Gama Júnior,1,159.0,0,0,1,1,2,Brazil
7372,Leroy Fer,1,77.0,0,0,1,0,1,Netherlands
7373,Leroy Francis,0,116.0,0,0,2,0,2,Saint Kitts and Nevis
7374,Leroy Sané,1,320.0,0,0,3,4,7,Netherlands
7375,Les Ferdinand,1,166.0,0,0,2,2,4,England
7376,Les Scheinflug,2,85.0,0,1,1,1,2,North Korea
7377,Leslie Santos,0,60.0,0,1,1,0,1,Hong Kong
7378,Lesly St. Fleur,0,379.0,1,0,7,0,7,Bahamas
7379,Lester Hayes III,0,90.0,0,0,1,0,1,Puerto Rico
7380,Lester Moré,3,704.0,0,1,7,7,14,Cayman Islands
7381,Lester Peltier,0,193.0,0,0,4,0,4,Trinidad and Tobago
7382,Leszek Lipka,0,75.0,0,0,0,1,1,Malta
7383,Levan Kenia,1,90.0,0,0,1,0,1,Georgia
7384,Levan Kobiashvili,0,565.0,0,3,3,5,8,Hungary
7385,Levan Mchedlidze,0,16.0,0,0,1,0,1,Georgia
7386,Levi García,1,160.0,0,0,1,2,3,Saint Vincent and the Grenadines
7387,Levon Hayrapetyan,0,22.0,1,0,1,0,1,Serbia
7388,Lexa Bibi,2,99.0,0,0,1,1,2,Vanuatu
7389,Leônidas,1,55.0,0,0,1,0,1,Brazil
7390,Leônidas da Silva,7,439.0,0,0,7,0,7,Brazil
7391,Li Bing,2,396.0,0,0,3,4,7,Saudi Arabia
7392,Li Chang-Ha,2,43.0,0,0,2,0,2,North Korea
7393,Li Dong-woon,1,22.0,0,0,1,0,1,North Korea
7394,Li Fubao,1,7.0,0,0,0,1,1,North Korea
7395,Li Huan-wen,1,45.0,0,0,0,1,1,Israel
7396,Li Huayun,1,108.0,0,0,0,1,1,Kuwait
7397,Li Hui,1,84.0,0,0,3,0,3,China PR
7398,Li Jinyu,0,413.0,0,0,5,3,8,China PR
7399,Li Kwok Keung,1,14.0,0,0,1,0,1,Hong Kong
7400,Li Ming,2,147.0,0,0,5,0,5,China PR
7401,Li Weifeng,0,517.0,0,0,5,2,7,China PR
7402,Li Xiao,0,70.0,0,0,0,1,1,Japan
7403,Li Xiaopeng,0,144.0,0,0,3,0,3,China PR
7404,Li Yi,0,80.0,0,0,1,0,1,China PR
7405,Li Yong-Man,0,3.0,0,0,0,1,1,Hong Kong
7406,Li Yong-Sob,2,66.0,0,0,1,2,3,North Korea
7407,Liam Brady,0,296.0,0,2,4,1,5,Republic of Ireland
7408,Liam O'Kane,0,68.0,0,0,0,1,1,Portugal
7409,Liam Tuohy,0,71.0,0,0,2,1,3,Republic of Ireland
7410,Liam Walker,1,33.0,0,0,2,0,2,Gibraltar
7411,Liberato Cacace,1,71.0,0,0,1,0,1,New Zealand
7412,Libor Kozák,0,19.0,0,0,0,1,1,Italy
7413,Libor Sionko,1,113.0,0,0,2,3,5,Slovakia
7414,Ligorio López,0,113.0,0,0,1,1,2,Mexico
7415,Lilian Laslandes,0,74.0,0,0,0,1,1,Armenia
7416,Lilian Thuram,0,117.0,0,0,2,0,2,France
7417,Lim Teong Kim,0,19.0,0,0,0,1,1,Singapore
7418,Limberg Gutiérrez,1,144.0,0,0,1,2,3,Bolivia
7419,Limbikani Mzava,1,51.0,1,0,1,0,1,Mozambique
7420,Lin Lefeng,1,81.0,0,0,0,2,2,India
7421,Lin Qiang,0,51.0,0,0,0,1,1,Macau
7422,Lin Wen Han,1,59.0,0,0,0,1,1,Bangladesh
7423,Lincoln Zvasiya,0,81.0,0,0,1,0,1,Zimbabwe
7424,Linnal Wilson,0,67.0,0,0,1,0,1,Jamaica
7425,Lino Nessi,1,10.0,0,0,1,0,1,Paraguay
7426,Linos Chalwe,0,26.0,0,0,1,0,1,Zambia
7427,Linos Makwaza,1,40.0,0,0,1,0,1,Zambia
7428,Liombi Essende,1,72.0,0,0,0,1,1,Liberia
7429,Lionel Messi,25,2475.0,0,14,39,15,54,Argentina
7430,Lior Refaelov,0,164.0,0,0,0,3,3,Malta
7431,Lisi Leututu,1,8.0,1,0,0,1,1,American Samoa
7432,Listner Pierre-Louis,0,44.0,0,0,1,0,1,Haiti
7433,Lito,0,39.0,0,0,1,0,1,Cape Verde
7434,Litsepe Marabe,0,88.0,0,0,1,0,1,Lesotho
7435,Liu Binbin,1,5.0,0,0,1,0,1,China PR
7436,Liu Haiguang,4,259.0,0,0,3,2,5,China PR
7437,Liu Jian,1,77.0,0,0,1,1,2,China PR
7438,Liuai Duguga,0,89.0,0,0,1,0,1,Fiji
7439,Liviu Ciobotariu,0,66.0,0,0,0,1,1,Slovakia
7440,Lizardo Garrido,0,85.0,1,0,1,0,1,Paraguay
7441,Liédson,1,241.0,0,0,2,1,3,Denmark
7442,Ljubinko Drulović,1,108.0,0,0,1,1,2,North Macedonia
7443,Ljubomir Radanović,0,95.0,0,0,1,1,2,Yugoslavia
7444,Ljupčo Markovski,0,69.0,0,0,0,1,1,Armenia
7445,Llewellyn Riley,0,256.0,0,0,3,2,5,Grenada
7446,Lo Chih Tsong,0,71.0,1,0,1,0,1,New Zealand
7447,Lo Hung-Hoi,1,53.0,0,0,1,0,1,Hong Kong
7448,Lo Kwan Yee,0,32.0,0,0,2,0,2,Hong Kong
7449,Loay Taleb,1,60.0,0,0,0,1,1,Maldives
7450,Locó,0,78.0,0,0,0,1,1,Benin
7451,Logan Rogerson,1,36.0,0,1,1,0,1,New Zealand
7452,Loh Wai Chi,1,15.0,0,0,0,1,1,India
7453,Lokenge Mungongo,0,166.0,0,0,0,2,2,Burkina Faso
7454,Lokoua Taufahema,4,244.0,0,0,0,5,5,Samoa
7455,Lomana LuaLua,1,76.0,0,0,0,2,2,Togo
7456,Lorenc Trashi,0,40.0,0,0,0,1,1,Moldova
7457,Lorenzo Fernández,3,93.0,0,0,0,3,3,Peru
7458,Lorenzo Gimenez,0,11.0,0,0,1,0,1,Paraguay
7459,Lorenzo Insigne,1,274.0,0,0,3,3,6,Italy
7460,Lorenzo Pellegrini,0,77.0,0,0,0,1,1,Armenia
7461,Lorenzo Staelens,0,268.0,0,2,4,2,6,Belgium
7462,Lorenzo Tehau,5,293.0,0,0,1,4,5,Samoa
7463,Lorgio Álvarez,0,57.0,0,0,0,1,1,Peru
7464,Loris Benito,0,75.0,0,0,0,1,1,Gibraltar
7465,Lorry Thomsen,1,45.0,0,0,0,1,1,Fiji
7466,Loten Dalai,0,89.0,0,0,0,1,1,Australia
7467,Lotfi Hsoumi,0,80.0,0,0,1,0,1,Tunisia
7468,Lotfi Rouissi,0,60.0,0,0,0,2,2,Benin
7469,Lothar Emmerich,1,39.0,0,0,1,0,1,Germany
7470,Lothar Matthäus,7,657.0,0,5,10,5,15,Czechoslovakia
7471,Lou Macari,0,18.0,0,0,0,1,1,Denmark
7472,Louis Camara,2,55.0,0,0,0,2,2,Ethiopia
7473,Louis Floch,0,30.0,0,0,1,0,1,France
7474,Louis Gomis Diop,0,2.0,0,0,1,0,1,Senegal
7475,Louis Pilot,0,143.0,0,0,3,1,4,Luxembourg
7476,Louis Saha,0,16.0,0,0,1,1,2,Georgia
7477,Louis Schaub,0,335.0,0,0,4,1,5,Austria
7478,Louis-Paul M'Fédé,2,234.0,0,1,4,0,4,Cameroon
7479,Lovro Majer,1,201.0,0,0,1,2,3,Malta
7480,Loïc Loval,1,33.0,0,0,0,1,1,Panama
7481,Loïc Négo,0,178.0,0,0,1,1,2,Hungary
7482,Loïc Rémy,0,120.0,0,0,2,0,2,France
7483,Lubambo Musonda,0,59.0,0,0,1,0,1,Zambia
7484,Luboš Kozel,0,26.0,0,0,1,0,1,Czech Republic
7485,Luboš Kubík,1,210.0,0,0,3,1,4,Czechoslovakia
7486,Luc Holtz,0,44.0,0,0,1,0,1,Luxembourg
7487,Luc Nilis,1,242.0,0,0,2,5,7,Armenia
7488,Luca Gobbi,0,27.0,1,0,0,1,1,San Marino
7489,Luca Toni,2,481.0,0,0,7,4,11,Italy
7490,Lucas Barrios,4,301.0,0,0,2,3,5,Paraguay
7491,Lucas Biglia,0,19.0,0,0,0,1,1,Colombia
7492,Lucas Cavallini,10,492.0,0,0,3,7,10,Mexico
7493,Lucas Lima,1,125.0,0,0,1,1,2,Argentina
7494,Lucas Neill,0,84.0,0,0,1,0,1,Australia
7495,Lucas Paquetá,1,303.0,0,0,4,2,6,Paraguay
7496,Lucas Pratto,0,79.0,0,0,1,1,2,Venezuela
7497,Lucas Radebe,2,64.0,0,0,1,1,2,Uruguay
7498,Lucho González,2,171.0,0,0,3,1,4,Argentina
7499,Luciano Djim,0,39.0,0,0,0,1,1,Zimbabwe
7500,Luciano Figueroa,6,516.0,0,0,4,5,9,Argentina
7501,Luciano Galletti,0,63.0,0,0,0,1,1,Bolivia
7502,Luciano Narsingh,0,161.0,0,0,1,1,2,Netherlands
7503,Luciano Vassallo,1,325.0,0,4,6,1,7,Israel
7504,Lucien Cossou,0,278.0,0,0,4,0,4,France
7505,Lucien Kassi-Kouadio,2,176.0,0,1,3,0,3,Ivory Coast
7506,Lucien Kouassi Kouame,0,17.0,0,0,1,0,1,Ivory Coast
7507,Lucien Laurent,1,19.0,0,0,1,0,1,France
7508,Lucien Mettomo,1,52.0,0,0,1,0,1,Cameroon
7509,Lucjan Brychczy,0,250.0,0,0,4,2,6,Poland
7510,Lucky Msiska,0,68.0,0,0,2,0,2,Zambia
7511,Ludo Coeck,1,106.0,0,0,3,0,3,Belgium
7512,Ludovic Giuly,0,206.0,0,0,2,1,3,France
7513,Ludovic Gotin,1,59.0,0,0,1,0,1,Guadeloupe
7514,Ludovic Magnin,0,158.0,1,0,2,0,2,Republic of Ireland
7515,Ludovic Sané,0,14.0,1,0,1,0,1,Ivory Coast
7516,Ludovico Avio,1,60.0,0,0,1,0,1,Argentina
7517,Ludwig Augustinsson,1,62.0,0,0,0,2,2,Mexico
7518,Luigi De Agostini,1,176.0,0,0,2,0,2,Italy
7519,Luigi Di Biagio,2,46.0,0,0,2,0,2,Italy
7520,Luigi Pieroni,0,52.0,0,0,0,1,1,Azerbaijan
7521,Luigi Riva,0,407.0,0,0,4,3,7,Wales
7522,Luis Advíncula,0,89.0,0,0,0,1,1,Ecuador
7523,Luis Alfonso Rodríguez,1,26.0,0,0,1,0,1,Mexico
7524,Luis Alfredo Ramírez,0,83.0,0,0,0,1,1,Nicaragua
7525,Luis Anaya,0,229.0,0,0,1,2,3,El Salvador
7526,Luis Antonio Jiménez,0,91.0,0,0,2,0,2,Chile
7527,Luis Aragonés,0,75.0,0,0,1,0,1,Spain
7528,Luis Araneda,0,127.0,0,0,2,0,2,Chile
7529,Luis Artime,8,625.0,0,0,9,2,11,Argentina
7530,Luis Capurro,1,6.0,0,1,1,0,1,Ecuador
7531,Luis Carlos Perea,1,88.0,0,0,1,0,1,Colombia
7532,Luis Casquez,0,77.0,0,0,1,0,1,Dominican Republic
7533,Luis Chávez,1,52.0,0,0,0,1,1,Saudi Arabia
7534,Luis Copete,0,64.0,0,0,2,0,2,Nicaragua
7535,Luis Cristaldo,0,151.0,0,0,1,3,4,Venezuela
7536,Luis Cruz,1,59.0,1,0,1,0,1,Austria
7537,Luis Cruzado,0,40.0,0,0,1,0,1,Peru
7538,Luis Cubilla,2,169.0,0,0,1,4,5,Bolivia
7539,Luis Diego Arnáez,0,166.0,0,0,2,1,3,Costa Rica
7540,Luis Díaz,3,395.0,0,0,2,5,7,Peru
7541,Luis Enrique,2,705.0,0,0,9,3,12,Spain
7542,Luis Enrique Cálix,3,119.0,0,0,0,3,3,Canada
7543,Luis Ernesto Castro,0,137.0,0,0,3,0,3,Uruguay
7544,Luis Ernesto Pérez,0,267.0,0,0,5,0,5,Mexico
7545,Luis Espel,1,89.0,0,0,0,1,1,Trinidad and Tobago
7546,Luis Espinal,1,75.0,0,0,0,1,1,Anguilla
7547,Luis Fernández,1,164.0,0,1,3,1,4,France
7548,Luis Flores,0,107.0,0,0,3,1,4,Mexico
7549,Luis Fretes,3,209.0,0,0,0,3,3,Chile
7550,Luis Fuentes,0,42.0,0,0,2,0,2,Chile
7551,Luis Gabriel Rey,0,60.0,0,0,2,1,3,Colombia
7552,Luis Galeano,0,60.0,0,0,1,1,2,Nicaragua
7553,Luis García,1,244.0,1,0,5,0,5,Argentina
7554,Luis García Postigo,9,1035.0,0,2,12,6,18,Mexico
7555,Luis González Rubio,2,5.0,0,0,1,1,2,Colombia
7556,Luis Guadalupe,0,90.0,1,0,1,0,1,Argentina
7557,Luis Guzmán,3,214.0,0,0,0,3,3,Colombia
7558,Luis Guzmán Gonzales,1,62.0,0,0,0,1,1,Ecuador
7559,Luis Gómez,0,90.0,0,0,0,1,1,Bolivia
7560,Luis Henríquez,0,81.0,0,0,1,1,2,Panama
7561,Luis Hernán Álvarez,0,25.0,0,0,0,1,1,Argentina
7562,Luis Hernández,18,1138.0,0,3,9,12,21,Mexico
7563,Luis Luna,0,56.0,0,0,2,0,2,Mexico
7564,Luis Mago,0,9.0,0,0,1,0,1,Venezuela
7565,Luis Manuel Seijas,0,82.0,0,0,1,0,1,Venezuela
7566,Luis Martén,1,177.0,0,0,2,1,3,Cuba
7567,Luis Martínez,0,111.0,0,0,2,0,2,Guatemala
7568,Luis Marín Murillo,1,174.0,0,1,2,1,3,Costa Rica
7569,Luis Mendez,1,61.0,0,0,1,0,1,Belize
7570,Luis Mendoza,1,54.0,0,0,1,1,2,Chile
7571,Luis Mendoza Benedetto,0,55.0,0,0,1,0,1,Venezuela
7572,Luis Meseguer,1,34.0,0,0,0,1,1,South Sudan
7573,Luis Miguel Noriega,1,45.0,0,1,0,1,1,Nicaragua
7574,Luis Miguel Salvador,0,232.0,0,0,5,0,5,Mexico
7575,Luis Molowny,0,65.0,0,0,1,0,1,Spain
7576,Luis Montes,2,60.0,0,0,0,2,2,Martinique
7577,Luis Monti,2,101.0,0,0,2,0,2,Argentina
7578,Luis Monzón,4,220.0,0,1,4,0,4,Paraguay
7579,Luis Morales,0,51.0,0,0,1,0,1,Venezuela
7580,Luis Muriel,0,122.0,0,1,3,0,3,Colombia
7581,Luis Navarrete,0,51.0,0,0,1,0,1,Peru
7582,Luis Nery Caballero,0,15.0,0,0,0,1,1,Ecuador
7583,Luis Norberto Campero,3,66.0,0,0,0,3,3,Brazil
7584,Luis Omar Sanchez,1,43.0,0,0,0,1,1,Montserrat
7585,Luis Paradela,1,33.0,0,0,1,0,1,Cuba
7586,Luis Quiñónez,1,30.0,0,0,1,0,1,Colombia
7587,Luis Ramallo,0,260.0,0,0,2,5,7,Venezuela
7588,Luis Ramírez Zapata,1,64.0,0,0,0,1,1,Hungary
7589,Luis Regueiro,0,165.0,0,0,2,1,3,Spain
7590,Luis Reyna,0,59.0,0,0,0,1,1,Argentina
7591,Luis Santamaría,0,77.0,0,0,0,1,1,Saint Vincent and the Grenadines
7592,Luis Suárez,16,2414.0,0,9,28,18,46,Uruguay
7593,Luis Suárez Miramontes,0,141.0,0,0,1,3,4,Spain
7594,Luis Tejada,10,1292.0,0,1,15,9,24,Panama
7595,Luis Vargas Peña,1,80.0,0,0,0,2,2,Chile
7596,Luis Zavalla,0,121.0,0,0,0,2,2,Venezuela
7597,Luis de Souza,1,75.0,0,0,1,0,1,Peru
7598,Luis de la Fuente,0,197.0,0,0,4,0,4,Mexico
7599,Luis del Sol,0,80.0,0,0,0,1,1,Morocco
7600,Luisão,1,68.0,0,0,0,2,2,Argentina
7601,Luizão,0,31.0,0,0,2,0,2,Brazil
7602,Luk Man Wai,1,51.0,0,0,1,0,1,Taiwan
7603,Luka Jović,0,125.0,0,0,2,0,2,Serbia
7604,Luka Menalo,0,155.0,0,0,2,0,2,Bosnia and Herzegovina
7605,Luka Milivojević,0,11.0,0,0,0,1,1,Austria
7606,Luka Modrić,3,891.0,0,6,12,6,18,Croatia
7607,Luka Đorđević,0,24.0,0,0,0,1,1,San Marino
7608,Lukas Podolski,6,1285.0,0,0,18,11,29,Germany
7609,Lukas Spalvis,0,90.0,0,0,1,0,1,Lithuania
7610,Luke Adams,1,80.0,0,0,1,0,1,New Zealand
7611,Luke Dimech,0,73.0,0,0,1,0,1,Malta
7612,Luke Gambin,0,16.0,0,0,0,1,1,Slovakia
7613,Luke Ivor,0,17.0,0,0,0,1,1,Bermuda
7614,Luke Jukulile,0,87.0,0,0,1,0,1,Zimbabwe
7615,Luke Shaw,0,2.0,0,0,1,0,1,England
7616,Luke Wilkshire,0,147.0,0,2,1,1,2,Saudi Arabia
7617,Luki Gosche,0,55.0,0,0,2,0,2,Samoa
7618,Lukáš Haraslín,0,45.0,0,0,0,1,1,Croatia
7619,Lukáš Hrádecký,1,74.0,1,0,0,1,1,Finland
7620,Lukáš Masopust,0,58.0,0,0,0,1,1,Montenegro
7621,Lukáš Provod,0,50.0,0,0,1,0,1,Czech Republic
7622,Lungisani Ndlela,2,109.0,0,0,1,1,2,Jamaica
7623,Lupo Quiñónez,0,44.0,0,0,0,1,1,Argentina
7624,Luther Blissett,0,192.0,0,0,3,0,3,England
7625,Luton Shelton,2,423.0,0,2,9,2,11,Guatemala
7626,Lutz Lindemann,0,108.0,0,0,1,1,2,German DR
7627,Luuk de Jong,0,380.0,0,0,2,3,5,Finland
7628,Luz Gastelbondo,1,27.0,0,0,0,1,1,Uruguay
7629,Luís Fabiano,10,873.0,0,1,10,10,20,Chile
7630,Luís Fernandes,0,83.0,0,0,1,0,1,Lebanon
7631,Luís Figo,2,780.0,0,1,9,8,17,Latvia
7632,Luís Henrique,1,144.0,0,0,1,1,2,Brazil
7633,Luís Leal,0,86.0,0,0,1,0,1,São Tomé and Príncipe
7634,Luís Neto,1,54.0,1,0,0,1,1,Portugal
7635,Luís Oliveira,0,186.0,0,0,3,3,6,Belgium
7636,Luís Roberto Alves,3,1024.0,0,1,18,3,21,Mexico
7637,Luís Trochillo,1,88.0,0,0,0,1,1,Argentina
7638,Luíz Mesquita de Oliveira,4,168.0,0,0,4,0,4,Brazil
7639,Lwata Mpia,0,78.0,0,0,1,0,1,DR Congo
7640,Lyle Taylor,3,318.0,0,2,1,5,6,Curaçao
7641,Lyndon Dykes,0,187.0,0,1,2,2,4,Scotland
7642,Lyndon Hooper,0,54.0,0,0,0,1,1,Australia
7643,Lyndon Joseph,0,90.0,1,0,0,1,1,Grenada
7644,Lys Mouithys,0,80.0,0,0,0,2,2,Mali
7645,Lyuboslav Penev,1,524.0,1,0,7,2,9,San Marino
7646,Lárus Guðmundsson,0,21.0,0,0,1,0,1,Iceland
7647,Lárus Sigurðsson,0,66.0,0,0,0,1,1,Ukraine
7648,László Branikovits,0,88.0,0,0,2,0,2,Hungary
7649,László Bálint,1,211.0,1,0,3,2,5,Hungary
7650,László Bölöni,1,293.0,0,0,5,1,6,Romania
7651,László Dajka,1,73.0,1,0,1,0,1,Russia
7652,László Disztl,0,16.0,0,0,1,0,1,Hungary
7653,László Fazekas,2,369.0,0,0,6,1,7,Czechoslovakia
7654,László Fekete,0,53.0,0,0,2,0,2,Hungary
7655,László Kiss,3,554.0,0,0,6,2,8,Norway
7656,László Klausz,0,80.0,0,0,3,0,3,Hungary
7657,László Kleinheisler,0,84.0,0,0,0,2,2,Norway
7658,László Nagy,0,188.0,0,0,1,3,4,Norway
7659,László Pusztai,0,111.0,0,0,2,1,3,Hungary
7660,László Szokolai,0,143.0,0,0,2,0,2,Hungary
7661,László Tieber,0,74.0,0,0,0,1,1,Finland
7662,Lázaro Darcourt,3,361.0,0,0,3,3,6,Cayman Islands
7663,Lázaro Oliveira,1,46.0,0,0,1,0,1,Angola
7664,Lázár Szentes,1,131.0,0,0,2,0,2,Hungary
7665,Léger Djimrangar,1,92.0,0,0,1,1,2,Chad
7666,Léider Preciado,1,82.0,0,0,1,0,1,Colombia
7667,Léon Dolmans,0,90.0,0,2,1,1,2,Norway
7668,Léon Glovacki,0,67.0,0,0,0,2,2,Luxembourg
7669,Léon Letsch,0,58.0,0,0,0,1,1,Netherlands
7670,Léon Mungamuni,1,188.0,0,0,1,2,3,Ethiopia
7671,Léon Semmeling,0,49.0,0,0,1,0,1,Belgium
7672,Léopold Anoul,3,194.0,0,0,3,2,5,Finland
7673,Léster Blanco,1,215.0,0,0,1,3,4,El Salvador
7674,Lê Công Vinh,0,521.0,0,1,7,4,11,Vietnam
7675,Lê Hữu Đức,2,178.0,0,0,0,3,3,Hong Kong
7676,Líder Paz,0,96.0,0,0,2,1,3,Bolivia
7677,Lúcio,1,84.0,0,0,0,1,1,United States
7678,Lư Đình Tuấn,1,14.0,0,0,1,0,1,Vietnam
7679,M'Bala Nzola,0,35.0,0,1,1,0,1,Angola
7680,M'Baye Niang,1,60.0,0,0,0,1,1,Poland
7681,M'Peti Suzeti,0,1.0,0,0,1,0,1,DR Congo
7682,Ma Jung-U,2,116.0,0,0,2,0,2,North Korea
7683,Ma Lin,3,446.0,0,0,1,7,8,Kuwait
7684,Ma Mingyu,1,195.0,0,0,3,2,5,Syria
7685,MaNicolás Oliveratias Almeyda,0,45.0,0,0,0,1,1,Brazil
7686,Mabululu,0,48.0,0,0,1,0,1,Angola
7687,Macchambes Younga-Mouhani,0,184.0,0,0,3,0,3,Congo
7688,Macha Gatien,1,88.0,0,0,1,0,1,Tahiti
7689,Maciej Żurawski,0,447.0,0,1,5,3,8,Northern Ireland
7690,Maciu Dunadamu,1,190.0,0,0,1,2,3,Fiji
7691,Macnelly Torres,0,128.0,0,0,3,0,3,Colombia
7692,Madjid Bougherra,1,160.0,0,0,1,2,3,Zambia
7693,Mael Kaudre,0,83.0,0,0,0,1,1,Fiji
7694,Magdi Abdelghani,2,159.0,0,2,0,2,2,Algeria
7695,Magid Mohamed,1,156.0,0,0,2,0,2,Qatar
7696,Magnús Bergs,0,110.0,0,0,1,1,2,Czechoslovakia
7697,Magomed Ozdoyev,0,83.0,0,0,1,1,2,Russia
7698,Mahad Khaireh,0,39.0,0,0,1,0,1,Djibouti
7699,Mahamadou Diarra,2,202.0,0,0,2,1,3,Burkina Faso
7700,Mahamadou N'Diaye,1,108.0,0,0,2,0,2,Mali
7701,Mahamane Cissé,0,115.0,0,0,3,0,3,Niger
7702,Mahamat Labbo,0,63.0,0,0,1,1,2,Chad
7703,Mahamoudou Kéré,0,116.0,0,0,3,0,3,Burkina Faso
7704,Maharan Radi,0,4.0,0,0,0,1,1,Luxembourg
7705,Mahboub Juma'a,0,69.0,0,0,2,0,2,Kuwait
7706,Mahdi Houssein Mahabeh,0,45.0,0,1,1,0,1,Djibouti
7707,Mahdi Kadhim,1,35.0,0,0,0,1,1,Yemen
7708,Mahdi Kamel,2,139.0,0,0,2,0,2,Iraq
7709,Mahdi Karim,0,251.0,0,0,0,4,4,Pakistan
7710,Maheanum Gatien,2,131.0,0,0,2,0,2,Tahiti
7711,Maher Al Sayed,0,162.0,0,1,2,0,2,Syria
7712,Maher Hammam,1,57.0,0,0,2,0,2,Egypt
7713,Maher Kanzari,0,30.0,0,0,1,0,1,Tunisia
7714,Maher Malki,0,89.0,0,0,1,0,1,Syria
7715,Maher Sabra,0,95.0,1,0,2,0,2,South Korea
7716,Mahfood Sultan Al Araimi,2,117.0,0,0,0,2,2,Nepal
7717,Mahir Emreli,0,128.0,0,0,1,1,2,Azerbaijan
7718,Mahir Shukurov,0,152.0,0,1,2,0,2,Azerbaijan
7719,Mahlon Houkarawa,1,82.0,0,0,0,1,1,Fiji
7720,Mahmadu Alphajor Bah,0,87.0,0,0,1,0,1,Sierra Leone
7721,Mahmood Abdulrahman,0,295.0,0,1,4,1,5,Bahrain
7722,Mahmood Al-Ajmi,0,45.0,0,0,1,0,1,Bahrain
7723,Mahmoud Al Baher,1,64.0,0,0,1,0,1,Syria
7724,Mahmoud Al-Jahani,0,22.0,0,0,1,0,1,Libya
7725,Mahmoud Al-Mawas,9,726.0,0,3,5,7,12,Cambodia
7726,Mahmoud Al-Sayed,0,101.0,0,0,2,0,2,Syria
7727,Mahmoud Baquir Younes,0,89.0,1,0,0,1,1,Lebanon
7728,Mahmoud Chahoud,0,63.0,0,0,0,1,1,Maldives
7729,Mahmoud El Ali,0,213.0,0,0,2,3,5,Lebanon
7730,Mahmoud El Khatib,2,307.0,0,0,5,3,8,Egypt
7731,Mahmoud El-Gohary,3,144.0,0,0,3,0,3,Egypt
7732,Mahmoud Fathalla,0,55.0,0,0,1,0,1,Egypt
7733,Mahmoud Guendouz,0,34.0,0,0,1,0,1,Algeria
7734,Mahmoud Khamees,0,66.0,0,0,1,1,2,Lebanon
7735,Mahmoud Mokhtar El-Tetsh,2,126.0,0,0,3,2,5,Egypt
7736,Mahmoud Shelbaieh,2,147.0,0,0,2,2,4,Taiwan
7737,Mahmoud Soufi,1,448.0,0,0,8,0,8,Qatar
7738,Mahmoud Yaseen Al-Soufi,1,367.0,0,0,5,1,6,Qatar
7739,Mahmud Qurbanov,0,63.0,0,0,0,1,1,Finland
7740,Mai Aih Naing,0,88.0,0,0,1,0,1,Myanmar
7741,Mai Chao,3,354.0,0,2,3,2,5,South Korea
7742,Maicon Sisenando,4,146.0,0,0,2,2,4,Brazil
7743,Maik Galakos,0,206.0,0,0,3,0,3,Greece
7744,Maikel Reyes,3,213.0,0,0,1,2,3,Guatemala
7745,Majdi Samir,0,67.0,0,0,1,0,1,Oman
7746,Majdi Shaaban Samir,0,266.0,0,0,2,2,4,Oman
7747,Majdi Siddiq,0,37.0,0,0,1,0,1,Qatar
7748,Majed Abdullah,4,516.0,0,0,9,2,11,Saudi Arabia
7749,Majid Musisi,0,73.0,0,0,1,0,1,Uganda
7750,Majid Namjoo-Motlagh,1,15.0,0,1,0,1,1,Taiwan
7751,Mak King-Fun,0,217.0,0,0,4,0,4,Hong Kong
7752,Mak Tian-fu,1,37.0,0,0,0,1,1,Hong Kong
7753,Makoto Hasebe,1,35.0,0,0,0,1,1,Syria
7754,Maksim Bardachov,0,23.0,0,0,1,0,1,Belarus
7755,Maksim Buznikin,0,19.0,0,0,1,0,1,Russia
7756,Maksim Igorevich Shevchenko,0,116.0,0,0,2,0,2,Kazakhstan
7757,Maksim Medvedev,1,47.0,1,0,2,0,2,Azerbaijan
7758,Maksim Nizovtsev,0,62.0,0,0,0,1,1,Albania
7759,Maksim Romaschenko,0,365.0,0,1,3,4,7,Belarus
7760,Maksim Shatskikh,3,861.0,0,1,13,6,19,Uzbekistan
7761,Maksim Skavysh,0,90.0,0,0,0,1,1,Estonia
7762,Maksim Smirnov,0,147.0,0,0,1,1,2,Scotland
7763,Maksim Valadzko,0,55.0,0,0,1,0,1,Belarus
7764,Maksim Zhalmagambetov,0,53.0,0,0,1,0,1,Kazakhstan
7765,Maksym Kalynychenko,1,173.0,0,0,2,1,3,Saudi Arabia
7766,Mal Donaghy,0,15.0,0,0,0,1,1,Albania
7767,Mal Griffiths,0,80.0,0,0,1,0,1,Wales
7768,Malcolm Allen,0,11.0,0,0,0,1,1,Germany
7769,Malcolm Bland,0,180.0,0,0,2,0,2,New Zealand
7770,Malcolm Dunford,0,154.0,0,0,3,1,4,New Zealand
7771,Malcolm Macdonald,0,224.0,0,0,5,0,5,England
7772,Malek Mouath,2,309.0,0,0,3,2,5,Japan
7773,Malick Evouna,1,74.0,0,0,1,1,2,Burkina Faso
7774,Malik Awab,0,36.0,0,0,1,0,1,Singapore
7775,Malik Jabir,1,100.0,0,0,1,0,1,Ghana
7776,Malkhaz Asatiani,0,242.0,1,0,3,2,5,Georgia
7777,Mama Baldé,0,82.0,0,0,0,1,1,Sudan
7778,Mama Ouattara,0,104.0,0,0,1,1,2,Sierra Leone
7779,Mamadaou Koïta,1,52.0,0,0,0,1,1,Nigeria
7780,Mamadou Aliou Keita,3,162.0,0,0,2,3,5,Ethiopia
7781,Mamadou Bagayoko,1,103.0,0,0,2,0,2,Mali
7782,Mamadou Bah,2,216.0,0,0,2,1,3,Guinea
7783,Mamadou Diallo,1,241.0,0,0,3,2,5,Cameroon
7784,Mamadou Diarra,0,75.0,0,0,1,0,1,Senegal
7785,Mamadou Kané,0,31.0,0,0,0,1,1,Morocco
7786,Mamadou Niang,3,185.0,0,0,3,2,5,Senegal
7787,Mamadou Niass,0,69.0,0,0,1,0,1,Mauritania
7788,Mamadou Sakho,0,94.0,0,0,2,0,2,France
7789,Mamadou Samassa,2,171.0,0,1,2,3,5,Benin
7790,Mamadou Tall,0,54.0,1,0,0,1,1,Burkina Faso
7791,Mamadou Zongo,0,329.0,0,0,5,4,9,Kenya
7792,Mamane Ali,0,82.0,0,0,0,1,1,Togo
7793,Mamar Mamouni,1,13.0,0,0,1,0,1,Algeria
7794,Mame Biram Diouf,1,211.0,0,0,1,2,3,Ghana
7795,Mamedaly Karadanov,0,159.0,0,0,1,1,2,Cambodia
7796,Mamun Joarder,3,170.0,0,0,2,1,3,Thailand
7797,Mandla Masango,1,17.0,0,0,1,0,1,South Africa
7798,Maneca,0,85.0,0,0,1,0,1,Brazil
7799,Manfred Kaiser,0,57.0,0,0,0,1,1,Wales
7800,Manfred Kaltz,0,220.0,0,2,3,3,6,Germany
7801,Manfred Linzmaier,0,115.0,0,0,2,0,2,Austria
7802,Manfred Ritschel,0,75.0,0,1,0,1,1,Bulgaria
7803,Manfred Zsak,0,62.0,0,0,1,0,1,Austria
7804,Mani Stenter,1,68.0,0,0,0,1,1,Samoa
7805,Maniche,2,196.0,0,0,5,1,6,Portugal
7806,Maninho,0,69.0,0,0,0,1,1,Zimbabwe
7807,Manjrekar James,0,35.0,0,0,0,1,1,Honduras
7808,Manny Rodríguez,0,90.0,0,0,1,0,1,Dominican Republic
7809,Manoa Masi,2,62.0,0,0,0,2,2,Samoa
7810,Manoel Alencar Monte,0,23.0,0,0,0,1,1,Argentina
7811,Manolo,0,294.0,0,0,4,1,5,Spain
7812,Manolo Gabbiadini,0,90.0,0,0,1,0,1,Italy
7813,Manolom Phomsouvanh,0,71.0,0,0,0,2,2,Cambodia
7814,Manor Solomon,0,62.0,0,0,1,1,2,Moldova
7815,Manrique Quesada,0,117.0,0,0,2,0,2,Costa Rica
7816,Mansour Al-Mousa,1,47.0,0,0,1,0,1,Saudi Arabia
7817,Mansour Al-Muainea,0,40.0,0,0,1,0,1,Saudi Arabia
7818,Mansour Basha Mohamed,1,62.0,0,0,1,0,1,Kuwait
7819,Mansour Boutabout,0,309.0,0,0,3,2,5,Niger
7820,Mansour Muftah,8,785.0,0,0,11,1,12,Qatar
7821,Mansour Sulaiti,1,37.0,0,0,0,1,1,United Arab Emirates
7822,Mansurdzhon Hakimov,0,37.0,0,0,1,0,1,Tajikistan
7823,Mantas Savėnas,0,41.0,0,0,1,0,1,Lithuania
7824,Mantorras,0,134.0,0,0,1,1,2,Angola
7825,Manuchekhr Dzhalilov,1,475.0,0,1,7,3,10,Tajikistan
7826,Manucho,7,424.0,0,2,2,7,9,South Africa
7827,Manucho Diniz,0,66.0,1,0,1,0,1,South Africa
7828,Manuel Akanji,1,58.0,0,0,0,1,1,Portugal
7829,Manuel Alonso,1,132.0,0,0,3,0,3,Mexico
7830,Manuel Amoros,1,111.0,0,1,1,0,1,France
7831,Manuel Arancibia,1,84.0,0,0,2,0,2,Chile
7832,Manuel Arenas,2,110.0,0,0,1,1,2,Chile
7833,Manuel Asisclo Cordoba,0,15.0,0,0,1,0,1,Colombia
7834,Manuel Bobadilla,0,88.0,0,0,0,1,1,Panama
7835,Manuel Bravo Paredes,0,41.0,0,0,0,1,1,Brazil
7836,Manuel Cardoni,0,117.0,0,0,1,1,2,Malta
7837,Manuel Drago,1,47.0,0,0,0,1,1,Colombia
7838,Manuel Fernandes,0,496.0,0,0,5,3,8,Portugal
7839,Manuel Ferreira,0,117.0,0,0,3,2,5,Peru
7840,Manuel Fleitas Solich,1,73.0,0,1,1,1,2,Argentina
7841,Manuel Friedrich,0,87.0,0,0,0,1,1,San Marino
7842,Manuel Gavilán,1,17.0,0,0,0,1,1,Brazil
7843,Manuel Locatelli,0,161.0,0,0,2,1,3,Bulgaria
7844,Manuel Lugo,0,110.0,0,0,1,2,3,Paraguay
7845,Manuel Marani,0,86.0,0,0,1,0,1,San Marino
7846,Manuel Marengo,0,14.0,0,0,0,1,1,Venezuela
7847,Manuel Muñoz,1,229.0,0,0,5,0,5,Chile
7848,Manuel Negrete Arias,0,34.0,0,0,1,0,1,Mexico
7849,Manuel Ott,0,84.0,0,0,1,0,1,Philippines
7850,Manuel Pellegrina,1,83.0,0,0,1,0,1,Argentina
7851,Manuel Piñeiro,0,80.0,0,0,1,0,1,Chile
7852,Manuel Ramírez,0,134.0,0,0,3,0,3,Chile
7853,Manuel Rivera,0,72.0,0,0,2,0,2,Peru
7854,Manuel Rosas,3,159.0,1,1,1,2,3,Chile
7855,Manuel Rosas Arreola,1,89.0,1,1,0,3,3,Suriname
7856,Manuel Saavedra,0,61.0,0,0,1,0,1,Chile
7857,Manuel Salamanca,1,71.0,0,0,0,1,1,Bolivia
7858,Manuel Sanchís Hontiyuelo,0,64.0,0,0,1,0,1,Spain
7859,Manuel Sanchís Martínez,1,57.0,0,0,1,0,1,Spain
7860,Manuel Sarabia,0,129.0,0,0,1,1,2,Spain
7861,Manuel Schauls,0,41.0,1,0,1,0,1,Estonia
7862,Manuel Seoane,2,360.0,0,0,8,0,8,Argentina
7863,Manuel Vallejas,1,36.0,0,0,0,1,1,Ecuador
7864,Manuel Varela,1,79.0,1,0,1,0,1,Argentina
7865,Manuel Vasques,0,65.0,0,0,2,0,2,Portugal
7866,Manuel Velázquez,0,27.0,0,0,2,0,2,Spain
7867,Mao Jianqing,1,33.0,0,0,1,0,1,China PR
7868,Mao Yijun,0,87.0,0,0,0,1,1,Iran
7869,Maor Melikson,0,61.0,0,0,0,1,1,Luxembourg
7870,Maouhoub Ghazouani,1,87.0,0,0,0,2,2,Bulgaria
7871,Marat Bikmaev,1,201.0,0,0,2,2,4,Palestine
7872,Marat Izmailov,0,32.0,0,0,2,0,2,Russia
7873,Marc Berdoll,1,197.0,0,0,3,0,3,France
7874,Marc Bernaus,0,60.0,0,0,1,0,1,Andorra
7875,Marc Birsens,0,76.0,0,0,1,0,1,Luxembourg
7876,Marc Degryse,2,586.0,0,0,10,4,14,Belgium
7877,Marc Enoumba,0,37.0,0,0,1,0,1,Bolivia
7878,Marc Hottiger,0,126.0,0,0,4,0,4,Switzerland
7879,Marc Janko,0,906.0,0,1,10,10,20,Austria
7880,Marc Joseph,0,42.0,0,0,1,0,1,Antigua and Barbuda
7881,Marc Overmars,1,659.0,0,0,6,5,11,Netherlands
7882,Marc Pujol,0,195.0,0,3,3,1,4,Andorra
7883,Marc Rebés,0,26.0,0,0,1,0,1,Andorra
7884,Marc Rieper,1,136.0,0,0,1,1,2,Denmark
7885,Marc Vales,0,150.0,0,0,4,0,4,Andorra
7886,Marc Van Der Linden,4,428.0,0,0,2,5,7,Portugal
7887,Marc Wilmots,4,870.0,0,2,9,9,18,Belgium
7888,Marc Wilson,0,46.0,0,0,0,1,1,Faroe Islands
7889,Marc Zoro,1,54.0,0,0,1,0,1,Ivory Coast
7890,Marc-Vivien Foé,1,258.0,0,0,3,3,6,Ghana
7891,Marcel Artelesa,0,80.0,0,0,0,1,1,Luxembourg
7892,Marcel Bossi,0,18.0,1,0,1,0,1,England
7893,Marcel Christophe,1,51.0,0,0,0,1,1,Serbia
7894,Marcel Coraș,1,73.0,0,0,0,2,2,Germany
7895,Marcel Desailly,1,67.0,0,0,2,0,2,France
7896,Marcel Di Domenico,0,54.0,0,0,1,0,1,Luxembourg
7897,Marcel Halstenberg,0,48.0,0,0,0,1,1,Northern Ireland
7898,Marcel Kimemba Mbayo,0,12.0,0,0,1,0,1,DR Congo
7899,Marcel Koller,0,7.0,0,0,0,1,1,Turkey
7900,Marcel Langiller,1,40.0,0,0,1,0,1,France
7901,Marcel Paeschen,0,25.0,0,0,1,0,1,Belgium
7902,Marcel Răducanu,0,189.0,0,0,2,1,3,Yugoslavia
7903,Marcel Sabitzer,0,404.0,0,0,3,4,7,Montenegro
7904,Marcel de Jong,1,28.0,0,0,0,1,1,Costa Rica
7905,Marcelinho Paraíba,0,4.0,0,0,1,0,1,Brazil
7906,Marcelino Bernal,1,214.0,0,0,3,1,4,Mexico
7907,Marcelino Martínez,0,218.0,0,0,4,0,4,Spain
7908,Marcelino Núñez,0,77.0,0,0,0,1,1,Bolivia
7909,Marcell Jansen,1,117.0,0,0,2,1,3,Germany
7910,Marcelo,0,97.0,1,0,1,1,2,Brazil
7911,Marcelo Balboa,1,253.0,1,0,3,1,4,United States
7912,Marcelo Brozović,0,297.0,1,0,5,1,6,Croatia
7913,Marcelo Corrales,1,84.0,0,0,0,1,1,Ecuador
7914,Marcelo Gallardo,3,461.0,0,2,5,3,8,Argentina
7915,Marcelo Martins Moreno,3,1246.0,0,6,15,10,25,Venezuela
7916,Marcelo Nascimento da Costa,0,65.0,0,0,1,0,1,Bulgaria
7917,Marcelo Oliveira,1,89.0,0,0,1,0,1,Brazil
7918,Marcelo Otero,0,229.0,0,0,5,1,6,Uruguay
7919,Marcelo Salas,4,1177.0,0,1,13,9,22,Chile
7920,Marcelo Saralegui,3,227.0,0,0,5,1,6,Uruguay
7921,Marcelo Sosa,1,22.0,0,0,1,0,1,Uruguay
7922,Marcelo Zalayeta,3,478.0,0,0,5,2,7,Czech Republic
7923,Marcial Barrios,7,434.0,0,1,3,5,8,Chile
7924,Marcial Salazar,1,39.0,1,0,1,0,1,Colombia
7925,Marciano Leyman,0,68.0,0,0,0,1,1,Guyana
7926,Marcin Kuźba,0,144.0,0,0,2,0,2,Poland
7927,Marcin Żewłakow,1,313.0,0,0,3,1,4,Poland
7928,Marco Antonio Anariba,2,117.0,0,1,0,3,3,Jamaica
7929,Marco Antonio Mendoza,0,42.0,0,0,1,0,1,Honduras
7930,Marco Antonio Sandy,0,96.0,1,0,2,0,2,Bolivia
7931,Marco Antônio García Alves,1,57.0,0,0,1,1,2,Brazil
7932,Marco Asensio,1,21.0,0,0,1,0,1,Spain
7933,Marco Bode,1,232.0,0,0,1,4,5,Northern Ireland
7934,Marco Delvecchio,1,117.0,0,0,1,2,3,France
7935,Marco Di Vaio,0,64.0,0,0,1,0,1,Italy
7936,Marco Estrada,0,74.0,0,0,1,0,1,Chile
7937,Marco Etcheverry,2,542.0,0,1,9,2,11,Colombia
7938,Marco Fabián,4,212.0,0,1,2,2,4,Mexico
7939,Marco Garcés,1,38.0,0,0,1,0,1,Mexico
7940,Marco Ilaimaharitra,1,76.0,0,0,1,0,1,Madagascar
7941,Marco Materazzi,2,45.0,0,0,1,1,2,Czech Republic
7942,Marco Padalino,0,87.0,0,0,1,0,1,Switzerland
7943,Marco Pappa,1,200.0,0,0,3,1,4,Cuba
7944,Marco Paulo Rebelo Lopes,0,81.0,0,0,0,1,1,Gabon
7945,Marco Reus,2,557.0,0,0,8,5,13,Germany
7946,Marco Rojas,0,252.0,0,0,3,1,4,New Zealand
7947,Marco Sandy,0,94.0,0,0,3,0,3,Bolivia
7948,Marco Schällibaum,0,23.0,0,0,1,0,1,Switzerland
7949,Marco Soares,0,166.0,0,0,1,1,2,Cape Verde
7950,Marco Streller,0,105.0,0,0,1,1,2,Turkey
7951,Marco Tardelli,2,205.0,0,0,3,0,3,Italy
7952,Marco Ureña,5,509.0,0,0,3,6,9,Costa Rica
7953,Marco Verratti,0,118.0,0,0,2,0,2,Italy
7954,Marco Zwyssig,0,26.0,0,0,1,0,1,Switzerland
7955,Marco van Basten,4,927.0,0,2,6,12,18,Republic of Ireland
7956,Marcos Alonso Peña,0,67.0,0,0,0,1,1,Iceland
7957,Marcos Bermeo,1,36.0,1,0,0,1,1,Ecuador
7958,Marcos Coll,1,68.0,0,0,1,0,1,Colombia
7959,Marcos González,0,29.0,0,0,1,0,1,Chile
7960,Marcos Lugris,0,93.0,0,1,1,1,2,Dominican Republic
7961,Marcos Paulo,1,45.0,0,0,0,1,1,New Zealand
7962,Marcos Pizzelli,0,203.0,0,0,3,3,6,Armenia
7963,Marcos Rojo,3,150.0,0,0,1,2,3,Nigeria
7964,Marcos Senna,0,83.0,0,0,1,0,1,Spain
7965,Marcus Allbäck,2,1009.0,0,0,12,7,19,Moldova
7966,Marcus Berg,0,762.0,0,0,12,4,16,Sweden
7967,Marcus Danielson,0,11.0,0,0,0,1,1,Malta
7968,Marcus Forss,0,29.0,0,0,0,1,1,Bosnia and Herzegovina
7969,Marcus Gayle,1,41.0,0,0,1,0,1,Jamaica
7970,Marcus Ingvartsen,0,89.0,0,0,1,0,1,Denmark
7971,Marcus Julien,0,41.0,0,0,0,1,1,Belize
7972,Marcus Lopez,1,127.0,1,1,2,0,2,Guam
7973,Marcus Macauley,1,81.0,0,0,1,1,2,Angola
7974,Marcus Pürk,0,84.0,0,0,1,0,1,Austria
7975,Marcus Rashford,3,368.0,0,0,3,4,7,England
7976,Marcus Tulio Tanaka,0,219.0,1,0,1,3,4,Thailand
7977,Marcílio Alves da Silva,2,126.0,0,0,0,2,2,Pakistan
7978,Mardik Mardikian,2,53.0,0,1,0,3,3,Guam
7979,Marei Al Ramly,0,70.0,0,0,1,0,1,Libya
7980,Marei Suliman,0,54.0,0,0,1,0,1,Libya
7981,Marek Citko,0,7.0,0,0,0,1,1,England
7982,Marek Hamšík,1,931.0,0,2,8,9,17,Slovakia
7983,Marek Heinz,2,220.0,0,0,2,2,4,Czech Republic
7984,Marek Jankulovski,0,410.0,0,3,4,5,9,Iceland
7985,Marek Koźmiński,0,19.0,0,0,0,1,1,Netherlands
7986,Marek Kulič,0,91.0,0,0,2,0,2,Czech Republic
7987,Marek Kusto,0,24.0,0,0,0,1,1,Iceland
7988,Marek Lemsalu,0,87.0,1,0,0,1,1,Estonia
7989,Marek Leśniak,0,282.0,0,0,2,3,5,Poland
7990,Marek Matějovský,0,23.0,0,0,0,1,1,Germany
7991,Marek Mintál,0,385.0,0,0,5,4,9,Slovakia
7992,Marek Ostrowski,0,58.0,0,0,0,1,1,Greece
7993,Marek Poštulka,0,82.0,0,0,0,2,2,Faroe Islands
7994,Marek Saganowski,0,352.0,0,0,3,1,4,Poland
7995,Marek Sapara,0,124.0,0,0,3,1,4,Slovakia
7996,Marek Ujlaky,0,77.0,0,0,1,0,1,Slovakia
7997,Marek Čech,0,265.0,0,0,3,2,5,Slovakia
7998,Marian Hristov,0,58.0,0,0,0,1,1,Andorra
7999,Marian Zeman,0,37.0,0,0,1,0,1,Slovakia
8000,Marians Pahars,0,134.0,0,0,3,2,5,Norway
8001,Marijo Dodik,0,85.0,0,0,1,0,1,Bosnia and Herzegovina
8002,Marinho Chagas,0,96.0,0,0,2,0,2,Brazil
8003,Marino Alcívar,1,149.0,0,0,0,3,3,Peru
8004,Marino Klinger,1,86.0,0,0,1,0,1,Colombia
8005,Marinos Ouzounidis,0,113.0,1,0,3,0,3,Russia
8006,Mario Acevedo,0,84.0,0,0,0,1,1,Barbados
8007,Mario Alborta,1,42.0,0,0,0,1,1,Argentina
8008,Mario Balotelli,6,563.0,0,3,5,6,11,Italy
8009,Mario Basler,0,71.0,0,0,1,0,1,Germany
8010,Mario Bertini,0,81.0,0,0,0,1,1,Romania
8011,Mario Bolatti,0,84.0,0,0,0,1,1,Uruguay
8012,Mario Boyé,5,269.0,0,0,5,0,5,Argentina
8013,Mario Cordero,1,81.0,0,0,1,1,2,Costa Rica
8014,Mario Corso,0,236.0,0,0,1,2,3,Israel
8015,Mario César Ramírez,0,43.0,1,0,1,0,1,Ecuador
8016,Mario Evaristo,1,135.0,0,0,3,0,3,Argentina
8017,Mario Fernández,1,7.0,0,0,1,0,1,Argentina
8018,Mario Frick,0,537.0,1,1,7,5,12,Liechtenstein
8019,Mario Gaspar Pérez,0,22.0,0,0,0,1,1,Ukraine
8020,Mario Gavranović,1,425.0,0,0,2,3,5,Switzerland
8021,Mario Gjurovski,0,42.0,0,0,1,0,1,North Macedonia
8022,Mario Gómez,5,793.0,0,0,6,9,15,Germany
8023,Mario Götze,2,520.0,0,0,8,2,10,Germany
8024,Mario Haas,0,96.0,0,0,2,0,2,Austria
8025,Mario Harte,0,76.0,0,0,0,1,1,United States Virgin Islands
8026,Mario Kempes,0,464.0,0,0,8,1,9,Venezuela
8027,Mario Lemina,0,30.0,0,0,0,1,1,Ivory Coast
8028,Mario Ludovico Bergara,3,192.0,0,0,0,4,4,Ecuador
8029,Mario López,0,327.0,0,1,0,7,7,Haiti
8030,Mario Mandžukić,12,997.0,1,0,11,12,23,Croatia
8031,Mario Martínez,0,139.0,0,0,3,0,3,Honduras
8032,Mario Moreno,1,88.0,0,0,1,0,1,Chile
8033,Mario Mutsch,0,61.0,0,0,1,0,1,Luxembourg
8034,Mario Méndez,0,5.0,0,0,0,1,1,Nicaragua
8035,Mario Ochoa,0,89.0,0,0,1,0,1,Mexico
8036,Mario Pašalić,1,235.0,0,0,3,1,4,Croatia
8037,Mario Pedraza,1,44.0,0,0,1,0,1,Cuba
8038,Mario Rafael Rodríguez,0,323.0,0,0,3,3,6,Costa Rica
8039,Mario Regueiro,0,4.0,0,0,0,1,1,Chile
8040,Mario Rodríguez,3,209.0,0,0,3,2,5,Argentina
8041,Mario Rondón,0,32.0,0,0,0,1,1,Bolivia
8042,Mario Saralegui,0,70.0,0,0,0,1,1,Ecuador
8043,Mario Soto,2,129.0,0,0,1,2,3,Bolivia
8044,Mario Stanić,1,108.0,0,0,2,1,3,Jamaica
8045,Mario Tenorio,0,6.0,0,0,1,0,1,Ecuador
8046,Mario Vega,0,90.0,0,0,1,0,1,Costa Rica
8047,Mario Yepes,1,187.0,0,0,2,2,4,Colombia
8048,Mario Zanabria,0,120.0,0,0,2,0,2,Argentina
8049,Marios Agathokleous,0,273.0,0,0,4,1,5,Cyprus
8050,Marios Charalambous,0,26.0,1,0,0,1,1,Cyprus
8051,Marios Christodoulou,0,163.0,0,0,2,0,2,Cyprus
8052,Marios Elia,0,30.0,0,0,1,0,1,Cyprus
8053,Marios Tsingis,0,68.0,0,1,0,1,1,Italy
8054,Marius Lăcătuș,2,322.0,0,2,4,3,7,Romania
8055,Marius Mapou,0,64.0,0,0,1,0,1,New Caledonia
8056,Marius Mbaiam,1,28.0,0,0,0,1,1,Sudan
8057,Marius Niculae,0,182.0,0,0,2,3,5,Romania
8058,Marius Stankevičius,0,341.0,1,1,2,4,6,Lithuania
8059,Marius Trésor,1,154.0,0,0,0,2,2,Luxembourg
8060,Marius Walter,1,13.0,0,0,1,0,1,France
8061,Marius Žaliūkas,0,18.0,0,0,1,0,1,Lithuania
8062,Mariusz Kukiełka,0,88.0,0,0,0,1,1,San Marino
8063,Mariusz Lewandowski,0,187.0,0,0,2,1,3,Portugal
8064,Marián Masný,0,281.0,0,0,3,4,7,Czechoslovakia
8065,Mark Armstrong,3,150.0,0,0,3,0,3,New Zealand
8066,Mark Bosnich,0,88.0,0,1,1,0,1,Australia
8067,Mark Bowen,0,126.0,0,0,2,0,2,Wales
8068,Mark Bresciano,0,213.0,0,0,4,1,5,Australia
8069,Mark Burton,0,339.0,0,0,5,1,6,Australia
8070,Mark Chamberlain,0,71.0,0,0,1,0,1,England
8071,Mark Ebanks,1,173.0,0,1,3,1,4,Cayman Islands
8072,Mark Fish,0,110.0,0,0,2,0,2,South Africa
8073,Mark González,1,134.0,0,0,1,1,2,Bolivia
8074,Mark Hartmann,1,88.0,0,0,1,0,1,Philippines
8075,Mark Hateley,0,206.0,0,0,2,2,4,England
8076,Mark Hughes,0,471.0,0,0,7,4,11,Wales
8077,Mark Kennedy,0,148.0,0,0,1,1,2,Iceland
8078,Mark Kinsella,0,61.0,0,0,2,0,2,Republic of Ireland
8079,Mark Lawrenson,0,204.0,0,0,3,2,5,Cyprus
8080,Mark Mackay,0,37.0,0,0,0,1,1,Puerto Rico
8081,Mark Milligan,1,219.0,0,3,2,2,4,Australia
8082,Mark Pembridge,0,255.0,0,1,0,4,4,Albania
8083,Mark Rogers,1,63.0,1,0,0,1,1,Canada
8084,Mark Strudal,0,162.0,0,0,2,0,2,Denmark
8085,Mark Uhatahi,1,46.0,0,0,1,0,1,Tonga
8086,Mark Viduka,2,334.0,0,0,2,4,6,Mexico
8087,Mark Watson,1,180.0,0,0,1,2,3,Canada
8088,Mark Williams,0,311.0,0,0,5,1,6,South Africa
8089,Mark Wright,1,58.0,0,0,1,0,1,England
8090,Mark van Bommel,1,311.0,0,0,2,4,6,Andorra
8091,Mark-Anthony Kaye,2,95.0,0,0,0,2,2,Cayman Islands
8092,Marko Arnautović,1,1255.0,0,4,13,10,23,Austria
8093,Marko Babić,0,19.0,0,0,0,1,1,Bulgaria
8094,Marko Dević,0,134.0,0,1,1,3,4,Ukraine
8095,Marko Kristal,0,160.0,0,0,1,1,2,Estonia
8096,Marko Livaja,1,167.0,0,0,2,1,3,Croatia
8097,Marko Pantelić,1,304.0,0,0,2,3,5,Serbia
8098,Marko Rajamäki,0,20.0,0,0,1,0,1,Finland
8099,Marko Rehmer,0,48.0,0,0,1,2,3,Greece
8100,Marko Simić,0,106.0,0,0,1,1,2,Kazakhstan
8101,Marko Topić,0,87.0,0,0,1,0,1,Bosnia and Herzegovina
8102,Marko Valok,0,83.0,0,0,0,2,2,Israel
8103,Marko Vešović,0,48.0,0,0,1,1,2,Kazakhstan
8104,Marko Šuler,0,97.0,0,0,0,2,2,San Marino
8105,Markus Babbel,0,72.0,0,0,1,0,1,Germany
8106,Markus Henriksen,0,204.0,1,0,2,2,4,Norway
8107,Markus Rosenberg,0,139.0,0,0,2,0,2,Sweden
8108,Markus Schopp,0,229.0,0,0,1,4,5,Northern Ireland
8109,Markus Tanner,0,55.0,1,0,2,0,2,Switzerland
8110,Marlon Ayoví,0,118.0,0,2,1,1,2,Venezuela
8111,Marlon Felter,0,215.0,1,1,3,2,5,Aruba
8112,Marlon James,0,252.0,0,0,3,1,4,Saint Vincent and the Grenadines
8113,Marlon King,1,221.0,0,1,5,3,8,Haiti
8114,Marlos,0,27.0,0,0,0,1,1,Lithuania
8115,Marlos Huggins,0,18.0,0,0,0,1,1,Puerto Rico
8116,Marlos Moreno,1,73.0,0,0,1,0,1,Colombia
8117,Marouane Chamakh,2,131.0,0,0,3,2,5,Morocco
8118,Marouane Fellaini,2,548.0,0,0,9,2,11,Belgium
8119,Maroš Klimpl,0,37.0,0,0,1,0,1,Slovakia
8120,Marquinhos,0,147.0,1,0,2,2,4,Brazil
8121,Marshall Forbes,0,63.0,0,1,1,0,1,Cayman Islands
8122,Marshall Munetsi,0,77.0,0,0,1,0,1,Zimbabwe
8123,Marteinn Geirsson,1,51.0,0,1,0,1,1,Malta
8124,Martin Amerhauser,0,71.0,0,0,1,0,1,Austria
8125,Martin Andresen,1,40.0,0,0,0,1,1,Turkey
8126,Martin Boyle,3,132.0,0,0,2,1,3,Nepal
8127,Martin Braithwaite,1,317.0,0,0,2,3,5,Denmark
8128,Martin Büchel,0,17.0,1,0,2,0,2,Liechtenstein
8129,Martin Chivers,0,173.0,0,0,3,2,5,England
8130,Martin Dahlin,4,730.0,0,0,8,8,16,Sweden
8131,Martin Dúbravka,0,30.0,1,0,1,0,1,Spain
8132,Martin Fabuš,0,70.0,0,0,1,1,2,Slovakia
8133,Martin Fenin,0,87.0,0,0,0,1,1,Poland
8134,Martin Frýdek,0,111.0,0,0,1,1,2,Belarus
8135,Martin Gisinger,0,37.0,0,0,0,1,1,Cyprus
8136,Martin Gregory,0,85.0,0,0,1,0,1,Malta
8137,Martin Harnik,0,501.0,0,0,2,7,9,Belgium
8138,Martin Hiden,0,69.0,0,0,0,1,1,San Marino
8139,Martin Hinteregger,0,121.0,1,0,2,2,4,Georgia
8140,Martin Hoffmann,1,532.0,0,0,8,3,11,Chile
8141,Martin Jakubko,0,351.0,0,0,3,3,6,Cyprus
8142,Martin Jiránek,0,85.0,1,0,0,1,1,Czech Republic
8143,Martin Jørgensen,1,237.0,0,1,2,5,7,Brazil
8144,Martin Koscelník,0,77.0,0,0,1,0,1,Slovakia
8145,Martin Laursen,0,102.0,0,0,2,0,2,Denmark
8146,Martin Linnes,0,86.0,0,0,0,1,1,San Marino
8147,Martin Machón,1,45.0,0,0,1,0,1,Guatemala
8148,Martin O'Neill,1,208.0,0,0,4,1,5,Northern Ireland
8149,Martin Olsson,0,189.0,0,0,1,2,3,San Marino
8150,Martin Paterson,0,57.0,0,0,1,1,2,Northern Ireland
8151,Martin Peters,1,329.0,0,0,2,5,7,England
8152,Martin Petrov,1,761.0,0,2,11,4,15,Bulgaria
8153,Martin Petráš,0,28.0,0,0,0,1,1,North Macedonia
8154,Martin Reim,0,364.0,0,2,3,4,7,Italy
8155,Martin Samuelsen,0,82.0,0,0,1,0,1,Norway
8156,Martin Smedberg-Dalence,1,17.0,0,0,0,1,1,Ecuador
8157,Martin Stocklasa,0,41.0,0,0,0,1,1,Luxembourg
8158,Martin Stranzl,0,157.0,0,0,1,2,3,Austria
8159,Martin Sánchez,0,72.0,0,0,1,0,1,Argentina
8160,Martin Telser,0,49.0,0,0,1,0,1,Liechtenstein
8161,Martin Vunk,0,28.0,0,0,1,0,1,Estonia
8162,Martin Weber,0,88.0,0,0,0,1,1,Italy
8163,Martin Ødegaard,0,70.0,0,0,1,0,1,Norway
8164,Martin Škrtel,0,342.0,2,0,6,1,7,Slovakia
8165,Martins Eyo,1,54.0,0,0,1,0,1,Nigeria
8166,Martti Hyvärinen,0,5.0,0,0,1,0,1,Finland
8167,Martí Ventolrà,0,68.0,0,0,1,0,1,Spain
8168,Martín Arzuaga,0,70.0,0,0,1,0,1,Colombia
8169,Martín Cáceres,0,114.0,0,0,2,1,3,Bolivia
8170,Martín Demichelis,1,77.0,0,0,0,1,1,Greece
8171,Martín Flor,1,47.0,0,0,0,1,1,Chile
8172,Martín Hidalgo,2,136.0,0,0,2,0,2,Peru
8173,Martín Palermo,4,351.0,0,0,3,2,5,Argentina
8174,Martín Pando,0,101.0,0,0,1,1,2,Ecuador
8175,Martín Rodríguez,1,67.0,0,0,1,0,1,Chile
8176,Marvin Andrews,2,239.0,1,0,3,4,7,Trinidad and Tobago
8177,Marvin Baudry,0,10.0,0,0,1,0,1,Congo
8178,Marvin Ceballos,0,79.0,0,1,1,0,1,Guatemala
8179,Marvin Chávez,1,168.0,0,0,0,2,2,Cuba
8180,Marvin Elliott,0,23.0,0,0,1,0,1,Jamaica
8181,Marvin Faustin,0,63.0,0,0,1,0,1,Trinidad and Tobago
8182,Marvin Fletes,1,46.0,0,0,0,1,1,Turks and Caicos Islands
8183,Marvin González,1,101.0,1,0,2,0,2,El Salvador
8184,Marvin Monterrosa,0,109.0,0,0,0,2,2,United States Virgin Islands
8185,Marvin Ogunjimi,0,297.0,0,0,3,2,5,Kazakhstan
8186,Marvin Rodríguez,1,186.0,0,0,3,1,4,Honduras
8187,Marwan Khalifa Khouri,0,82.0,0,0,1,0,1,Syria
8188,Marwan Medrati,0,78.0,0,0,1,0,1,Syria
8189,Maryan Wisniewski,2,412.0,0,0,7,2,9,Iceland
8190,Marzouk Al-Otaibi,7,347.0,0,0,2,6,8,Egypt
8191,Masaaki Sawanobori,0,84.0,0,0,0,1,1,United Arab Emirates
8192,Masahiko Inoha,0,89.0,0,0,0,1,1,Qatar
8193,Masahiro Fukuda,1,196.0,0,0,3,1,4,Japan
8194,Masakiyo Maezono,2,176.0,0,0,2,0,2,Japan
8195,Masami Ihara,2,164.0,0,0,1,2,3,Sri Lanka
8196,Masashi Nakayama,6,611.0,0,0,6,3,9,Japan
8197,Masashi Oguro,3,419.0,0,0,3,2,5,Japan
8198,Masashi Watanabe,1,11.0,0,0,1,0,1,Japan
8199,Masato Morishige,1,35.0,0,0,0,1,1,Afghanistan
8200,Masauso Tembo,1,73.0,0,0,1,0,1,Zambia
8201,Masayuki Okano,1,118.0,0,0,1,0,1,Japan
8202,Masengo Ilunga,0,85.0,0,0,1,0,1,DR Congo
8203,Masimba Mambare,0,42.0,0,0,1,0,1,Zimbabwe
8204,Mason Mount,0,153.0,0,0,0,2,2,Kosovo
8205,Masoud Shojaei,1,232.0,0,1,2,2,4,Iran
8206,Mass Sarr Jr.,1,54.0,0,0,0,1,1,Gabon
8207,Massadio Haïdara,1,2.0,0,0,1,0,1,Mali
8208,Massamasso Tchangai,2,108.0,0,0,0,2,2,DR Congo
8209,Massimo Lombardo,0,14.0,0,0,0,1,1,Finland
8210,Massimo Luongo,0,220.0,0,0,5,0,5,Australia
8211,Massimo Margiotta,0,74.0,0,0,0,1,1,Peru
8212,Massimo Oddo,0,71.0,0,1,1,0,1,Italy
8213,Master Masiku,0,78.0,0,0,0,1,1,Malawi
8214,Mat Noh,0,31.0,0,0,1,0,1,Singapore
8215,Matar Niang,2,101.0,0,0,0,2,2,Ethiopia
8216,Matateu,0,169.0,0,0,2,1,3,Portugal
8217,Mate Vatsadze,0,75.0,0,0,2,0,2,Georgia
8218,Matej Mavrič,0,58.0,0,0,0,1,1,Moldova
8219,Matej Mitrović,1,68.0,0,0,0,1,1,Kosovo
8220,Mateja Kežman,4,524.0,0,0,4,6,10,Faroe Islands
8221,Mateus Galiano da Costa,1,48.0,0,0,0,1,1,Burkina Faso
8222,Mateus Uribe,0,139.0,0,0,1,1,2,Peru
8223,Matheus Nunes,0,90.0,0,0,1,0,1,Portugal
8224,Mathew Leckie,3,314.0,0,0,4,5,9,Australia
8225,Mathias Christen,0,60.0,0,0,1,0,1,Liechtenstein
8226,Mathias Jensen,0,39.0,0,0,1,0,1,Denmark
8227,Mathias Jänisch,0,87.0,0,0,1,0,1,Luxembourg
8228,Mathias Jørgensen,1,85.0,0,0,0,2,2,Croatia
8229,Mathias Normann,0,88.0,0,0,1,0,1,Norway
8230,Mathieu Bollen,0,100.0,0,0,2,0,2,Belgium
8231,Mathieu Dossevi,1,5.0,0,0,0,1,1,Morocco
8232,Mathieu Valbuena,1,87.0,0,0,1,1,2,France
8233,Mathías Corujo,1,88.0,0,0,1,0,1,Uruguay
8234,Matias Belli Moldskred,1,87.0,0,0,0,1,1,Turks and Caicos Islands
8235,Mats Hummels,2,181.0,2,0,2,3,5,Germany
8236,Mats Jingblad,0,87.0,0,0,0,1,1,Czechoslovakia
8237,Mats Magnusson,0,177.0,0,0,2,1,3,Sweden
8238,Mats Møller Dæhli,0,22.0,0,0,0,1,1,Malta
8239,Mats Nordgren,0,54.0,0,0,0,1,1,France
8240,Matt Besler,0,32.0,0,0,0,1,1,Saint Vincent and the Grenadines
8241,Matt Doherty,0,85.0,0,0,1,0,1,Republic of Ireland
8242,Matt Elliott,0,98.0,1,0,0,2,2,Scotland
8243,Matt Holland,2,243.0,0,0,1,3,4,Portugal
8244,Matt McKay,0,27.0,0,0,1,0,1,Australia
8245,Matt Miazga,0,88.0,0,0,1,0,1,United States
8246,Matt Moussilou,0,1.0,0,0,0,1,1,São Tomé and Príncipe
8247,Matt Ritchie,0,45.0,0,0,1,0,1,Scotland
8248,Mattar Al-Mukhaini,1,64.0,0,0,0,1,1,Taiwan
8249,Matteo Darmian,0,65.0,0,0,0,1,1,Azerbaijan
8250,Matteo Pessina,1,144.0,0,0,2,0,2,Italy
8251,Matteo Vitaioli,0,55.0,0,0,0,1,1,Lithuania
8252,Matthew Amoah,1,439.0,0,0,5,4,9,Ghana
8253,Matthew Bingley,0,66.0,0,0,1,0,1,Australia
8254,Matthew Booth,0,5.0,0,0,1,0,1,South Africa
8255,Matthew Garbett,1,90.0,0,0,0,1,1,Solomon Islands
8256,Matthew Hoppe,0,83.0,0,0,1,0,1,United States
8257,Matthew Upson,1,37.0,0,0,0,1,1,Germany
8258,Matthias Döschner,0,84.0,0,0,0,1,1,Iceland
8259,Matthias Ginter,0,41.0,0,0,1,0,1,Germany
8260,Matthias Herget,0,83.0,0,0,0,2,2,Czechoslovakia
8261,Matthias Liebers,0,40.0,0,0,1,0,1,German DR
8262,Matthias Phaeton,1,20.0,0,0,0,1,1,Suriname
8263,Matthias Sammer,2,349.0,0,0,4,2,6,Iceland
8264,Matthias Sindelar,1,111.0,0,0,2,0,2,Austria
8265,Matthijs de Ligt,0,48.0,0,0,1,0,1,Netherlands
8266,Matthías Hallgrímsson,0,25.0,0,0,0,1,1,German DR
8267,Matti Paatelainen,0,77.0,0,0,1,2,3,Czechoslovakia
8268,Mattia Destro,0,5.0,0,0,1,0,1,Italy
8269,Mattia Stefanelli,0,136.0,1,0,0,2,2,Norway
8270,Mattias Jonson,1,361.0,0,0,3,4,7,Sweden
8271,Mattias Käit,1,239.0,0,0,4,1,5,Estonia
8272,Mattias Svanberg,0,72.0,0,0,1,0,1,Sweden
8273,Matty Geoghegan,0,37.0,0,0,0,1,1,Norway
8274,Matías Campos,0,86.0,0,0,1,0,1,Chile
8275,Matías Fernández,0,390.0,0,0,3,4,7,Chile
8276,Matías Jadue,0,90.0,0,0,0,1,1,Saudi Arabia
8277,Matěj Vydra,0,128.0,0,0,0,2,2,Armenia
8278,Maung Maung Lwin,0,63.0,0,0,1,0,1,Myanmar
8279,Mauri Vanhanen,0,72.0,0,0,1,0,1,Finland
8280,Mauri Wasi,2,107.0,0,0,1,1,2,Papua New Guinea
8281,Maurice Escalona,0,161.0,0,0,2,1,3,Aruba
8282,Maurice Martens,0,32.0,0,0,2,0,2,Belgium
8283,Maurice Sunguti,0,145.0,0,0,0,2,2,Burkina Faso
8284,Maurice Tillotson,1,7.0,1,0,1,0,1,Indonesia
8285,Maurice Willems,0,168.0,0,0,0,3,3,France
8286,Mauricio Alonso Rodríguez,0,90.0,0,0,0,1,1,Haiti
8287,Mauricio Cienfuegos,0,315.0,0,0,5,0,5,El Salvador
8288,Mauricio Ernesto González,0,90.0,0,0,0,1,1,Suriname
8289,Mauricio Isla,0,152.0,0,0,2,0,2,Chile
8290,Mauricio Molina,1,79.0,0,0,1,0,1,Colombia
8291,Mauricio Pineda,1,36.0,0,0,1,0,1,Argentina
8292,Mauricio Pinilla,0,275.0,0,0,1,4,5,Chile
8293,Mauricio Pochettino,0,67.0,0,0,0,1,1,Paraguay
8294,Mauricio Ramos,1,87.0,0,0,0,1,1,Chile
8295,Mauricio Serna,0,120.0,0,2,0,2,2,Bolivia
8296,Mauricio Solís,0,115.0,0,0,1,1,2,Costa Rica
8297,Mauricio Wright,3,191.0,0,0,1,2,3,Colombia
8298,Maurinho,1,128.0,0,0,2,0,2,Brazil
8299,Mauro Camoranesi,0,134.0,0,0,0,3,3,Belarus
8300,Mauro Rosales,0,14.0,0,0,0,1,1,Peru
8301,Mauro Valentini,0,110.0,1,0,1,1,2,San Marino
8302,Mavango Kiala,0,85.0,0,0,0,1,1,Sudan
8303,Mavuba Mafuila,0,89.0,0,1,1,0,1,DR Congo
8304,Mawa Inunu,0,42.0,0,0,1,0,1,DR Congo
8305,Max Gradel,6,264.0,0,0,2,5,7,Ivory Coast
8306,Max Hagmayr,0,24.0,0,0,1,0,1,Austria
8307,Max Kruse,2,207.0,0,0,1,2,3,Gibraltar
8308,Max Llovera,0,82.0,0,0,0,1,1,Hungary
8309,Max Lorenz,0,32.0,0,0,1,0,1,Germany
8310,Max Morlock,6,545.0,0,0,9,3,12,Germany
8311,Maxi Gómez,0,90.0,0,0,1,0,1,Uruguay
8312,Maxi Pereira,1,141.0,0,0,2,1,3,Uruguay
8313,Maxi Rodríguez,3,341.0,0,0,4,3,7,Argentina
8314,Maxim Fedin,0,62.0,0,0,1,0,1,Kazakhstan
8315,Maxime Bossis,1,89.0,0,0,1,0,1,France
8316,Maxime Camara,0,28.0,0,0,1,0,1,Guinea
8317,Maxime Chanot,0,126.0,1,1,2,0,2,Luxembourg
8318,Maximilian Göppel,0,227.0,2,0,1,2,3,Israel
8319,Maxwel Cornet,2,208.0,0,0,2,1,3,Ivory Coast
8320,May Mahlangu,0,71.0,0,0,1,0,1,South Africa
8321,Maya Yoshida,2,608.0,0,0,8,1,9,Japan
8322,Mayanga Maku,5,215.0,0,0,0,7,7,Sudan
8323,Maykel Galindo,1,72.0,0,0,0,1,1,Costa Rica
8324,Maynor Figueroa,1,75.0,0,0,0,2,2,Trinidad and Tobago
8325,Mayron George,1,30.0,0,0,1,0,1,Costa Rica
8326,Mazinho Oliveira,1,16.0,0,0,1,1,2,Brazil
8327,Mbala Mbuta Biscotte,0,75.0,0,0,1,0,1,DR Congo
8328,Mbark Boussoufa,1,90.0,0,0,0,1,1,South Africa
8329,Mbiamcie Mvoubi,0,89.0,0,1,1,0,1,Congo
8330,Mbo Mpenza,0,123.0,0,0,2,0,2,Belgium
8331,Mbulelo Mabizela,0,108.0,0,0,2,0,2,South Africa
8332,Mbuleya Tondelva,0,150.0,0,0,1,1,2,Mauritius
8333,Mbungu Ekofa,1,137.0,0,0,1,1,2,DR Congo
8334,Mbwana Samatta,1,289.0,0,0,5,1,6,Tanzania
8335,McDonald Mariga,0,84.0,0,1,2,0,2,Kenya
8336,Meaataz Kailouni,0,86.0,0,0,0,1,1,Kyrgyzstan
8337,Mechack Jérôme,0,38.0,0,0,0,1,1,Grenada
8338,Meddie Kagere,0,227.0,0,0,3,2,5,Rwanda
8339,Medhi Benatia,0,30.0,0,0,0,1,1,Ivory Coast
8340,Medin Zhega,0,31.0,0,0,1,0,1,Albania
8341,Mehdi Abtahi,1,22.0,0,0,0,1,1,Taiwan
8342,Mehdi Ben Slimane,2,103.0,0,0,2,1,3,Rwanda
8343,Mehdi Fonounizadeh,2,95.0,0,0,0,2,2,Saudi Arabia
8344,Mehdi Ghayedi,1,84.0,0,0,0,1,1,Cambodia
8345,Mehdi Hasheminasab,0,54.0,0,0,1,0,1,Iran
8346,Mehdi Mahdavikia,2,439.0,0,0,4,5,9,Maldives
8347,Mehdi Monajati,0,19.0,0,0,1,0,1,Iran
8348,Mehdi Nafti,0,27.0,0,0,0,1,1,Botswana
8349,Mehdi Taremi,7,1007.0,0,1,9,11,20,Iran
8350,Mehdi Torabi,0,89.0,0,0,1,0,1,Iran
8351,Mehmed Baždarević,0,188.0,0,0,0,3,3,Wales
8352,Mehmet Aurélio,0,72.0,0,0,1,0,1,Turkey
8353,Mehmet Durakovic,0,227.0,0,0,3,0,3,Australia
8354,Mehmet Oğuz,0,85.0,0,0,1,0,1,Turkey
8355,Mehmet Scholl,1,177.0,0,0,3,0,3,Germany
8356,Mehmet Türkkan,0,51.0,0,0,1,0,1,Turkey
8357,Mehmet Özgül,0,22.0,0,0,1,0,1,Turkey
8358,Meho Kodro,0,59.0,0,0,1,1,2,Slovenia
8359,Mehrdad Minavand,3,296.0,0,0,0,4,4,Thailand
8360,Mehrdad Mohammadi,0,85.0,0,0,1,0,1,Iran
8361,Mei Fang,0,10.0,0,0,1,0,1,China PR
8362,Meinhard Olsen,0,83.0,0,0,0,1,1,Moldova
8363,Mejdi Traoui,1,82.0,0,0,1,0,1,Tunisia
8364,Mekan Nasyrow,0,83.0,0,0,2,0,2,Turkmenistan
8365,Mekan Saparow,0,73.0,1,0,1,1,2,Oman
8366,Mel Charles,0,6.0,0,0,0,1,1,German DR
8367,Meli Vuilabasa,2,266.0,0,0,3,1,4,Fiji
8368,Melih Atacan,0,54.0,0,0,1,0,1,Turkey
8369,Melis Asprou,0,22.0,0,0,1,0,1,Cyprus
8370,Melvin Valies,1,65.0,0,0,0,1,1,Montserrat
8371,Melvin Valladares,1,145.0,0,0,2,0,2,Honduras
8372,Memphis Depay,3,1392.0,0,6,17,9,26,Australia
8373,Meng Kam Jong,0,76.0,0,0,1,0,1,Macau
8374,Mengistu Worku,5,731.0,0,0,9,2,11,Ethiopia
8375,Mengitsu Hussien,0,7.0,0,0,1,0,1,Ethiopia
8376,Merih Demiral,0,188.0,2,0,3,0,3,Italy
8377,Merlyn Membreño,0,65.0,0,0,1,0,1,Honduras
8378,Merouane Zemmama,0,66.0,0,0,1,0,1,Morocco
8379,Mert Müldür,0,84.0,0,0,1,0,1,Turkey
8380,Meshach Wade,0,130.0,0,0,2,0,2,Bermuda
8381,Meshal Abdullah,0,86.0,0,0,0,1,1,Laos
8382,Meshal Mubarak,0,140.0,0,0,2,0,2,Qatar
8383,Mesut Özil,4,1051.0,0,4,12,6,18,Ghana
8384,Metin Kurt,0,4.0,0,0,1,0,1,Turkey
8385,Metin Oktay,0,166.0,0,0,2,1,3,Norway
8386,Metin Tekin,0,112.0,0,0,1,1,2,Albania
8387,Metodije Spasovski,0,64.0,0,0,2,0,2,Yugoslavia
8388,Mevlüt Erdinç,0,178.0,0,0,1,2,3,Turkey
8389,Mexhit Haxhiu,0,77.0,0,0,1,0,1,Albania
8390,Mica Pinto,0,8.0,0,0,1,0,1,Luxembourg
8391,Micah Hyde,0,40.0,0,0,0,1,1,El Salvador
8392,Micah Lea'alafa,0,102.0,0,1,2,0,2,Solomon Islands
8393,Micah Richards,0,66.0,0,0,1,0,1,England
8394,Michael Amir Murillo,1,72.0,1,0,2,0,2,Panama
8395,Michael Arroyo,0,164.0,0,0,0,2,2,Colombia
8396,Michael Ballack,4,1030.0,0,8,15,12,27,Greece
8397,Michael Barrantes,2,129.0,0,0,2,0,2,Costa Rica
8398,Michael Baur,0,98.0,1,0,2,2,4,Austria
8399,Michael Beauchamp,0,21.0,0,0,0,1,1,Thailand
8400,Michael Bethel,0,40.0,0,0,1,0,1,Bahamas
8401,Michael Boxall,0,31.0,1,0,1,0,1,Russia
8402,Michael Bradley,2,514.0,0,0,9,3,12,United States
8403,Michael Chabala,1,167.0,0,0,3,1,4,Zambia
8404,Michael Crawford,0,50.0,0,0,1,0,1,Saint Kitts and Nevis
8405,Michael Degiorgio,0,102.0,0,0,0,2,2,Spain
8406,Michael Dupuy,1,90.0,0,0,0,1,1,New Caledonia
8407,Michael Eneramo,0,80.0,0,0,1,0,1,Nigeria
8408,Michael Essien,0,249.0,0,1,5,1,6,Ghana
8409,Michael Estrada,0,234.0,0,0,5,1,6,Ecuador
8410,Michael Forde,0,89.0,0,0,1,0,1,Barbados
8411,Michael Foster,0,150.0,0,0,3,1,4,Papua New Guinea
8412,Michael Glowatzky,0,11.0,0,0,1,0,1,German DR
8413,Michael Gravgaard,0,167.0,0,0,1,3,4,Denmark
8414,Michael Gregoritsch,1,163.0,0,0,2,0,2,Austria
8415,Michael Groom,1,6.0,0,0,1,0,1,New Zealand
8416,Michael Hughes,0,183.0,0,0,2,1,3,Portugal
8417,Michael Junior Palusami,1,20.0,0,0,1,0,1,Samoa
8418,Michael Keane,0,30.0,0,0,0,1,1,Montenegro
8419,Michael Klein,0,109.0,0,0,1,1,2,Romania
8420,Michael Krohn-Dehli,2,81.0,0,0,2,2,4,Cyprus
8421,Michael Lang,0,94.0,0,0,1,1,2,Albania
8422,Michael Laudrup,3,825.0,0,3,14,5,19,Denmark
8423,Michael Lohai,1,71.0,0,0,0,1,1,American Samoa
8424,Michael McGarry,0,104.0,0,0,2,0,2,New Zealand
8425,Michael McGlinchey,1,183.0,0,0,3,1,4,New Zealand
8426,Michael Mifsud,1,706.0,0,2,9,5,14,Malta
8427,Michael Ngadeu-Ngadjui,3,240.0,0,0,3,1,4,Cameroon
8428,Michael O'Neill,0,214.0,0,0,2,2,4,Malta
8429,Michael Obiku,0,67.0,0,0,0,1,1,Angola
8430,Michael Olunga,2,289.0,0,0,4,3,7,Mauritius
8431,Michael Orozco,0,136.0,0,0,1,1,2,United States
8432,Michael Owen,5,1194.0,0,1,14,13,27,Romania
8433,Michael Preetz,1,6.0,0,0,1,0,1,Germany
8434,Michael Rabeson,0,26.0,0,0,1,0,1,Madagascar
8435,Michael Robinson,0,128.0,0,0,2,2,4,Republic of Ireland
8436,Michael Schjønberg,0,110.0,0,0,1,2,3,Cyprus
8437,Michael Smith,0,7.0,0,0,0,1,1,Germany
8438,Michael Stocklasa,0,90.0,0,0,1,0,1,Liechtenstein
8439,Michael Streiter,0,48.0,0,0,1,0,1,Austria
8440,Michael Umaña,0,22.0,0,0,1,0,1,Costa Rica
8441,Michael Zandberg,0,90.0,0,0,1,0,1,Israel
8442,Michael Zisser,0,89.0,0,0,0,1,1,Finland
8443,Michail Antonio,0,109.0,0,1,1,2,3,El Salvador
8444,Michal Bílek,2,420.0,0,3,5,2,7,Czechoslovakia
8445,Michal Horňák,0,10.0,0,0,1,0,1,Czech Republic
8446,Michal Kadlec,0,326.0,1,3,1,4,5,Czech Republic
8447,Michal Krmenčík,0,85.0,0,0,3,1,4,Czech Republic
8448,Michal Ďuriš,0,110.0,0,0,0,1,1,Northern Ireland
8449,Michalis Kapsis,0,43.0,0,0,0,1,1,Georgia
8450,Michalis Konstantinou,0,898.0,0,4,10,12,22,Cyprus
8451,Michalis Kritikopoulos,0,80.0,0,0,0,1,1,Malta
8452,Michalis Yasemis,0,118.0,0,1,1,1,2,Cyprus
8453,Michaël Maria,2,36.0,0,0,0,2,2,British Virgin Islands
8454,Michał Żewłakow,0,93.0,1,2,3,0,3,Poland
8455,Michel Bassolé,2,50.0,0,0,0,2,2,Nigeria
8456,Michel Bouanga,0,127.0,0,0,2,0,2,Congo
8457,Michel De Wolf,1,64.0,0,0,1,0,1,Belgium
8458,Michel Goba,0,75.0,0,0,1,0,1,Ivory Coast
8459,Michel Hmaé,6,579.0,0,0,10,1,11,New Caledonia
8460,Michel Kira,0,26.0,0,0,1,0,1,Madagascar
8461,Michel Minko,0,37.0,0,0,1,0,1,Gabon
8462,Michel Mézy,0,63.0,0,0,1,0,1,France
8463,Michel Ngonge,0,60.0,0,0,1,1,2,Mauritius
8464,Michel Platini,4,1336.0,0,3,17,10,27,Bulgaria
8465,Michel Reuter,0,88.0,0,0,0,1,1,Switzerland
8466,Michel Valke,0,15.0,1,0,1,0,1,Austria
8467,Michele Cevoli,0,96.0,2,0,2,0,2,Azerbaijan
8468,Michele Polverino,0,128.0,0,0,3,0,3,Liechtenstein
8469,Michy Batshuayi,3,537.0,0,1,4,6,10,Belgium
8470,Michél Mazingu-Dinzey,0,52.0,0,0,1,0,1,DR Congo
8471,Mick Channon,0,343.0,0,1,3,3,6,England
8472,Mick Martin,0,171.0,1,0,2,2,4,France
8473,Mickaël Poté,2,101.0,0,0,1,2,3,Benin
8474,Mickey Thomas,0,107.0,0,0,2,0,2,Wales
8475,Mickey Trotman,1,101.0,0,0,0,1,1,Costa Rica
8476,Mickey Walsh,0,145.0,0,0,1,1,2,Iceland
8477,Mickey Weche,1,89.0,0,1,0,1,1,Nigeria
8478,Mido,1,287.0,0,1,5,1,6,Egypt
8479,Miel Pijs,0,35.0,0,0,1,0,1,Netherlands
8480,Miguel Aguilar,0,202.0,0,0,1,3,4,Venezuela
8481,Miguel Almirón,1,112.0,0,1,1,1,2,Chile
8482,Miguel Angel Lauri,1,28.0,0,0,1,0,1,Argentina
8483,Miguel Augusto Prince,0,133.0,0,0,3,0,3,Colombia
8484,Miguel Borja,1,254.0,0,2,5,0,5,Colombia
8485,Miguel Busquets,1,71.0,0,0,1,0,1,Chile
8486,Miguel Camargo,1,123.0,0,0,1,2,3,Chile
8487,Miguel Dellavalle,0,13.0,0,0,0,1,1,Chile
8488,Miguel Echenausi,1,89.0,0,0,0,1,1,United States
8489,Miguel Estrada,0,3.0,0,0,0,1,1,Nicaragua
8490,Miguel Gandara,0,90.0,0,0,1,0,1,Cuba
8491,Miguel González,0,97.0,0,0,2,0,2,Spain
8492,Miguel Layún,0,20.0,0,0,0,1,1,United States
8493,Miguel Martínez,1,57.0,0,0,1,0,1,Uruguay
8494,Miguel María Michelagnoli,0,47.0,0,0,1,0,1,Paraguay
8495,Miguel Mea Vitali,0,24.0,0,0,1,0,1,Venezuela
8496,Miguel Mercado,1,78.0,0,0,0,1,1,Chile
8497,Miguel Peredo,1,117.0,0,0,1,1,2,Argentina
8498,Miguel Pereira,1,86.0,0,0,1,0,1,Angola
8499,Miguel Pérez,0,38.0,0,0,1,0,1,Dominican Republic
8500,Miguel Sabah,4,263.0,0,0,5,0,5,Mexico
8501,Miguel Veloso,0,222.0,0,0,2,1,3,Portugal
8502,Miguel Villalta,1,27.0,0,0,0,1,1,Uruguay
8503,Miguel Zepeda,1,283.0,0,0,3,2,5,Chile
8504,Miguel Ángel Benítez,1,209.0,0,0,5,2,7,Paraguay
8505,Miguel Ángel Brindisi,1,108.0,0,0,3,0,3,Argentina
8506,Miguel Ángel Bustillo,0,20.0,0,0,1,0,1,Spain
8507,Miguel Ángel Gamboa,0,145.0,0,0,1,2,3,Bolivia
8508,Miguel Ángel Loayza,4,136.0,0,0,3,2,5,Peru
8509,Miguel Ángel Nadal,0,123.0,0,0,1,1,2,Spain
8510,Miguel Ángel Neira,1,87.0,0,1,1,1,2,Chile
8511,Miguel Ángel Noro,0,59.0,1,0,0,1,1,Bolivia
8512,Miguel Ángel Ponce,1,90.0,0,0,0,1,1,Martinique
8513,Miguel Ángel Russo,0,27.0,0,0,1,0,1,Argentina
8514,Miha Mevlja,0,143.0,1,0,1,1,2,Slovakia
8515,Miha Zajc,0,147.0,0,0,2,2,4,Slovenia
8516,Mihai Pintilii,0,31.0,0,0,1,0,1,Romania
8517,Mihail Aleksandrov,0,26.0,0,1,1,1,2,Bulgaria
8518,Mihail Lozanov,0,66.0,0,0,0,1,1,Austria
8519,Mihail Titow,0,23.0,0,0,1,0,1,Turkmenistan
8520,Mihails Zemļinskis,0,404.0,1,3,2,5,7,Belarus
8521,Mihal Gjika,0,15.0,0,0,1,0,1,Albania
8522,Mihály Korhut,0,10.0,0,0,1,0,1,Hungary
8523,Mihály Kozma,0,9.0,0,0,1,0,1,Hungary
8524,Mihály Lantos,2,78.0,0,1,1,1,2,Hungary
8525,Miikka Toivola,0,60.0,0,0,1,1,2,Finland
8526,Mijat Gaćinović,0,106.0,0,0,1,1,2,Georgia
8527,Mika Lipponen,0,238.0,0,0,2,3,5,Turkey
8528,Mika Nurmela,0,84.0,0,0,1,1,2,Azerbaijan
8529,Mika Väyrynen,0,166.0,0,0,2,1,3,Poland
8530,Mikael Forssell,0,930.0,0,2,16,4,20,Finland
8531,Mikael Lustig,0,241.0,0,0,2,3,5,Sweden
8532,Mikael Nilsson,0,3.0,0,0,0,1,1,Poland
8533,Mikalay Ryndzyuk,0,70.0,0,0,1,1,2,Poland
8534,Mike England,0,171.0,0,0,2,1,3,Wales
8535,Mike Hanke,0,88.0,0,0,1,0,1,Germany
8536,Mike Havenaar,0,58.0,0,0,2,0,2,Japan
8537,Mike Okoth Origi,0,344.0,0,0,5,1,6,Guinea
8538,Mike Ott,0,83.0,0,0,1,0,1,Philippines
8539,Mike Summerbee,0,9.0,0,0,1,0,1,England
8540,Mikel John Obi,3,234.0,0,0,5,0,5,Nigeria
8541,Mikel Oyarzabal,1,280.0,0,0,2,1,3,Spain
8542,Mikel Villanueva,0,80.0,0,0,1,1,2,Peru
8543,Mikhail Gordeichuk,0,96.0,0,0,2,0,2,Belarus
8544,Mikhail Sivakow,0,33.0,0,1,1,0,1,Belarus
8545,Mikheil Ashvetia,0,17.0,0,0,1,0,1,Georgia
8546,Mikheil Kavelashvili,0,52.0,0,0,1,0,1,Georgia
8547,Mikheil Meskhi,2,174.0,0,0,2,1,3,Russia
8548,Mikkel Beck,0,54.0,0,0,1,1,2,Belgium
8549,Mikkel Damsgaard,0,119.0,0,0,3,1,4,Denmark
8550,Mikkel Diskerud,0,83.0,0,0,1,0,1,United States
8551,Miklos Molnar,0,129.0,0,0,2,0,2,Denmark
8552,Miklós Fehér,0,259.0,0,0,0,4,4,Azerbaijan
8553,Miklós Kovács,1,89.0,0,0,0,1,1,Peru
8554,Miku,2,336.0,0,0,3,2,5,Venezuela
8555,Milad Meydavoudi,0,7.0,0,0,0,1,1,Indonesia
8556,Milad Mohammadi,1,58.0,0,0,0,1,1,Cambodia
8557,Milan Albrecht,0,30.0,0,0,1,0,1,Czechoslovakia
8558,Milan Badelj,1,85.0,0,0,0,2,2,Malta
8559,Milan Baroš,5,1418.0,0,1,20,5,25,Czech Republic
8560,Milan Dolinský,0,180.0,0,0,2,1,3,Czechoslovakia
8561,Milan Dvořák,2,32.0,0,1,1,1,2,Czechoslovakia
8562,Milan Galić,4,623.0,0,0,5,12,17,Yugoslavia
8563,Milan Jovanović,1,387.0,0,0,3,5,8,Finland
8564,Milan Luhový,1,216.0,0,0,1,2,3,Czechoslovakia
8565,Milan Osterc,0,299.0,0,0,3,1,4,Slovenia
8566,Milan Rapaić,2,177.0,0,2,3,1,4,Italy
8567,Milan Ristovski,0,79.0,0,0,0,1,1,Armenia
8568,Milan Smiljanić,0,75.0,0,0,0,1,1,Azerbaijan
8569,Milan Đurić,0,138.0,0,0,1,1,2,Bosnia and Herzegovina
8570,Milan Škoda,1,236.0,0,0,3,0,3,Czech Republic
8571,Milan Škriniar,1,272.0,2,0,4,1,5,Northern Ireland
8572,Milciades Morel,0,137.0,0,0,2,1,3,Brazil
8573,Mile Jedinak,5,884.0,1,11,11,7,18,Australia
8574,Mile Krstev,0,117.0,0,0,2,0,2,North Macedonia
8575,Mile Sterjovski,0,241.0,0,0,4,0,4,Australia
8576,Milenko Ačimovič,1,466.0,0,1,9,0,9,Slovenia
8577,Milenko Špoljarić,0,431.0,0,2,5,1,6,Cyprus
8578,Miles Robinson,0,167.0,0,0,2,0,2,United States
8579,Milivoje Novaković,0,947.0,0,2,14,7,21,Slovenia
8580,Milko Djurovski,0,29.0,0,0,0,1,1,Bulgaria
8581,Millan Baçi,0,18.0,0,0,1,0,1,Albania
8582,Miller Bolaños,3,319.0,0,0,4,1,5,Ecuador
8583,Millón Medeiros,0,24.0,0,1,1,0,1,Brazil
8584,Milot Rashica,0,38.0,0,0,0,2,2,Montenegro
8585,Milovan Mirosevic,0,107.0,0,0,1,1,2,Argentina
8586,Miloš Krasić,0,49.0,0,0,1,1,2,Serbia
8587,Miloš Milutinović,1,128.0,0,0,3,1,4,Yugoslavia
8588,Miloš Šestić,0,112.0,0,0,0,2,2,France
8589,Milton Coimbra,0,198.0,0,0,2,1,3,Bolivia
8590,Milton Karisa,0,11.0,0,0,0,1,1,Congo
8591,Milton Meléndez,0,114.0,0,0,1,2,3,Jamaica
8592,Milton Núñez,2,722.0,0,0,8,4,12,Honduras
8593,Milutin Pajević,0,57.0,0,0,3,0,3,Yugoslavia
8594,Milyon Beguashaw,0,38.0,0,0,1,0,1,Ethiopia
8595,Mimi El-Sherbini,1,64.0,0,0,1,0,1,Egypt
8596,Mimis Domazos,0,91.0,0,0,1,1,2,Romania
8597,Mimis Papaioannou,1,681.0,0,0,9,3,12,Greece
8598,Mimoun Mahi,0,88.0,0,0,1,0,1,Morocco
8599,Mindaugas Kalonas,0,106.0,0,1,1,1,2,Romania
8600,Minervino Pietra,0,65.0,0,0,1,0,1,Portugal
8601,Mini Jakobsen,0,133.0,0,0,2,2,4,Italy
8602,Minor López,0,172.0,0,0,1,2,3,Belize
8603,Minyahil Teshome,1,61.0,0,0,0,1,1,Central African Republic
8604,Miodrag Belodedici,0,42.0,0,0,1,0,1,Romania
8605,Miodrag Ješić,0,66.0,0,0,1,0,1,Yugoslavia
8606,Miralem Pjanić,1,543.0,0,2,8,4,12,Luxembourg
8607,Miralem Sulejmani,0,90.0,0,0,1,0,1,Serbia
8608,Miran Pavlin,1,130.0,0,0,0,2,2,Ukraine
8609,Miranda,0,2.0,0,0,1,0,1,Brazil
8610,Mirbağır İsayev,0,73.0,0,0,1,0,1,Azerbaijan
8611,Mircea Dridea,0,139.0,0,0,1,2,3,Romania
8612,Mircea Lucescu,0,276.0,0,1,3,2,5,Cyprus
8613,Mircea Sandu,0,90.0,0,0,2,0,2,Romania
8614,Mirco Gennari,0,87.0,1,0,1,0,1,Spain
8615,Mirdjalal Kasimov,0,71.0,0,0,1,0,1,Uzbekistan
8616,Mirel Josa,0,69.0,0,0,1,0,1,Albania
8617,Mirel Rădoi,0,25.0,0,0,0,1,1,Luxembourg
8618,Mirjalol Qosimov,7,747.0,0,1,7,8,15,Qatar
8619,Mirko Hrgović,0,64.0,0,0,0,2,2,Malta
8620,Mirko Ivanovski,0,59.0,0,0,1,0,1,North Macedonia
8621,Mirko Palazzi,0,74.0,0,0,0,1,1,Azerbaijan
8622,Mirko Vučinić,0,433.0,0,1,7,2,9,Montenegro
8623,Mirlan Murzaev,3,297.0,0,1,0,6,6,United Arab Emirates
8624,Miro,0,52.0,0,0,1,0,1,Mozambique
8625,Miroslav Baranek,0,12.0,0,0,0,1,1,Bosnia and Herzegovina
8626,Miroslav Chvíla,0,78.0,0,0,0,1,1,Romania
8627,Miroslav Gajdůšek,0,149.0,0,0,0,2,2,Scotland
8628,Miroslav Gjokić,0,142.0,0,0,0,2,2,Romania
8629,Miroslav Kadlec,0,82.0,0,0,2,0,2,Czechoslovakia
8630,Miroslav Karhan,0,463.0,0,1,7,2,9,Slovakia
8631,Miroslav Klose,13,2316.0,0,0,29,19,48,Germany
8632,Miroslav Pavlović,0,67.0,0,0,0,1,1,Spain
8633,Miroslav Romaschenko,0,68.0,0,0,1,0,1,Belarus
8634,Miroslav Sovič,0,3.0,0,0,0,1,1,Liechtenstein
8635,Miroslav Stevanović,0,84.0,0,0,0,1,1,Finland
8636,Miroslav Stoch,0,149.0,0,0,2,1,3,Slovakia
8637,Miroslav Đukić,1,91.0,0,0,1,1,2,Hungary
8638,Mirosław Szymkowiak,0,41.0,0,0,1,1,2,Poland
8639,Mirosław Trzeciak,0,99.0,0,0,2,0,2,Poland
8640,Mirsad Bešlija,0,41.0,0,0,0,1,1,Spain
8641,Mirsad Hibić,0,29.0,1,0,0,1,1,Bosnia and Herzegovina
8642,Misagh Bahadoran,1,145.0,0,0,2,1,3,Philippines
8643,Mislav Oršić,2,127.0,0,0,2,0,2,Croatia
8644,Mitchell Duke,6,350.0,0,0,4,2,6,Australia
8645,Mitchell Joseph,0,65.0,0,0,1,0,1,Dominica
8646,Mithun Chowdhury,0,52.0,0,0,1,0,1,Bangladesh
8647,Mitko Stojkovski,0,150.0,0,1,3,2,5,North Macedonia
8648,Mitsunori Yoshida,1,36.0,0,0,0,1,1,Bangladesh
8649,Mitsuo Ogasawara,0,106.0,0,0,2,1,3,Japan
8650,Mixu Paatelainen,0,672.0,0,0,9,4,13,Wales
8651,Mladen Bartolović,0,45.0,0,0,0,1,1,Malta
8652,Mladen Krstajić,0,74.0,0,0,0,1,1,Switzerland
8653,Mladen Mladenović,0,7.0,0,0,1,0,1,Croatia
8654,Mladen Petrić,0,432.0,0,0,6,4,10,Croatia
8655,Mladen Rudonja,0,55.0,0,0,0,1,1,Romania
8656,Mladen Vasilev,0,37.0,0,0,0,1,1,Norway
8657,Mo Johnston,1,422.0,0,1,7,3,10,Scotland
8658,Mo'ayyad Salim,0,70.0,0,0,1,0,1,Jordan
8659,Moayad Ajan,1,42.0,0,0,0,1,1,Afghanistan
8660,Mobarak Al-Faneeni,0,49.0,0,0,1,0,1,Kuwait
8661,Moctar Sidi El Hacen,1,72.0,0,1,0,1,1,Mali
8662,Moderato Wisintainer,2,110.0,0,0,0,2,2,Bolivia
8663,Modeste Eta,0,64.0,0,0,0,1,1,Equatorial Guinea
8664,Modeste M'Bami,2,107.0,0,0,2,0,2,Cameroon
8665,Modestus Haas,0,60.0,1,0,1,0,1,Romania
8666,Modibo Maïga,2,157.0,0,0,2,1,3,Mali
8667,Modibo Sidibé,0,34.0,0,0,0,1,1,Tunisia
8668,Mogakolodi Ngele,1,218.0,0,0,4,0,4,Botswana
8669,Mogens Berg,0,60.0,0,0,0,1,1,Greece
8670,Mogogi Gabonamong,0,12.0,0,0,1,0,1,Botswana
8671,Mohaisen Al-Jam'an,1,207.0,0,0,3,0,3,Saudi Arabia
8672,Mohamad Kdouh,3,107.0,0,0,1,2,3,Lebanon
8673,Mohamad Moustafa Kadir,1,193.0,0,2,2,1,3,Taiwan
8674,Mohamad Yehya Al Rashed,0,76.0,0,0,1,0,1,Syria
8675,Mohamadi Balma,0,27.0,1,0,1,0,1,Guinea
8676,Mohamadou Sumareh,0,220.0,0,0,2,2,4,Malaysia
8677,Mohamadu Salisu,0,55.0,0,0,1,0,1,Ghana
8678,Mohamed Abdallah,0,68.0,0,0,0,1,1,Tanzania
8679,Mohamed Abdel-Shafy,1,80.0,0,0,0,1,1,Algeria
8680,Mohamed Abdelmonem,1,35.0,0,0,1,0,1,Egypt
8681,Mohamed Abdelrahman,0,145.0,0,0,2,0,2,Sudan
8682,Mohamed Abdelwahab,0,88.0,0,0,0,1,1,Sudan
8683,Mohamed Abdulazeez,0,13.0,0,0,0,1,1,Oman
8684,Mohamed Aboutrika,4,1238.0,0,4,10,10,20,Sudan
8685,Mohamed Ahmed,0,111.0,0,0,2,0,2,United Arab Emirates
8686,Mohamed Ahmed Bashir,2,106.0,0,0,2,0,2,Sudan
8687,Mohamed Akid,0,158.0,0,0,2,1,3,Tunisia
8688,Mohamed Al Ghanodi,0,48.0,0,0,0,1,1,Rwanda
8689,Mohamed Al Zeno,1,209.0,0,1,2,2,4,Syria
8690,Mohamed Al-Diabaz,0,75.0,0,0,2,0,2,Jordan
8691,Mohamed Al-Romaihi,1,290.0,0,0,2,2,4,Bahrain
8692,Mohamed Al-Shehhi,0,174.0,0,1,3,2,5,United Arab Emirates
8693,Mohamed Al-Suwaiyed Shehrani,1,82.0,0,0,0,1,1,Syria
8694,Mohamed Ala'a,0,23.0,0,0,1,0,1,Egypt
8695,Mohamed Ali,0,46.0,0,0,1,0,1,Ethiopia
8696,Mohamed Ali Hamoud,0,37.0,0,0,1,0,1,Oman
8697,Mohamed Ali Mahjoubi,0,178.0,0,0,3,0,3,Tunisia
8698,Mohamed Ali Manser,1,70.0,0,0,1,0,1,Tunisia
8699,Mohamed Amine Ben Amor,0,83.0,0,0,0,1,1,Guinea
8700,Mohamed Aoudou,0,176.0,0,0,2,0,2,Benin
8701,Mohamed Barakat,1,179.0,0,0,3,1,4,Egypt
8702,Mohamed Bayo,2,123.0,0,0,1,1,2,Sudan
8703,Mohamed Boussati,0,30.0,0,0,1,0,1,Morocco
8704,Mohamed Brahimi,0,60.0,0,0,1,0,1,Algeria
8705,Mohamed Daima,0,71.0,0,0,0,1,1,Ghana
8706,Mohamed Dräger,0,31.0,0,0,1,0,1,Tunisia
8707,Mohamed El Monir,0,126.0,0,0,0,2,2,Rwanda
8708,Mohamed El Rabty,0,88.0,0,0,1,0,1,Libya
8709,Mohamed El-Akad,0,42.0,0,0,1,0,1,Egypt
8710,Mohamed El-Sayed,0,72.0,0,0,2,0,2,Qatar
8711,Mohamed El-Seyagui,1,86.0,0,0,1,0,1,Egypt
8712,Mohamed Elneny,1,72.0,0,0,2,1,3,Egypt
8713,Mohamed Elyounoussi,0,340.0,0,0,2,4,6,San Marino
8714,Mohamed Emara,0,15.0,0,0,1,0,1,Egypt
8715,Mohamed Farouk,0,221.0,0,0,3,0,3,Egypt
8716,Mohamed Gasri,0,160.0,0,0,1,1,2,Benin
8717,Mohamed Hameed,0,90.0,0,0,1,0,1,Sri Lanka
8718,Mohamed Hassan Abdullah,2,159.0,0,0,1,1,2,Yemen
8719,Mohamed Hubail,1,308.0,0,0,3,2,5,China PR
8720,Mohamed Husain,1,277.0,1,0,2,2,4,Kuwait
8721,Mohamed Jameel,0,61.0,0,0,0,1,1,China PR
8722,Mohamed Kaci-Saïd,0,67.0,0,0,0,1,1,Tunisia
8723,Mohamed Kader,3,336.0,0,0,1,5,6,Ghana
8724,Mohamed Kallon,1,158.0,0,1,2,1,3,Sierra Leone
8725,Mohamed Kamara,0,11.0,0,0,1,0,1,Sierra Leone
8726,Mohamed Khalfi,0,70.0,0,0,2,0,2,Morocco
8727,Mohamed Konaté,2,139.0,0,0,0,2,2,Niger
8728,Mohamed Koussa,0,49.0,0,0,1,0,1,Libya
8729,Mohamed Latif,1,132.0,0,0,2,1,3,Egypt
8730,Mohamed Liban,0,21.0,0,0,0,1,1,Eswatini
8731,Mohamed M'Changama,0,70.0,0,0,0,1,1,Lesotho
8732,Mohamed Madih,0,58.0,0,0,1,0,1,Morocco
8733,Mohamed Magdy,0,9.0,0,2,2,0,2,Egypt
8734,Mohamed Maghfour,0,14.0,0,0,1,0,1,Morocco
8735,Mohamed Mesud,0,83.0,0,0,1,0,1,Ethiopia
8736,Mohamed Morsi Hussein,4,151.0,0,0,4,0,4,Egypt
8737,Mohamed Nagy,0,83.0,0,0,1,0,1,Egypt
8738,Mohamed Nazeeh,0,80.0,0,0,1,0,1,Maldives
8739,Mohamed Nizam,0,66.0,0,0,1,1,2,Mongolia
8740,Mohamed Obaid,0,48.0,0,0,1,0,1,United Arab Emirates
8741,Mohamed Obaid Al-Zahiri,1,11.0,1,0,0,1,1,United Arab Emirates
8742,Mohamed Omer,0,127.0,0,0,2,1,3,United Arab Emirates
8743,Mohamed Rashid,1,69.0,0,0,1,1,2,United Arab Emirates
8744,Mohamed Salah,5,1026.0,0,3,9,10,19,Guinea
8745,Mohamed Salah Abo Greisha,0,77.0,0,0,1,0,1,Egypt
8746,Mohamed Salah Jedidi,2,168.0,0,0,2,2,4,Tunisia
8747,Mohamed Salim,0,3.0,0,0,0,1,1,New Caledonia
8748,Mohamed Salmeen,1,113.0,1,0,1,2,3,Kyrgyzstan
8749,Mohamed Samadi,0,50.0,0,0,1,0,1,Morocco
8750,Mohamed Shawky,1,178.0,0,0,1,2,3,Egypt
8751,Mohamed Sissoko,1,79.0,0,0,1,1,2,Kenya
8752,Mohamed Sylla,0,62.0,0,0,0,1,1,Cameroon
8753,Mohamed Tayib Abdul Noor,0,83.0,0,0,1,0,1,Oman
8754,Mohamed Timoumi,0,216.0,0,0,2,2,4,Senegal
8755,Mohamed Wonkoye,1,127.0,0,1,1,1,2,Djibouti
8756,Mohamed Yattara,3,255.0,0,0,3,3,6,Guinea
8757,Mohamed Youssouf,0,72.0,0,0,0,1,1,Mozambique
8758,Mohamed Zahid Hossain,0,22.0,0,0,1,0,1,Bangladesh
8759,Mohamed Zidan,5,253.0,0,0,3,3,6,Egypt
8760,Mohammad Afash,1,318.0,0,1,6,1,7,Taiwan
8761,Mohammad Al Marmour,0,44.0,0,0,0,1,1,Lebanon
8762,Mohammad Al-Sahlawi,3,1042.0,0,5,8,11,19,Hong Kong
8763,Mohammad Al-Shalhoub,3,371.0,0,1,9,0,9,Saudi Arabia
8764,Mohammad Alavi,0,38.0,0,0,0,1,1,China PR
8765,Mohammad Hassan,1,74.0,0,0,0,1,1,Kyrgyzstan
8766,Mohammad Hassan Ansarifard,0,50.0,0,0,0,1,1,Bangladesh
8767,Mohammad Ibrahim Hussain,0,27.0,0,0,0,1,1,Brunei
8768,Mohammad Jakalan,0,30.0,0,0,0,1,1,Saudi Arabia
8769,Mohammad Kassas,0,90.0,0,0,1,0,1,Lebanon
8770,Mohammad Mohebi,0,132.0,0,0,2,0,2,Iran
8771,Mohammad Muharam,1,140.0,0,0,2,1,3,Jordan
8772,Mohammad Nasuha,0,43.0,0,0,1,0,1,Indonesia
8773,Mohammad Nosrati,1,138.0,0,0,1,1,2,Oman
8774,Mohammad Nouri,1,83.0,0,0,0,1,1,United Arab Emirates
8775,Mohammad Omar,0,122.0,0,0,1,3,4,Brunei
8776,Mohammad Reza Khalatbari,0,174.0,0,0,1,2,3,Maldives
8777,Mohammad Sadeghi,0,89.0,0,0,1,0,1,Iran
8778,Mohammad Sultan,1,25.0,0,0,0,1,1,South Korea
8779,Mohammad Umer,0,66.0,0,0,1,1,2,Pakistan
8780,Mohammadou Idrissou,1,86.0,0,0,1,0,1,Cameroon
8781,Mohammed Abdellaoue,0,163.0,0,1,1,1,2,Iceland
8782,Mohammed Abdul Ghani,0,44.0,0,0,0,1,1,Syria
8783,Mohammed Abdul Noor,2,103.0,0,0,0,2,2,Taiwan
8784,Mohammed Abduljawad,1,65.0,0,0,0,1,1,Qatar
8785,Mohammed Adolf Rishard,0,70.0,0,0,1,0,1,Tanzania
8786,Mohammed Ahmed,0,52.0,0,0,1,0,1,Ghana
8787,Mohammed Al Balushi,1,8.0,0,0,0,1,1,Iraq
8788,Mohammed Al-Anbar,0,5.0,0,0,0,1,1,South Korea
8789,Mohammed Al-Attas,0,74.0,1,0,0,1,1,United Arab Emirates
8790,Mohammed Al-Fatil,1,37.0,0,0,1,0,1,Saudi Arabia
8791,Mohammed Al-Ghafri,1,22.0,0,0,0,1,1,Bangladesh
8792,Mohammed Al-Ghassani,0,70.0,0,0,0,1,1,Turkmenistan
8793,Mohammed Al-Hardan,0,65.0,0,1,1,0,1,Bahrain
8794,Mohammed Al-Hinai,0,202.0,0,0,0,3,3,India
8795,Mohammed Al-Jaish,2,126.0,0,0,1,1,2,Palestine
8796,Mohammed Al-Khilaiwi,0,116.0,0,0,2,0,2,Saudi Arabia
8797,Mohammed Al-Musalami,1,90.0,0,0,1,0,1,Oman
8798,Mohammed Al-Suwaiti,1,4.0,0,0,0,1,1,Qatar
8799,Mohammed Ali El Khider,1,33.0,1,0,1,0,1,Cameroon
8800,Mohammed Boqshan,1,56.0,0,0,1,0,1,Yemen
8801,Mohammed Chaouch,1,158.0,0,0,5,1,6,Morocco
8802,Mohammed Diarra,0,81.0,0,0,1,0,1,Guinea
8803,Mohammed El Filali,0,91.0,0,0,2,0,2,Morocco
8804,Mohammed Gargo,1,214.0,0,1,3,0,3,Ghana
8805,Mohammed Ghaddar,0,427.0,0,2,3,4,7,Lebanon
8806,Mohammed Gholam,1,61.0,0,0,1,0,1,Qatar
8807,Mohammed Jewel Rana,2,100.0,0,0,2,0,2,Bangladesh
8808,Mohammed Jumaa,0,90.0,0,0,1,0,1,United Arab Emirates
8809,Mohammed Karam,0,90.0,0,0,1,0,1,Kuwait
8810,Mohammed Kasola,0,179.0,0,0,3,1,4,Qatar
8811,Mohammed Khalifa Al-Ammari,0,71.0,0,0,1,0,1,Qatar
8812,Mohammed Khamis Al-Araimi,0,200.0,0,0,3,1,4,Oman
8813,Mohammed Kudus,2,107.0,0,0,1,2,3,Ghana
8814,Mohammed Lashaf,0,40.0,0,0,1,0,1,Morocco
8815,Mohammed Lawal,0,120.0,0,1,1,1,2,Morocco
8816,Mohammed Muntari,1,262.0,0,0,4,2,6,Qatar
8817,Mohammed Musa,0,210.0,0,0,3,1,4,Qatar
8818,Mohammed Noor,0,192.0,0,2,2,1,3,Saudi Arabia
8819,Mohammed Ouseb,0,161.0,0,1,2,0,2,Namibia
8820,Mohammed Razak,0,89.0,0,0,1,1,2,Indonesia
8821,Mohammed Sahil,1,85.0,0,0,0,1,1,Ivory Coast
8822,Mohammed Salem,0,44.0,0,0,1,0,1,Yemen
8823,Mohammed Salem Al-Enazi,4,671.0,0,0,12,4,16,Qatar
8824,Mohammed Salem Al-Mal,0,60.0,0,0,1,0,1,Qatar
8825,Mohammed Salim,0,85.0,0,0,0,1,1,Nigeria
8826,Mohammed Salisu,1,24.0,0,0,0,1,1,South Korea
8827,Mohammed Sama,0,88.0,0,1,0,1,1,Nigeria
8828,Mohammed Sangare,0,82.0,0,1,1,0,1,Liberia
8829,Mohammed Sujan,2,162.0,0,0,2,0,2,Bangladesh
8830,Mohammed Tayeb Al Alawi,0,77.0,0,0,2,0,2,Bahrain
8831,Mohammed Zughair,0,30.0,0,0,0,1,1,Uzbekistan
8832,Mohanad Ali,4,221.0,0,0,4,3,7,Iraq
8833,Mohanad Salem,0,16.0,0,0,1,0,1,United Arab Emirates
8834,Mohannad Abdul-Raheem,6,272.0,0,0,6,0,6,Iraq
8835,Mohd Aidil Zafuan Abdul Radzak,0,8.0,0,0,0,1,1,Taiwan
8836,Mohd Amri Yahyah,0,19.0,0,0,0,1,1,Kuwait
8837,Mohd Bunyamin Omar,0,45.0,0,0,0,1,1,Bahrain
8838,Mohd Noor Ali,0,65.0,0,0,1,0,1,Singapore
8839,Mohd Rafi Ali,1,129.0,0,0,1,1,2,Indonesia
8840,Mohd Safiq Rahim,0,68.0,0,0,1,1,2,Malaysia
8841,Mohieddine Habita,0,119.0,0,1,2,0,2,Tunisia
8842,Mohsen Garousi,0,144.0,0,0,2,1,3,Thailand
8843,Mohsen Khalili,0,90.0,0,0,0,1,1,Syria
8844,Mohsen Labidi,1,36.0,0,0,1,0,1,Tunisia
8845,Mohsen Qarawi,1,53.0,0,0,1,1,2,Singapore
8846,Mohsin Al-Khaldi,0,97.0,0,0,2,0,2,Oman
8847,Mohsin Harthi,0,5.0,0,0,1,0,1,Saudi Arabia
8848,Mohsin Yousifi,0,10.0,0,0,1,0,1,Iran
8849,Moise Adilehou,1,53.0,0,0,0,1,1,Morocco
8850,Moise Brou,0,81.0,0,0,1,0,1,Gabon
8851,Moise Kean,0,183.0,0,0,4,0,4,Italy
8852,Moise Poida,1,55.0,0,0,0,1,1,American Samoa
8853,Moisés Caicedo,1,171.0,0,0,2,1,3,Ecuador
8854,Moisés Hernández,1,77.0,0,1,1,1,2,British Virgin Islands
8855,Moisés Villarroel,0,37.0,0,0,0,1,1,Bolivia
8856,Moisés Villarroel Angulo,0,53.0,0,0,1,0,1,Bolivia
8857,Mojtaba Jabbari,0,145.0,0,0,1,2,3,Iran
8858,Mokhtar Dahari,1,50.0,0,0,0,1,1,China PR
8859,Mokhtar Dhouieb,1,87.0,0,0,0,1,1,Mexico
8860,Mokhtar Kalem,1,125.0,0,0,2,0,2,Algeria
8861,Mokhtar Mokhtar,1,70.0,0,0,2,0,2,Egypt
8862,Molesi Tokuma,1,48.0,1,0,0,1,1,Samoa
8863,Momath Gueye,1,46.0,0,1,1,0,1,Senegal
8864,Momo Soumah,0,218.0,0,0,3,1,4,Guinea
8865,Momodou Ceesay,0,8.0,0,0,0,1,1,Tanzania
8866,Momčilo Vukotić,0,44.0,0,0,2,0,2,Yugoslavia
8867,Moncef Cherif,0,29.0,0,0,0,1,1,Ethiopia
8868,Moncef Khouini,0,62.0,0,0,1,0,1,Tunisia
8869,Monduone N'Kama,0,23.0,0,0,1,0,1,DR Congo
8870,Mone Wamowe,0,37.0,0,0,0,2,2,Fiji
8871,Mongi Delhoum,0,80.0,0,0,1,0,1,Tunisia
8872,Mongkol Tossakrai,1,191.0,0,0,2,1,3,Thailand
8873,Monsef Zerka,1,74.0,0,0,0,1,1,Namibia
8874,Monès Chéry,1,85.0,0,1,0,2,2,Guadeloupe
8875,Moon Jung-sik,0,110.0,0,0,2,0,2,South Korea
8876,Morciré Sylla,3,178.0,0,0,2,1,3,Guinea
8877,Mordechai Spiegler,4,449.0,0,1,6,3,9,Israel
8878,Mordon Malitoli,1,87.0,0,0,0,1,1,Sierra Leone
8879,Morgan Gould,0,14.0,0,0,0,1,1,Botswana
8880,Morten Bisgaard,0,48.0,0,0,0,1,1,Iceland
8881,Morten Gamst Pedersen,0,426.0,0,0,4,3,7,Norway
8882,Morten Nordstrand,0,128.0,0,0,2,1,3,Denmark
8883,Morten Rasmussen,0,129.0,0,0,3,0,3,Denmark
8884,Morten Wieghorst,0,147.0,0,0,0,2,2,Saudi Arabia
8885,Morteza Pouraliganji,2,173.0,0,0,2,1,3,Iran
8886,Mory Koné,0,39.0,0,0,1,0,1,Guinea
8887,Moses Chavula,0,220.0,1,0,1,2,3,Malawi
8888,Moses Chikwalakwala,0,50.0,0,0,0,2,2,Namibia
8889,Moses Msereko,1,32.0,0,0,0,1,1,Morocco
8890,Moses Ramafole,0,64.0,0,0,0,1,1,Botswana
8891,Moses Simon,1,127.0,0,0,2,1,3,Nigeria
8892,Moses Simwala,0,204.0,0,0,2,1,3,Zambia
8893,Moses Toata,1,89.0,0,0,1,0,1,Solomon Islands
8894,Moshe Leon,0,20.0,0,0,1,0,1,Israel
8895,Moshe Onana,5,336.0,0,0,5,0,5,Israel
8896,Moshe Romano,3,123.0,0,0,2,1,3,Hong Kong
8897,Moshe Selecter,0,75.0,0,0,1,0,1,Israel
8898,Moshe Sinai,0,56.0,0,0,0,1,1,Scotland
8899,Mostafa Mohamed,0,135.0,0,0,0,2,2,Gabon
8900,Mostafa Taha,0,100.0,0,0,2,0,2,Egypt
8901,Motasem Sabbou,0,87.0,0,0,0,1,1,Guinea
8902,Mothobi Mvala,0,71.0,0,0,0,1,1,Ethiopia
8903,Motohiro Yamaguchi,0,67.0,0,0,1,0,1,Japan
8904,Mouagi,1,90.0,0,0,0,1,1,Australia
8905,Mouhanad Boushi,0,163.0,0,0,3,0,3,Syria
8906,Moulay Khanousi,1,27.0,0,0,0,1,1,Tunisia
8907,Moumi Ngamaleu,0,61.0,0,1,0,1,1,Ivory Coast
8908,Moumouni Dagano,2,1008.0,0,2,10,9,19,Burkina Faso
8909,Mounir Diane,0,46.0,0,0,1,0,1,Morocco
8910,Mounir El Hamdaoui,0,83.0,0,0,1,0,1,Morocco
8911,Mourad Meziane,0,155.0,0,0,2,0,2,Algeria
8912,Mouritala Ogunbiyi,0,98.0,0,0,2,0,2,Benin
8913,Mousa Dembélé,0,315.0,0,0,5,0,5,Belgium
8914,Moussa Badiane,0,83.0,0,0,2,0,2,Senegal
8915,Moussa Camara,1,8.0,0,0,1,0,1,Guinea
8916,Moussa Diakhité,1,42.0,0,0,0,1,1,Congo
8917,Moussa Djenepo,0,19.0,0,0,0,1,1,Rwanda
8918,Moussa Doumbia,1,85.0,0,0,1,0,1,Mali
8919,Moussa Hirir,0,85.0,0,0,0,1,1,DR Congo
8920,Moussa Hojeij,0,277.0,0,0,3,1,4,Lebanon
8921,Moussa Kanfideni,0,82.0,0,0,1,1,2,Niger
8922,Moussa Konaté,0,53.0,0,0,1,0,1,Senegal
8923,Moussa Latoundji,1,90.0,0,0,0,1,1,Nigeria
8924,Moussa Mallam,0,20.0,0,0,0,1,1,Angola
8925,Moussa Marega,1,45.0,0,1,1,0,1,Mali
8926,Moussa Maâzou,2,169.0,0,1,2,2,4,Somalia
8927,Moussa N'Dao,1,56.0,0,0,0,1,1,Cameroon
8928,Moussa N'Diaye,0,248.0,0,0,2,2,4,Benin
8929,Moussa Samba,0,84.0,0,0,1,0,1,Mauritania
8930,Moussa Saïb,0,125.0,0,1,1,1,2,Algeria
8931,Moussa Sissako,0,36.0,1,0,0,1,1,Mali
8932,Moussa Sissoko,1,73.0,0,0,0,1,1,Switzerland
8933,Moussa Sow,4,424.0,0,1,4,2,6,Equatorial Guinea
8934,Moussa Traoré,2,159.0,0,0,0,2,2,Congo
8935,Moussa Wagué,1,71.0,0,0,0,1,1,Japan
8936,Moussa Yahaya,0,112.0,0,0,2,0,2,Niger
8937,Moustafa Abdou,2,155.0,0,0,6,0,6,Egypt
8938,Moustapha Bangura,0,20.0,0,0,1,0,1,Sierra Leone
8939,Moustapha Bayal Sall,1,45.0,0,0,0,1,1,Tunisia
8940,Moustapha Choukri,0,179.0,0,0,1,2,3,Senegal
8941,Moustapha Salifou,1,215.0,0,0,4,2,6,Togo
8942,Moysés Ferreira Alves,1,80.0,0,0,1,0,1,Brazil
8943,Mrisho Ngassa,0,11.0,0,0,0,1,1,Chad
8944,Mthunzi Mkhontfo,0,45.0,0,0,0,1,1,Djibouti
8945,Mu Kanazaki,0,98.0,0,0,1,1,2,Singapore
8946,Mu'nas Dabbur,0,497.0,0,1,8,3,11,Israel
8947,Muayad Al-Haddad,1,26.0,0,0,0,1,1,Iran
8948,Mubarak Anber,1,47.0,1,0,0,1,1,Qatar
8949,Mubarak Mustafa,3,613.0,0,2,8,3,11,Saudi Arabia
8950,Mubarak Wakaso,4,331.0,0,3,6,2,8,Ghana
8951,Muda Lawal,1,71.0,0,0,2,1,3,Nigeria
8952,Mudashiru Lawal,2,166.0,0,0,1,2,3,Guinea
8953,Mudather El Tahir,2,161.0,0,1,4,0,4,Sudan
8954,Muhadjiri Hakizimana,0,111.0,0,0,1,1,2,Seychelles
8955,Muhamad El-Basheer El-Asyad,0,185.0,0,0,2,0,2,Sudan
8956,Muhamed Konjić,0,37.0,0,0,1,1,2,Lithuania
8957,Muhamed Mujić,0,203.0,0,0,2,2,4,Romania
8958,Muhammad Arshad,2,29.0,0,0,1,1,2,Pakistan
8959,Muhammad Ilham,0,30.0,0,0,0,1,1,Turkmenistan
8960,Muhammad Ridwan,0,76.0,0,0,1,0,1,Indonesia
8961,Muhammet Akagündüz,0,88.0,0,0,0,1,1,Belarus
8962,Muhannad El Tahir,0,103.0,0,1,2,0,2,Sudan
8963,Muhedin Targaj,0,213.0,0,2,2,1,3,Finland
8964,Muhsen Al-Ghassani,2,250.0,0,1,3,1,4,Uzbekistan
8965,Muhsin Musabah,0,26.0,1,0,1,0,1,Qatar
8966,Mujahid Ahmed,0,231.0,0,0,2,1,3,Mozambique
8967,Mukhsin Mukhamadiev,0,80.0,0,0,1,0,1,Russia
8968,Mulugeta Kebede,0,99.0,0,0,1,1,2,Kenya
8969,Mumamba Numba,0,136.0,0,0,0,2,2,Seychelles
8970,Mumba Mwila,0,42.0,0,0,0,1,1,Tanzania
8971,Mun In-Guk,0,118.0,0,0,2,0,2,North Korea
8972,Munaf Ramadan,0,12.0,0,0,1,0,1,Syria
8973,Munif Shaef Noman,0,50.0,0,0,1,0,1,Yemen
8974,Munir El Haddadi,0,82.0,0,0,1,0,1,Morocco
8975,Munther Abu Amarah,0,33.0,0,0,0,1,1,Bangladesh
8976,Munthir Khalaf,1,152.0,0,0,0,2,2,Jordan
8977,Murad Alyan,1,117.0,0,0,2,1,3,Afghanistan
8978,Murad Hüseynov,0,89.0,0,0,1,0,1,Azerbaijan
8979,Murat Yakin,0,134.0,0,0,1,2,3,Finland
8980,Murray Barnes,0,56.0,0,0,1,1,2,Australia
8981,Murtaz Khurtsilava,0,73.0,0,0,2,0,2,Russia
8982,Musa Al-Taamari,1,26.0,0,0,1,0,1,Jordan
8983,Musa Barrow,2,161.0,0,1,1,1,2,Gambia
8984,Musa Noah Kamara,1,55.0,0,0,0,1,1,Ivory Coast
8985,Musa Otieno,0,183.0,0,0,2,1,3,Kenya
8986,Musa Shannon,0,89.0,0,0,0,1,1,Ghana
8987,Musab Al-Battat,0,9.0,0,0,0,1,1,Malaysia
8988,Musaed Neda,0,202.0,0,0,2,2,4,Kuwait
8989,Muslim Agaev,0,136.0,0,0,0,3,3,Vietnam
8990,Mussab Al-Laham,0,30.0,0,0,1,0,1,Jordan
8991,Mussad Nur,1,38.0,0,0,1,0,1,Egypt
8992,Mustafa Denizli,0,25.0,0,0,0,1,1,Malta
8993,Mustafa El Haddaoui,0,62.0,0,0,2,0,2,Morocco
8994,Mustafa Ertan,1,21.0,0,0,0,1,1,Germany
8995,Mustafa Karim,1,48.0,0,0,1,0,1,Iraq
8996,Mustafa Shehdeh,0,90.0,0,0,1,0,1,Jordan
8997,Mustafa Zazai,1,128.0,0,0,1,1,2,Cambodia
8998,Mustamu Yessy,0,67.0,0,0,0,1,1,Hong Kong
8999,Mustapha Hadji,2,229.0,0,0,2,2,4,Ghana
9000,Mustapha Jarju,0,112.0,0,0,2,1,3,Liberia
9001,Mustapha Merry,0,242.0,0,1,3,1,4,Sierra Leone
9002,Mustapha Tahir,1,62.0,0,0,0,2,2,Tunisia
9003,Mustapha Yaghcha,0,25.0,0,1,0,1,1,Cameroon
9004,Mustapha Yatabaré,0,90.0,0,0,0,1,1,Angola
9005,Mustaqim,0,60.0,0,0,1,0,1,Indonesia
9006,Mutaz Kablan,0,45.0,0,0,2,0,2,Libya
9007,Muteba N'Daye,0,169.0,0,0,2,1,3,DR Congo
9008,Mutiu Adepoju,4,204.0,0,0,2,3,5,Nigeria
9009,Mwape Miti,0,85.0,0,0,1,0,1,Zambia
9010,Mwepu Ilunga,0,41.0,1,0,1,0,1,Egypt
9011,Mxolisi Lukhele,0,84.0,0,0,0,1,1,Djibouti
9012,Myer Bevan,0,14.0,0,0,0,1,1,Solomon Islands
9013,Mykola Shaparenko,0,44.0,0,0,1,0,1,Ukraine
9014,Myles Weston,0,72.0,0,1,1,0,1,Antigua and Barbuda
9015,Myron Boadu,0,87.0,0,0,1,0,1,Netherlands
9016,Myron Samuel,0,145.0,0,1,2,2,4,Saint Vincent and the Grenadines
9017,Myrto Uzuni,0,165.0,0,0,1,1,2,San Marino
9018,Mágico González,0,277.0,0,0,4,2,6,Nicaragua
9019,Márcio Amoroso,4,179.0,0,0,3,1,4,Brazil
9020,Márcio Roberto dos Santos,1,66.0,0,0,1,0,1,Brazil
9021,Márcio Santos,1,54.0,0,0,1,0,1,Brazil
9022,Mário Coluna,0,328.0,0,0,5,1,6,German DR
9023,Mário Fernandes,0,310.0,0,0,2,2,4,Russia
9024,Mário Moínhos,0,87.0,0,0,0,1,1,Cyprus
9025,Mário Zagallo,1,124.0,0,0,1,1,2,Sweden
9026,Márton Esterházy,1,118.0,0,0,2,1,3,Hungary
9027,Máté Fenyvesi,0,101.0,0,0,1,2,3,Netherlands
9028,Máté Pátkai,0,156.0,0,0,2,0,2,Hungary
9029,Máximo Alcócer,2,576.0,0,0,11,0,11,Bolivia
9030,Máximo Mosquera,3,278.0,0,0,3,3,6,Paraguay
9031,Máximo Rolón,6,306.0,0,1,3,4,7,Argentina
9032,Máximo Tenorio,0,65.0,0,0,1,0,1,Ecuador
9033,Mërgim Mavraj,0,81.0,1,0,1,1,2,Albania
9034,Mërgim Vojvoda,0,105.0,1,0,2,0,2,Kosovo
9035,Míchel,5,724.0,1,7,10,7,17,Spain
9036,Müller,4,205.0,0,0,5,0,5,Brazil
9037,Mārcis Ošs,0,65.0,0,0,1,0,1,Latvia
9038,Māris Verpakovskis,1,952.0,0,1,9,14,23,Greece
9039,N'Kiambi Mapuata,0,56.0,0,0,2,0,2,DR Congo
9040,Na Sang-ho,0,13.0,0,0,0,1,1,Turkmenistan
9041,Nabeel Mubar Al Siyabi,0,98.0,0,0,2,0,2,Oman
9042,Nabil Al-Siyabi,1,74.0,0,0,0,1,1,Taiwan
9043,Nabil Ashoor,0,27.0,1,0,0,1,1,Oman
9044,Nabil Baha,1,90.0,0,0,1,0,1,Morocco
9045,Nabil Bentaleb,1,148.0,0,0,0,2,2,Senegal
9046,Nabil Dirar,0,24.0,0,0,0,1,1,Ivory Coast
9047,Nabil El Zhar,0,49.0,0,0,1,0,1,Morocco
9048,Nabil Ghilas,0,78.0,0,0,0,1,1,Benin
9049,Nabil Maâloul,0,85.0,0,1,2,0,2,Tunisia
9050,Nabil Nano,1,65.0,0,0,1,0,1,Syria
9051,Nabil Taïder,0,24.0,0,0,0,1,1,Nigeria
9052,Naby Keïta,2,199.0,0,0,3,2,5,Namibia
9053,Naby Laye Camara,0,52.0,0,1,1,0,1,Guinea
9054,Naby Soumah,1,86.0,0,0,0,1,1,Botswana
9055,Nacer Bouiche,1,44.0,0,0,1,0,1,Algeria
9056,Nacer Chadli,1,352.0,0,0,4,2,6,Belgium
9057,Nacho,1,58.0,0,0,0,1,1,Portugal
9058,Nacho Monreal,0,84.0,0,0,1,0,1,Spain
9059,Nader Joukhadar,2,191.0,0,0,3,2,5,Japan
9060,Nader Kara,0,168.0,0,0,2,1,3,Sudan
9061,Nader Matar,0,64.0,0,0,1,0,1,Lebanon
9062,Nadir Belhadj,0,45.0,0,0,1,0,1,Algeria
9063,Naea Bennett,4,209.0,0,0,0,4,4,Vanuatu
9064,Naeem Saddam,2,134.0,0,0,1,1,2,Pakistan
9065,Naeim Saadavi,1,38.0,0,0,0,1,1,Thailand
9066,Nahki Wells,2,419.0,0,2,5,2,7,Bermuda
9067,Nahuel Molina,1,35.0,0,0,0,1,1,Netherlands
9068,Nahum Stelmach,4,422.0,0,0,8,1,9,Hong Kong
9069,Naif Hazazi,1,350.0,0,0,2,3,5,Iran
9070,Naiz Hassan,0,90.0,0,0,1,0,1,Maldives
9071,Najeh Braham,0,132.0,0,0,1,1,2,Tunisia
9072,Najwan Ghrayib,0,157.0,0,0,1,1,2,San Marino
9073,Naldo Kwasie,0,81.0,0,0,1,0,1,Suriname
9074,Nam Song-Chol,0,61.0,0,0,0,1,1,Japan
9075,Nam Tae-hee,1,234.0,0,0,3,1,4,Kuwait
9076,Nana Arhin Duah,0,81.0,0,0,2,0,2,Ghana
9077,Nando Maria Neves,1,33.0,1,0,0,1,1,Cape Verde
9078,Nang Yan Leung,0,75.0,0,0,0,2,2,Indonesia
9079,Nani,5,557.0,0,0,10,6,16,Belgium
9080,Naohiro Takahara,9,360.0,0,0,6,4,10,Saudi Arabia
9081,Naoki Soma,2,135.0,0,0,1,1,2,Japan
9082,Narasek Boongeang,0,76.0,0,0,0,1,1,India
9083,Narcisse Yaméogo,0,90.0,0,0,1,0,1,Burkina Faso
9084,Narender Thapa,0,89.0,0,0,1,0,1,India
9085,Narubadin Weerawatnodom,1,5.0,0,0,1,0,1,Thailand
9086,Nasema,1,85.0,0,0,1,0,1,Fiji
9087,Naser Al-Sauhi,1,72.0,0,0,0,1,1,Bahrain
9088,Nashat Akram,4,415.0,0,1,3,6,9,Saudi Arabia
9089,Nasir Khamees,0,10.0,0,0,1,0,1,Qatar
9090,Nasir Khamees Mubarak,0,38.0,0,0,1,0,1,United Arab Emirates
9091,Nasko Sirakov,2,640.0,0,0,8,6,14,Norway
9092,Nasr Eddin Abbas,4,420.0,0,0,2,4,6,Egypt
9093,Nasr El-Din Abbas,0,66.0,0,0,1,1,2,Nigeria
9094,Nasreddine Kraouche,1,90.0,0,0,0,1,1,Liberia
9095,Nasser Al-Gahwashi,1,85.0,0,0,1,0,1,Yemen
9096,Nasser Al-Shamrani,0,368.0,0,0,5,2,7,Saudi Arabia
9097,Nasser Bouiche,1,94.0,0,0,2,0,2,Algeria
9098,Nasser Kamil Mubarak,0,42.0,0,0,0,1,1,Laos
9099,Nasser Khaleefa,0,90.0,0,0,0,1,1,Iraq
9100,Nasser Mohammadkhani,3,224.0,0,0,2,1,3,Iran
9101,Nasser Nouraei,0,127.0,0,0,3,0,3,Iran
9102,Nasser Zayid,0,62.0,0,1,1,0,1,Oman
9103,Nassim Akrour,1,214.0,0,0,3,1,4,Liberia
9104,Nassir Al-Ghanem,0,130.0,0,0,2,0,2,Kuwait
9105,Nassoro Mashoto,0,58.0,0,0,1,0,1,Tanzania
9106,Nastja Čeh,0,181.0,0,0,4,1,5,Slovenia
9107,Nat Lofthouse,3,323.0,0,0,2,4,6,Wales
9108,Nate Burkey,0,50.0,0,0,0,1,1,Sri Lanka
9109,Nathalie Suiverstin,0,18.0,0,0,1,0,1,Madagascar
9110,Nathan Aké,0,19.0,0,0,1,0,1,Netherlands
9111,Nathan Blake,0,159.0,0,0,2,2,4,Moldova
9112,Nathan Burns,0,183.0,0,0,3,0,3,Australia
9113,Nathan Fasika,0,66.0,0,0,0,1,1,Tanzania
9114,Nathan Patterson,0,38.0,0,0,0,1,1,Moldova
9115,Nathan Pond,1,39.0,0,0,1,0,1,Montserrat
9116,Nathan Sinkala,0,71.0,0,0,0,1,1,Ghana
9117,Nathaniel Lepani,0,55.0,0,0,0,1,1,Samoa
9118,Natia Natia,1,39.0,0,0,1,0,1,American Samoa
9119,Natipong Sritong-In,0,122.0,0,0,1,1,2,Thailand
9120,Natiq Hashim,0,85.0,0,0,1,0,1,Iraq
9121,Nauris Bulvītis,0,20.0,0,0,1,0,1,Latvia
9122,Nawaf Al-Abed,3,428.0,0,4,2,4,6,North Korea
9123,Nawaf Al-Temyat,3,304.0,0,1,1,3,4,Mexico
9124,Nawaf Humaidan,0,70.0,0,0,0,1,1,Hong Kong
9125,Nawaf Mubarak,0,90.0,0,0,1,0,1,United Arab Emirates
9126,Nawayug Shrestha,1,80.0,0,0,1,0,1,Nepal
9127,Nayef Aguerd,2,131.0,2,0,3,0,3,Morocco
9128,Nayef Mubarak Al Khater,0,75.0,0,0,1,0,1,Qatar
9129,Nazar Ashraf,1,34.0,0,0,1,0,1,Iraq
9130,Nazar Bayramov,1,6.0,0,0,0,1,1,Saudi Arabia
9131,Nazar Baýramow,0,83.0,0,0,2,0,2,Turkmenistan
9132,Nazim Suleymanov,1,198.0,0,2,2,1,3,Slovakia
9133,Nazir McBurnette,0,90.0,0,0,0,1,1,Guatemala
9134,Naïm Sliti,3,165.0,0,1,0,3,3,Algeria
9135,Nchimunya Mweetwa,0,114.0,0,0,0,2,2,Liberia
9136,Ndaye Mulamba,8,554.0,0,0,4,6,10,Guinea
9137,Ndubuisi Okosieme,1,33.0,0,0,0,1,1,Kenya
9138,Necati Ateş,0,55.0,0,2,2,0,2,Turkey
9139,Neco,2,280.0,0,0,7,1,8,Argentina
9140,Neco Williams,0,20.0,0,0,1,0,1,Wales
9141,Ned Zelić,0,63.0,0,0,3,0,3,Australia
9142,Nedim Doğan,0,48.0,0,0,1,0,1,Turkey
9143,Nedžmedin Memedi,0,60.0,0,0,0,1,1,Iceland
9144,Neeskens Kebano,1,154.0,0,0,1,2,3,Guinea
9145,Neftali Díaz,0,70.0,0,0,1,0,1,Panama
9146,Neider Morantes,3,73.0,0,0,3,0,3,Colombia
9147,Neil Danns,3,314.0,0,3,4,1,5,Guyana
9148,Neil Jones,1,72.0,0,0,1,0,1,New Zealand
9149,Neil Lennon,0,92.0,0,0,2,0,2,Northern Ireland
9150,Neil McCann,0,157.0,0,0,1,2,3,Latvia
9151,Neil Paynter,0,66.0,0,0,0,1,1,Jamaica
9152,Neil Slatter,0,68.0,0,0,0,1,1,Finland
9153,Neil Taylor,1,20.0,0,0,0,1,1,Russia
9154,Neil Webb,0,171.0,0,0,2,0,2,England
9155,Nejc Pečnik,0,337.0,0,0,1,3,4,Slovakia
9156,Nelinho,2,172.0,0,1,5,0,5,Brazil
9157,Nelson Abeijon,0,83.0,0,0,1,0,1,Uruguay
9158,Nelson Barahona,1,202.0,0,0,2,1,3,Panama
9159,Nelson Bonilla,3,490.0,0,0,3,6,9,Saint Kitts and Nevis
9160,Nelson Cuevas,3,235.0,0,0,1,2,3,Slovenia
9161,Nelson Gabolwelwe,0,69.0,0,0,2,0,2,Botswana
9162,Nelson Luís Kerchner,1,72.0,0,0,1,0,1,Brazil
9163,Nelson Melgar,0,88.0,0,0,1,0,1,Guatemala
9164,Nelson Moreno,1,30.0,0,0,0,1,1,Ecuador
9165,Nelson Peña,0,73.0,0,0,1,0,1,Dominican Republic
9166,Nelson Pérez,1,27.0,0,0,1,0,1,Colombia
9167,Nelson Sale,0,21.0,1,0,0,1,1,Solomon Islands
9168,Nelson Valdez,2,365.0,0,0,4,4,8,Venezuela
9169,Nemanja Matić,0,144.0,0,0,0,2,2,Portugal
9170,Nemanja Nikolić,0,214.0,0,1,1,2,3,Hungary
9171,Nemanja Radonjić,0,125.0,0,0,1,1,2,Luxembourg
9172,Nemesio Mosquera,1,54.0,0,0,0,2,2,Ecuador
9173,Nemesio Rojas,1,77.0,0,0,1,0,1,Bolivia
9174,Nenad Jestrović,0,98.0,0,0,0,2,2,San Marino
9175,Nenad Milijaš,0,19.0,0,2,2,0,2,Serbia
9176,Nenad Stojković,0,36.0,0,0,0,1,1,Bulgaria
9177,Nené,1,493.0,0,0,6,6,12,Portugal
9178,Nermin Šabić,0,69.0,0,0,1,0,1,Bosnia and Herzegovina
9179,Nery Castillo,5,225.0,0,2,4,2,6,Mexico
9180,Nery Medina,0,52.0,0,0,0,1,1,United States
9181,Nesley Jean,0,160.0,0,0,1,2,3,Bahamas
9182,Nestor Subiat,0,158.0,0,0,0,2,2,Hungary
9183,Nestoras Mitidis,0,152.0,0,0,1,3,4,Andorra
9184,Neto,1,5.0,0,1,0,1,1,Bolivia
9185,Neven Subotić,0,69.0,0,0,0,1,1,Faroe Islands
9186,Ney Avilés,3,324.0,0,0,3,3,6,Chile
9187,Neymar,7,1504.0,0,8,24,7,31,Brazil
9188,Ng Chi Kit,0,44.0,1,0,0,1,1,Macau
9189,Ng Wai Chiu,0,17.0,0,0,0,1,1,Malaysia
9190,Ngasanya Ilongo,0,58.0,0,0,1,0,1,DR Congo
9191,Ngidi Yemweni,0,328.0,0,0,4,1,5,Djibouti
9192,Nguyen Cong Vinh,0,71.0,0,0,0,1,1,Turkmenistan
9193,Nguyen Hong Son,1,30.0,0,0,0,1,1,Indonesia
9194,Nguyễn Công Phượng,3,160.0,0,0,1,2,3,Iraq
9195,Nguyễn Hồng Sơn,5,241.0,0,2,2,3,5,Mongolia
9196,Nguyễn Lương Phúc,2,90.0,0,0,2,0,2,Vietnam
9197,Nguyễn Minh Hải,0,13.0,0,0,1,0,1,Vietnam
9198,Nguyễn Ngọc Thanh,0,67.0,0,0,1,0,1,Vietnam
9199,Nguyễn Quang Hải,2,241.0,0,0,4,2,6,Macau
9200,Nguyễn Thanh Bình,0,19.0,0,0,0,1,1,Japan
9201,Nguyễn Tiến Linh,3,413.0,0,0,3,5,8,Indonesia
9202,Nguyễn Trung Vĩnh,1,77.0,0,0,0,1,1,Bangladesh
9203,Nguyễn Trọng Hoàng,0,60.0,0,0,1,0,1,Vietnam
9204,Nguyễn Vinh Quang,1,54.0,1,0,0,1,1,Vietnam Republic
9205,Nguyễn Văn Quyết,0,89.0,0,0,1,0,1,Vietnam
9206,Nguyễn Văn Sỹ,1,65.0,0,0,0,1,1,Bangladesh
9207,Nguyễn Văn Toàn,0,71.0,0,0,2,0,2,Vietnam
9208,Nguyễn Văn Tu,0,70.0,0,0,0,1,1,South Korea
9209,Niall McGinn,1,310.0,0,0,1,4,5,Portugal
9210,Niall Quinn,1,646.0,0,0,10,4,14,Republic of Ireland
9211,Niall Reid-Stephen,0,42.0,0,0,0,1,1,Dominican Republic
9212,Nian Weisi,0,9.0,0,0,1,0,1,China PR
9213,Nicaise Ondeno,0,32.0,0,0,1,0,1,Gabon
9214,Nicaise Zimbori-Auzingoni,0,79.0,0,0,0,2,2,Botswana
9215,Nicholas Gioacchini,0,90.0,0,0,1,0,1,United States
9216,Nicholas Ioannou,0,98.0,0,0,0,2,2,Kazakhstan
9217,Nick Dasovic,1,166.0,1,0,2,1,3,Canada
9218,Nick Deacy,0,135.0,0,0,2,0,2,Wales
9219,Nick Papadakis,0,100.0,0,0,2,0,2,Canada
9220,Nicki Bille Nielsen,0,84.0,0,0,1,0,1,Denmark
9221,Nicklas Bendtner,3,936.0,0,1,9,8,17,Northern Ireland
9222,Nicko Williams,0,67.0,1,0,0,1,1,Grenada
9223,Nicky Barmby,0,24.0,0,0,0,1,1,Moldova
9224,Nicky Saliba,1,6.0,0,0,0,1,1,Serbia
9225,Niclas Alexandersson,1,261.0,0,0,3,2,5,Sweden
9226,Niclas Füllkrug,2,172.0,0,0,0,2,2,Spain
9227,Niclas Nyhlén,0,90.0,0,0,1,0,1,Sweden
9228,Nico Braun,0,122.0,0,1,4,1,5,Luxembourg
9229,Nico Claesen,3,580.0,0,1,5,6,11,Belgium
9230,Nico Schulz,0,90.0,0,0,0,1,1,Netherlands
9231,Nico Van Kerckhoven,0,28.0,0,0,1,0,1,Belgium
9232,Nicodème Kabamba,2,78.0,0,1,0,2,2,Congo
9233,Nicola Albani,0,59.0,0,0,0,1,1,Latvia
9234,Nicola Bacciocchi,0,53.0,0,0,0,1,1,Turkey
9235,Nicola Nanni,0,48.0,0,0,1,0,1,San Marino
9236,Nicolae Dică,0,200.0,0,1,2,2,4,Albania
9237,Nicolae Dobrin,0,211.0,0,0,4,2,6,Italy
9238,Nicolae Georgescu,0,56.0,0,0,1,1,2,Romania
9239,Nicolae Josan,0,43.0,0,0,1,1,2,Moldova
9240,Nicolae Lupescu,0,46.0,0,0,1,1,2,Finland
9241,Nicolae Milinceanu,0,140.0,0,0,1,1,2,Moldova
9242,Nicolae Mitea,0,76.0,0,0,0,2,2,North Macedonia
9243,Nicolae Oaidă,0,62.0,0,0,1,0,1,Romania
9244,Nicolae Pantea,0,55.0,0,0,1,0,1,Romania
9245,Nicolae Stanciu,0,112.0,0,0,0,2,2,Armenia
9246,Nicolae Tătaru,0,66.0,0,0,2,0,2,Romania
9247,Nicolae Ungureanu,0,48.0,0,0,1,0,1,Romania
9248,Nicolai Jørgensen,0,166.0,0,0,1,2,3,Sweden
9249,Nicolas Anelka,0,495.0,0,0,4,5,9,Russia
9250,Nicolas Hasler,0,61.0,0,0,0,1,1,Bosnia and Herzegovina
9251,Nicolas Hoffmann,0,83.0,0,0,1,0,1,Luxembourg
9252,Nicolas Lombaerts,0,89.0,0,0,1,0,1,Belgium
9253,Nicolas Nkoulou,1,59.0,0,0,0,1,1,Egypt
9254,Nicolas Pépé,3,121.0,0,0,3,0,3,Ivory Coast
9255,Nicolas Vallar,3,47.0,1,2,2,1,3,Tahiti
9256,Nicolás Falero,7,376.0,0,0,0,9,9,Bolivia
9257,Nicolás González,0,92.0,0,0,2,1,3,Argentina
9258,Nicolás Lodeiro,2,165.0,0,0,3,1,4,Uruguay
9259,Nicolás Martínez,0,6.0,0,0,1,0,1,Cuba
9260,Nicolás Olivera,2,282.0,0,1,3,3,6,United Arab Emirates
9261,Nicolás Otamendi,1,89.0,0,0,1,1,2,Argentina
9262,Nicolás Ramírez,0,78.0,1,0,1,1,2,United States
9263,Nicolás Suazo,0,359.0,0,0,5,3,8,Honduras
9264,Nicolás Tellez,0,34.0,0,0,1,0,1,Mexico
9265,Nicolò Barella,1,90.0,0,0,2,2,4,Italy
9266,Nicolò Zaniolo,0,73.0,0,0,2,0,2,Italy
9267,Nicos Kantzilieris,0,47.0,0,0,0,1,1,Austria
9268,Nicușor Bancu,0,87.0,0,0,0,1,1,Liechtenstein
9269,Niel Hans,1,89.0,0,1,1,0,1,Papua New Guinea
9270,Niels Tune-Hansen,0,19.0,0,0,0,1,1,Cyprus
9271,Nigel Bishop,0,34.0,0,0,1,0,1,Grenada
9272,Nigel Codrington,0,84.0,0,0,1,0,1,Guyana
9273,Nigel Dabinyaba,0,259.0,0,0,4,0,4,Papua New Guinea
9274,Nigel Hasselbaink,4,307.0,0,0,4,3,7,Aruba
9275,Nigel Pierre,0,164.0,0,1,2,1,3,Dominican Republic
9276,Nigel de Jong,0,8.0,0,0,0,1,1,Iceland
9277,Niginho,2,134.0,0,0,2,0,2,Brazil
9278,Nihad Al Boushi,0,166.0,0,0,4,0,4,Syria
9279,Nihad Boshi,1,244.0,0,0,2,2,4,Syria
9280,Nihat Kahveci,3,699.0,0,0,6,6,12,Moldova
9281,Nihat Yayöz,0,83.0,0,0,0,1,1,Poland
9282,Nik Viljoen,0,80.0,0,0,1,0,1,New Zealand
9283,Nika Kacharava,0,6.0,0,0,1,0,1,Georgia
9284,Niki Temiha,1,4.0,0,0,0,1,1,Solomon Islands
9285,Niki Zimling,0,83.0,0,0,0,1,1,Czech Republic
9286,Nikica Jelavić,1,112.0,0,0,1,1,2,Republic of Ireland
9287,Nikita Naumov,0,48.0,0,0,0,1,1,Estonia
9288,Nikita Simonyan,2,121.0,0,0,1,4,5,Russia
9289,Niklas Moisander,0,77.0,0,0,1,0,1,Finland
9290,Niko Kata,1,75.0,1,0,1,0,1,South Sudan
9291,Niko Kovač,2,307.0,0,0,5,3,8,San Marino
9292,Niko Kranjčar,0,468.0,0,1,3,7,10,Bulgaria
9293,Nikodimos Papavasiliou,0,143.0,0,0,1,2,3,Faroe Islands
9294,Nikola Drinčić,0,27.0,0,0,1,0,1,Montenegro
9295,Nikola Jerkan,0,58.0,0,0,1,0,1,Croatia
9296,Nikola Jurčević,0,55.0,0,0,0,1,1,Slovenia
9297,Nikola Kalinić,2,432.0,0,0,6,1,7,Croatia
9298,Nikola Kotkov,0,199.0,0,1,6,0,6,Bulgaria
9299,Nikola Lazetić,1,52.0,0,0,1,0,1,Serbia
9300,Nikola Milenković,0,245.0,1,0,3,0,3,Serbia
9301,Nikola Tsanev,0,61.0,0,0,2,0,2,Bulgaria
9302,Nikola Vlašić,0,217.0,0,0,2,3,5,Slovakia
9303,Nikola Vujnović,0,86.0,0,0,1,0,1,Montenegro
9304,Nikola Vukčević,0,59.0,0,0,1,0,1,Montenegro
9305,Nikola Žigić,1,869.0,0,0,9,5,14,Ivory Coast
9306,Nikolai Pisarev,0,72.0,0,0,1,0,1,Russia
9307,Nikolaos Karelis,0,24.0,0,0,0,1,1,Finland
9308,Nikolas Ledgerwood,0,53.0,0,0,1,0,1,Canada
9309,Nikolay Bodurov,0,79.0,1,0,0,2,2,Bulgaria
9310,Nikolay Iliev,0,84.0,0,0,1,0,1,Bulgaria
9311,Nikolay Komlichenko,0,78.0,0,0,0,1,1,San Marino
9312,Nikolay Larionov,0,86.0,0,0,1,0,1,Russia
9313,Nikolay Shirshov,0,257.0,0,0,4,2,6,Uzbekistan
9314,Nikolay Todorov,0,198.0,0,0,1,2,3,Romania
9315,Nikoloz Gelashvili,1,9.0,0,0,0,1,1,Gibraltar
9316,Nikolče Noveski,0,107.0,0,0,1,2,3,Andorra
9317,Nikos Anastopoulos,1,515.0,0,1,8,5,13,Greece
9318,Nikos Charalambous,0,42.0,0,0,1,0,1,Cyprus
9319,Nikos Liberopoulos,0,404.0,0,0,4,2,6,Greece
9320,Nikos Machlas,0,669.0,0,1,8,3,11,Luxembourg
9321,Nikos Nioplias,0,49.0,0,0,1,0,1,Greece
9322,Nikos Pantziaras,0,93.0,1,0,2,0,2,Cyprus
9323,Nikos Patikkis,0,58.0,1,0,0,1,1,Cyprus
9324,Nikos Spyropoulos,0,188.0,1,0,1,2,3,Greece
9325,Nikos Tsiantakis,0,37.0,0,0,1,0,1,Greece
9326,Nildeson,0,123.0,0,0,2,1,3,El Salvador
9327,Nilmar,0,300.0,0,0,4,1,5,Brazil
9328,Nilo Braga,3,228.0,0,0,2,4,6,Argentina
9329,Nils Liedholm,0,130.0,0,1,3,0,3,Sweden
9330,Nils Rikberg,0,70.0,0,0,1,0,1,Finland
9331,Nils-Åke Sandell,0,165.0,0,0,2,2,4,Finland
9332,Nininho,0,141.0,0,0,3,0,3,Brazil
9333,Nir Bitton,0,131.0,0,0,2,1,3,Israel
9334,Nir Klinger,0,37.0,0,0,0,1,1,New Zealand
9335,Nir Sivilia,0,84.0,0,0,1,0,1,Israel
9336,Nirajan Rayamajhi,6,310.0,0,0,2,5,7,Iraq
9337,Nirut Surasiang,0,114.0,0,0,0,2,2,Yemen
9338,Nissim Cohen,0,67.0,0,0,1,0,1,Israel
9339,Nitder Pizzani,0,94.0,0,0,2,0,2,Uruguay
9340,Nitsavong Khouphachansy,0,135.0,1,0,0,2,2,Philippines
9341,Niwat Srisawat,2,124.0,0,0,1,1,2,Malaysia
9342,Niweat Siriwong,0,168.0,0,0,2,0,2,Thailand
9343,Nizar Khalfan,0,19.0,0,0,0,1,1,Mauritius
9344,Nizar Mahrous,1,363.0,0,0,3,3,6,Bahrain
9345,Njiva Rakotoharimalala,0,135.0,0,0,3,1,4,Madagascar
9346,Njogu Demba-Nyrén,0,90.0,0,0,2,0,2,Gambia
9347,Nkau Lerotholi,0,50.0,1,0,0,1,1,Lesotho
9348,Nkiere Wawa,0,61.0,0,0,1,0,1,DR Congo
9349,Nnamdi Oduamadi,3,202.0,0,0,1,3,4,Nigeria
9350,Noah Frick,0,80.0,0,0,0,1,1,Armenia
9351,Noah Frommelt,0,83.0,1,0,0,1,1,Liechtenstein
9352,Noah Hickey,0,130.0,0,0,2,0,2,New Zealand
9353,Noah Okafor,0,48.0,0,0,1,0,1,Switzerland
9354,Noel Barkley,0,57.0,0,0,1,0,1,New Zealand
9355,Noel Berry,3,321.0,0,0,6,1,7,Solomon Islands
9356,Noel Brotherston,0,24.0,0,0,1,0,1,Northern Ireland
9357,Noel Cantwell,0,406.0,0,2,5,1,6,Republic of Ireland
9358,Noel Mkandawire,0,230.0,0,0,3,1,4,Guinea
9359,Noel Valladares,1,48.0,1,0,1,0,1,France
9360,Noh Alam Shah,1,197.0,0,0,1,2,3,Singapore
9361,Noh Jung-yoon,1,143.0,0,0,2,0,2,South Korea
9362,Noh Soo-Jin,0,176.0,0,0,1,2,3,South Korea
9363,Nolberto Molina,0,60.0,0,1,1,0,1,Colombia
9364,Nolberto Solano,1,439.0,0,2,5,4,9,Mexico
9365,Nolito,1,100.0,0,0,1,1,2,Spain
9366,Nontapan Jeansatawong,0,10.0,0,0,1,0,1,Thailand
9367,Norbert Eschmann,0,81.0,0,0,1,0,1,Switzerland
9368,Norbert Hof,0,85.0,0,0,1,0,1,Austria
9369,Norbert Owona,0,101.0,0,0,1,1,2,Nigeria
9370,Norberto Conde,0,61.0,0,0,0,1,1,Chile
9371,Norberto Doroteo Méndez,10,667.0,0,0,15,2,17,Argentina
9372,Norberto Maurito,1,86.0,0,0,1,0,1,Angola
9373,Norberto Menéndez,1,173.0,0,0,3,1,4,Chile
9374,Norfran Lazo,0,63.0,0,0,1,0,1,Nicaragua
9375,Norio Omura,1,86.0,0,0,0,2,2,Oman
9376,Norival Pereira Da Silva,1,63.0,0,0,1,0,1,Brazil
9377,Norjmoogiin Tsedenbal,0,113.0,0,2,2,1,3,Mongolia
9378,Norlla Amiri,2,122.0,0,0,1,1,2,Syria
9379,Norm McLeod,0,32.0,0,0,1,0,1,Canada
9380,Norman Forde,0,35.0,0,0,0,1,1,Grenada
9381,Norman Hunter,0,122.0,0,0,1,1,2,Spain
9382,Norman Lockhart,0,72.0,0,1,1,0,1,Northern Ireland
9383,Norman Patterson,0,79.0,0,0,1,0,1,Canada
9384,Norman Whiteside,1,331.0,0,0,5,2,7,Northern Ireland
9385,Norshahrul Idlan,0,43.0,0,0,1,0,1,Malaysia
9386,Noud van Melis,0,97.0,0,0,1,2,3,Austria
9387,Noureddine Naybet,0,24.0,0,0,1,0,1,Morocco
9388,Nourken Mazbaev,0,57.0,0,0,1,1,2,Pakistan
9389,Nourredine Kourichi,0,53.0,0,0,1,0,1,Algeria
9390,Novatus Dismas,0,26.0,0,0,1,0,1,Tanzania
9391,Nowend Lorenzo,2,71.0,0,0,0,2,2,Anguilla
9392,Noël Birindi Minga,1,112.0,0,0,1,1,2,Cameroon
9393,Noël Kouamé,0,59.0,0,0,1,1,2,Ivory Coast
9394,Noël Minga,0,88.0,0,0,1,0,1,Congo
9395,Nqobizitha Ncube,0,20.0,0,0,1,0,1,Zimbabwe
9396,Nsumbu Ngoy,0,55.0,0,0,0,1,1,Tunisia
9397,Numon Khasanov,0,45.0,0,0,1,1,2,Yemen
9398,Numondzhon Khakimov,0,280.0,0,2,3,2,5,Bangladesh
9399,Nuno Gomes,9,1007.0,0,0,7,11,18,Portugal
9400,Nuno Miguel Monteiro Rocha,0,71.0,0,1,2,0,2,Cape Verde
9401,Nurbol Zhumaskaliyev,0,61.0,0,0,1,0,1,Kazakhstan
9402,Nurdin Bakari,0,80.0,0,0,0,1,1,Chad
9403,Nwankwo Kanu,0,379.0,0,1,5,1,6,Nigeria
9404,Nyam-Osor Naranbold,0,69.0,0,0,1,0,1,Mongolia
9405,Nyasha Mushekwi,1,29.0,0,1,0,1,1,Algeria
9406,Nyron Nosworthy,0,18.0,0,0,1,0,1,Jamaica
9407,Nzelo Hervé Lembi,0,13.0,0,0,1,0,1,DR Congo
9408,Nándor Hidegkuti,4,192.0,0,0,1,5,6,Germany
9409,Néjib Ghommidh,1,79.0,0,0,0,1,1,Mexico
9410,Néjib Liman,0,40.0,0,0,2,0,2,Tunisia
9411,Nélson Oliveira,0,85.0,0,0,1,0,1,Portugal
9412,Nélson Veiga,0,62.0,1,0,1,0,1,Ghana
9413,Néstor Araujo,1,115.0,0,0,1,2,3,Chile
9414,Néstor Ayala,0,82.0,0,0,1,0,1,Paraguay
9415,Néstor Azón,1,84.0,0,0,0,1,1,Brazil
9416,Néstor Clausen,0,88.0,0,0,1,0,1,Argentina
9417,Néstor Combin,0,73.0,0,0,2,2,4,Hungary
9418,Néstor Craviotto,1,63.0,1,0,1,1,2,Argentina
9419,Néstor Gorosito,0,41.0,0,1,0,1,1,Bolivia
9420,Nílton Santos,2,62.0,0,0,1,1,2,Brazil
9421,Oalex Anderson,1,211.0,0,1,2,4,6,Guyana
9422,Obafemi Martins,3,923.0,0,2,7,6,13,Nigeria
9423,Obaidullah Karimi,1,16.0,0,0,1,0,1,Afghanistan
9424,Obby Kapita,1,149.0,0,0,0,4,4,DR Congo
9425,Obdulio Varela,4,263.0,0,0,1,4,5,Peru
9426,Obeid Al-Dosari,2,744.0,0,0,10,3,13,Taiwan
9427,Obinna Nwaneri,0,45.0,0,0,1,0,1,Nigeria
9428,Oceano da Cruz,0,82.0,0,1,2,0,2,Portugal
9429,Octavio Mora,0,68.0,0,0,3,0,3,Mexico
9430,Octavio Sergio da Costa,0,10.0,0,0,1,0,1,Brazil
9431,Octávio Machado,0,79.0,0,0,0,1,1,Denmark
9432,Odai Al-Saify,1,59.0,0,0,1,0,1,Jordan
9433,Oday Al-Jafal,1,59.0,0,0,1,0,1,Syria
9434,Oday Dabbagh,3,210.0,0,0,4,0,4,Palestine
9435,Odaïr Fortes,0,26.0,0,0,1,0,1,Cape Verde
9436,Odd Iversen,0,354.0,0,1,4,2,6,Norway
9437,Oded Machnes,0,84.0,0,0,2,0,2,Israel
9438,Odil Ahmedov,4,724.0,0,0,8,7,15,Lebanon
9439,Odilon Polleunis,0,479.0,0,0,7,1,8,Finland
9440,Odion Ighalo,5,263.0,0,1,4,2,6,Nigeria
9441,Odise Roshi,0,223.0,0,0,3,1,4,Albania
9442,Odkhuu Selenge,0,90.0,0,0,1,0,1,Mongolia
9443,Oeki Hoekema,0,54.0,0,0,1,0,1,Netherlands
9444,Ofentse Nato,0,124.0,0,0,2,0,2,Botswana
9445,Oghenekaro Etebo,1,32.0,1,0,1,0,1,Croatia
9446,Ognjen Koroman,1,53.0,0,0,1,0,1,Serbia
9447,Ognjen Vukojević,0,21.0,0,0,0,2,2,Kazakhstan
9448,Oguchi Onyewu,0,179.0,0,0,2,0,2,United States
9449,Ogün Altıparmak,0,175.0,0,0,1,2,3,Republic of Ireland
9450,Ogün Temizkanoğlu,0,130.0,0,0,1,1,2,Switzerland
9451,Oh Seok-Jae,1,68.0,0,0,1,0,1,South Korea
9452,Oh Yong-Nam,0,88.0,1,0,1,0,1,Japan
9453,Okan Buruk,1,336.0,0,0,5,3,8,Turkey
9454,Okan Yılmaz,3,207.0,0,1,1,2,3,Turkey
9455,Okeem Challenger,0,86.0,0,0,1,0,1,Antigua and Barbuda
9456,Okey Isima,1,136.0,1,0,3,0,3,Nigeria
9457,Okita Katschi,0,85.0,0,1,1,0,1,DR Congo
9458,Oktay Derelioğlu,0,313.0,0,0,8,0,8,Turkey
9459,Ola Dybwad-Olsen,0,306.0,0,0,4,0,4,Norway
9460,Ola Kamara,0,90.0,0,0,1,0,1,Norway
9461,Ola Toivonen,1,350.0,0,0,5,2,7,Moldova
9462,Olaf Marschall,0,85.0,0,0,1,0,1,Germany
9463,Olaf Thon,0,85.0,0,0,1,0,1,Germany
9464,Olav Nilsen,0,269.0,0,0,1,3,4,Norway
9465,Olavi Lahtinen,1,192.0,0,0,1,2,3,Finland
9466,Olavi Rissanen,0,198.0,0,0,3,0,3,Finland
9467,Oldřich Nejedlý,7,636.0,0,1,8,1,9,Czechoslovakia
9468,Ole Bjørnmose,0,15.0,0,0,1,0,1,Denmark
9469,Ole Fritsen,0,60.0,0,0,1,1,2,Denmark
9470,Ole Gunnar Solskjær,0,795.0,0,1,6,8,14,Norway
9471,Ole Madsen,1,508.0,0,0,9,5,14,Denmark
9472,Ole Martin Årst,0,89.0,0,0,1,0,1,Norway
9473,Ole Rasmussen,0,21.0,0,0,0,1,1,Cyprus
9474,Ole Selnæs,0,58.0,0,0,0,1,1,San Marino
9475,Ole Stavrum,0,8.0,0,0,0,1,1,Yugoslavia
9476,Ole Sørensen,0,103.0,0,0,3,0,3,Denmark
9477,Ole Tobiasen,0,90.0,0,0,0,1,1,Switzerland
9478,Oleg Blokhin,5,682.0,0,0,10,4,14,Russia
9479,Oleg Kuzmin,0,33.0,0,0,1,0,1,Russia
9480,Oleg Litvinenko,3,128.0,0,0,2,2,4,Nepal
9481,Oleg Salenko,6,251.0,0,2,5,1,6,Sweden
9482,Oleg Shatskikh,1,598.0,0,0,3,6,9,China PR
9483,Oleg Zoteev,0,72.0,0,0,1,0,1,Uzbekistan
9484,Oleg Șișchin,0,76.0,0,0,0,1,1,Germany
9485,Oleh Husyev,0,268.0,0,0,3,4,7,Turkey
9486,Oleh Kuznetsov,0,60.0,0,0,1,0,1,Russia
9487,Oleh Protasov,10,643.0,0,0,9,4,13,Russia
9488,Oleh Shelayev,0,7.0,0,0,0,1,1,Georgia
9489,Oleksandr Kucher,0,60.0,0,0,1,0,1,Ukraine
9490,Oleksandr Zavarov,3,250.0,0,0,3,2,5,Russia
9491,Oleksandr Zinchenko,1,93.0,0,0,0,3,3,Lithuania
9492,Oleksiy Byelik,0,26.0,0,0,1,1,2,Kazakhstan
9493,Oleksiy Gai,0,54.0,0,0,0,1,1,Croatia
9494,Oleksiy Mykhaylychenko,2,273.0,0,0,3,3,6,Russia
9495,Oli,0,28.0,0,0,1,0,1,Spain
9496,Oliver Bierhoff,6,1122.0,0,0,11,8,19,Czech Republic
9497,Oliver Burke,0,89.0,0,0,1,0,1,Scotland
9498,Oliver Makor,1,345.0,0,0,3,1,4,Liberia
9499,Oliver Neuville,1,226.0,0,0,4,0,4,Germany
9500,Olivier Dacourt,0,71.0,0,0,0,1,1,Slovenia
9501,Olivier Deschacht,0,82.0,1,0,1,0,1,Lithuania
9502,Olivier Djappa,0,20.0,0,0,1,0,1,Cameroon
9503,Olivier Giroud,5,1032.0,0,2,12,8,20,Spain
9504,Olivier Kapo,0,17.0,0,0,1,0,1,France
9505,Olivier Karekezi,0,161.0,0,0,4,0,4,Rwanda
9506,Olivier Niere,0,128.0,0,0,2,0,2,Congo
9507,Olivier Niyonzima,0,66.0,0,0,0,1,1,Kenya
9508,Olivier Occéan,0,167.0,0,0,1,3,4,Saint Lucia
9509,Olivier Thill,0,80.0,0,0,1,1,2,Luxembourg
9510,Ollie Watkins,0,83.0,0,0,1,0,1,England
9511,Olof Mellberg,1,289.0,0,0,6,2,8,Poland
9512,Olumuyiwa Oshode,0,154.0,0,0,1,1,2,Cameroon
9513,Omar Abdulrahman,0,74.0,0,0,1,1,2,Malaysia
9514,Omar Al Ariki,0,148.0,0,0,5,0,5,Yemen
9515,Omar Al Khouja,0,43.0,0,0,0,1,1,Angola
9516,Omar Al Somah,9,689.0,0,2,7,6,13,Iran
9517,Omar Al-Dahi,2,91.0,0,0,2,0,2,Yemen
9518,Omar Ali Hasab El-Rasoul,1,174.0,0,0,4,0,4,Sudan
9519,Omar Berdiýew,0,42.0,0,0,1,0,1,Turkmenistan
9520,Omar Betrouni,0,83.0,0,0,1,0,1,Algeria
9521,Omar Bravo,6,523.0,0,0,9,0,9,Mexico
9522,Omar Cummings,1,155.0,0,0,1,1,2,Jamaica
9523,Omar Daley,1,173.0,0,0,2,0,2,Jamaica
9524,Omar Daoud,0,50.0,0,0,1,0,1,Libya
9525,Omar Gonzalez,0,156.0,1,0,4,0,4,United States
9526,Omar Hawsawi,0,90.0,0,0,0,1,1,Japan
9527,Omar Higinio García,1,2.0,0,0,1,0,1,Argentina
9528,Omar Khribin,8,591.0,0,2,6,7,13,Afghanistan
9529,Omar Marmoush,0,49.0,0,0,1,0,1,Egypt
9530,Omar Midani,0,50.0,0,0,0,1,1,Cambodia
9531,Omar Mohamed,0,85.0,0,0,0,1,1,Zimbabwe
9532,Omar Mubarak,2,73.0,0,0,2,0,2,Yemen
9533,Omar Méndez,1,12.0,0,0,0,1,1,Ecuador
9534,Omar Sivori,0,221.0,0,0,4,0,4,Italy
9535,Omar Sívori,3,114.0,0,0,3,1,4,Argentina
9536,Omar Traoré,0,80.0,0,0,0,1,1,Togo
9537,Omar Zapata,1,190.0,0,0,3,1,4,Dominican Republic
9538,Omari Glasgow,1,75.0,0,0,1,0,1,Guyana
9539,Omari Sterling-James,0,82.0,0,0,0,1,1,Bahamas
9540,Omari Tetradze,1,54.0,0,0,1,0,1,Russia
9541,Omer Damari,0,209.0,0,0,1,4,5,Cyprus
9542,Omer Golan,0,296.0,0,0,3,2,5,Israel
9543,Omid Popalzay,1,23.0,0,0,1,0,1,Afghanistan
9544,Omri Afek,1,4.0,0,0,1,1,2,Cyprus
9545,Onandi Lowe,1,246.0,0,0,3,4,7,Saint Vincent and the Grenadines
9546,Ondrej Duda,1,387.0,0,1,3,4,7,Wales
9547,Ondrej Krištofík,0,27.0,1,0,1,0,1,France
9548,Ondřej Čelůstka,0,79.0,0,0,1,0,1,Czech Republic
9549,Onel Hernández,2,95.0,0,0,2,0,2,Cuba
9550,Oniel Fisher,0,79.0,0,0,0,1,1,Honduras
9551,Onur Dogan,0,52.0,0,0,0,1,1,Brunei
9552,Opa Nguette,0,55.0,0,0,1,0,1,Senegal
9553,Opoku Afriyie,0,206.0,0,0,4,0,4,Ghana
9554,Opoku Nti,2,248.0,0,0,2,2,4,Libya
9555,Oppe Quiñónez,1,82.0,0,0,0,1,1,Ecuador
9556,Orbelín Pineda,4,262.0,0,2,3,2,5,Mexico
9557,Orestas Buitkus,0,222.0,0,0,1,2,3,North Macedonia
9558,Oreste Corbatta,5,486.0,0,6,12,2,14,Argentina
9559,Orhan Çıkırıkçı,0,87.0,0,0,1,0,1,Turkey
9560,Oribe Peralta,8,827.0,0,0,11,7,18,Guyana
9561,Orin de Waard,0,12.0,0,0,1,0,1,Curaçao
9562,Orkun Kökçü,0,60.0,0,0,0,1,1,Montenegro
9563,Orlando Gando,0,50.0,0,0,0,1,1,Congo
9564,Orlando Maturana,1,18.0,0,1,1,0,1,Colombia
9565,Orlando Mesa,0,18.0,0,0,0,1,1,Brazil
9566,Orlando Mitchum,0,302.0,0,0,4,1,5,Saint Kitts and Nevis
9567,Orlando Torres,0,8.0,0,0,1,0,1,Venezuela
9568,Orlando de Azevedo Viarina,0,132.0,0,0,2,0,2,Brazil
9569,Orly Klinger,0,48.0,0,0,1,0,1,Ecuador
9570,Osael Romero,3,533.0,0,1,6,5,11,El Salvador
9571,Osama Al Fazzani,0,4.0,0,0,1,0,1,Libya
9572,Osama Al-Muwallad,0,132.0,0,0,1,1,2,Iran
9573,Osama Hawsawi,0,189.0,0,0,1,2,3,Saudi Arabia
9574,Osama Idris,0,7.0,0,0,1,0,1,Sudan
9575,Osama Omari,4,213.0,0,0,4,1,5,Cambodia
9576,Osamu Maeda,0,16.0,0,0,1,0,1,Japan
9577,Osaze Odemwingie,3,216.0,0,0,3,0,3,Nigeria
9578,Oscar,1,228.0,0,0,3,0,3,Brazil
9579,Oscar Arriaza,0,22.0,0,0,1,0,1,Chile
9580,Oscar Black,0,11.0,0,0,1,0,1,Jamaica
9581,Oscar Chirimini,1,198.0,0,0,1,2,3,Chile
9582,Oscar Crino,0,67.0,0,0,2,0,2,Australia
9583,Oscar Fornari,0,17.0,0,0,0,1,1,Bolivia
9584,Oscar Heisserer,0,10.0,0,0,1,0,1,France
9585,Oscar Hiljemark,0,45.0,0,0,1,0,1,Sweden
9586,Oscar Mas,1,23.0,0,0,1,0,1,Argentina
9587,Oscar Ruggeri,2,46.0,0,0,2,0,2,Argentina
9588,Oscar Santis,0,16.0,0,0,1,0,1,Guatemala
9589,Oscar Zubía,0,60.0,0,0,0,1,1,Ecuador
9590,Osea Vakatalesau,0,113.0,0,0,2,0,2,Fiji
9591,Osei Kofi,6,486.0,0,1,4,5,9,DR Congo
9592,Oskars Kļava,0,27.0,0,0,0,1,1,Iceland
9593,Osman Arpacıoğlu,0,45.0,0,0,2,0,2,Turkey
9594,Osman Bukari,1,89.0,0,0,0,1,1,Portugal
9595,Osmin Hernández,0,19.0,0,0,1,0,1,Cuba
9596,Ossama Khalil,1,99.0,0,0,2,0,2,Egypt
9597,Ostap Steckiw,0,14.0,0,0,0,1,1,United States
9598,Osvaldo Ardiles,1,185.0,0,0,2,1,3,Venezuela
9599,Osvaldo Balseiro,4,260.0,0,0,0,4,4,Chile
9600,Osvaldo Castro,0,40.0,0,0,1,0,1,Chile
9601,Osvaldo Fernando Saturnino de Oliveira,0,78.0,0,0,0,1,1,Algeria
9602,Osvaldo Héctor Cruz,2,95.0,0,0,2,0,2,Argentina
9603,Osvaldo Sáez,3,207.0,0,0,2,1,3,Chile
9604,Osvaldo de Oliveira,0,73.0,0,0,1,1,2,Cameroon
9605,Oswalding Mackay,0,85.0,0,0,1,0,1,Aruba
9606,Oswaldo Alanís,0,35.0,0,0,1,0,1,Mexico
9607,Oswaldo Calero,0,42.0,0,0,1,0,1,Colombia
9608,Oswaldo Palencia,0,14.0,0,0,1,0,1,Venezuela
9609,Oswaldo Ramírez,0,219.0,0,1,2,3,5,Argentina
9610,Oswaldo Taurisano,3,121.0,0,0,3,0,3,Brazil
9611,Oswaldo Vizcarrondo,1,59.0,0,0,1,1,2,Chile
9612,Otabek Shukurov,0,141.0,0,1,2,0,2,Uzbekistan
9613,Otar Kakabadze,0,76.0,1,0,1,0,1,Greece
9614,Othman Ferjani,0,50.0,0,0,0,1,1,Egypt
9615,Otis Roberts,0,124.0,0,0,1,1,2,Guyana
9616,Otis Steede,0,43.0,0,0,1,0,1,Bermuda
9617,Ottmar Walter,4,286.0,0,0,3,2,5,Germany
9618,Otto Addo,0,37.0,0,0,1,0,1,Ghana
9619,Otto Siffling,1,108.0,0,0,2,1,3,Belgium
9620,Otto Walzhofer,0,51.0,0,0,1,0,1,Austria
9621,Otávio,0,15.0,0,0,1,0,1,Portugal
9622,Oumar Barro,0,62.0,0,0,2,0,2,Burkina Faso
9623,Oumar Ben Salah,1,187.0,0,0,5,1,6,Ivory Coast
9624,Oumar Kalabane,0,103.0,0,0,0,2,2,Ghana
9625,Oumar N'Diaye,0,22.0,0,0,1,0,1,Mauritania
9626,Oumar Tchomogo,0,210.0,0,2,5,0,5,Benin
9627,Oumed Alidodov,0,32.0,0,0,1,1,2,Tajikistan
9628,Oumed Oukri,0,5.0,0,0,1,0,1,Ethiopia
9629,Oupa Manyisa,1,47.0,0,0,1,0,1,South Africa
9630,Ousman Jallow,0,26.0,0,0,1,0,1,Gambia
9631,Ousmane Badara Bangoura,0,15.0,0,0,0,1,1,Togo
9632,Ousmane Bangoura,2,253.0,0,0,0,4,4,Botswana
9633,Ousmane Dembélé,0,19.0,0,0,0,1,1,Kazakhstan
9634,Ousmane Sanou,2,169.0,0,0,2,1,3,Burkina Faso
9635,Ousmane Sidibé,0,61.0,1,0,1,0,1,DR Congo
9636,Ousmane Thiam Tollo,1,50.0,0,1,1,1,2,Ghana
9637,Oussama Darragi,0,355.0,0,2,2,3,5,Tunisia
9638,Ovays Azizi,1,75.0,1,0,1,0,1,India
9639,Ove Bech Nielsen,0,91.0,0,0,0,2,2,England
9640,Ove Grahn,1,254.0,0,1,3,1,4,Norway
9641,Ove Kindvall,0,386.0,0,1,5,4,9,Cyprus
9642,Ove Ødegaard,0,54.0,0,0,0,2,2,Austria
9643,Ovidio Mezza,0,198.0,0,1,2,2,4,Bolivia
9644,Ovidiu Hanganu,0,86.0,0,0,0,1,1,Cyprus
9645,Ovidiu Hoban,0,90.0,0,0,1,0,1,Romania
9646,Ovidiu Petre,0,29.0,0,0,1,0,1,Romania
9647,Oyunbaataryn Mijiddorj,1,34.0,0,0,0,1,1,Kyrgyzstan
9648,Ozan Tufan,4,344.0,0,0,2,4,6,Czech Republic
9649,Oğuz Çetin,0,130.0,0,0,2,0,2,Turkey
9650,Oğuzhan Özyakup,0,8.0,0,0,1,0,1,Turkey
9651,Oļegs Aleksejenko,0,3.0,0,0,0,1,1,Albania
9652,Pa Dibba,0,9.0,0,0,0,1,1,Namibia
9653,Paa Nii Lutterodt,1,52.0,0,0,1,0,1,Ghana
9654,Pablo Aimar,2,312.0,0,0,4,2,6,Argentina
9655,Pablo Armero,1,95.0,0,0,2,0,2,Colombia
9656,Pablo Barrera,3,286.0,0,0,2,3,5,Nicaragua
9657,Pablo Bengoechea,2,218.0,0,0,2,2,4,Chile
9658,Pablo Cardozo,1,43.0,0,0,0,1,1,Solomon Islands
9659,Pablo Contreras,0,28.0,0,0,1,0,1,Chile
9660,Pablo César Aguilar,0,52.0,0,0,1,0,1,Paraguay
9661,Pablo Daniel Escobar,0,195.0,0,0,4,0,4,Bolivia
9662,Pablo Dorado,0,19.0,0,0,2,0,2,Uruguay
9663,Pablo Fornals,0,32.0,0,0,0,1,1,Kosovo
9664,Pablo Ganet,1,122.0,0,0,1,1,2,Equatorial Guinea
9665,Pablo García,0,90.0,0,0,1,1,2,Uruguay
9666,Pablo Herrera Barrantes,1,158.0,0,0,1,1,2,Costa Rica
9667,Pablo León,1,89.0,0,0,0,1,1,Brazil
9668,Pablo Lima,1,87.0,0,0,1,0,1,Uruguay
9669,Pablo Palacios,0,83.0,0,0,1,0,1,Ecuador
9670,Pablo Paz,0,58.0,0,0,1,0,1,Argentina
9671,Pablo Punyed,0,45.0,0,0,1,0,1,El Salvador
9672,Pablo Ramírez,1,76.0,0,0,0,1,1,Bolivia
9673,Pablo Rojas,0,38.0,0,0,0,1,1,Venezuela
9674,Pablo Sarabia,1,246.0,0,1,3,2,5,Spain
9675,Pablo Tamburrini,0,51.0,0,0,0,1,1,Saudi Arabia
9676,Pablo Thiam,0,24.0,0,0,0,1,1,Uganda
9677,Paco Alcácer,2,515.0,0,0,5,3,8,Spain
9678,Paco Clos,0,48.0,0,0,1,0,1,Spain
9679,Paddy McCourt,0,158.0,0,0,2,0,2,Northern Ireland
9680,Paddy McNair,0,168.0,0,1,0,2,2,Belarus
9681,Paddy Moore,4,263.0,0,0,4,1,5,Republic of Ireland
9682,Pai Soe,0,62.0,0,0,1,0,1,Myanmar
9683,Paik Seung-ho,1,76.0,0,0,0,1,1,Brazil
9684,Paisano Urbita Sosa,0,77.0,0,0,0,1,1,Uruguay
9685,Pajtim Kasami,0,75.0,0,0,1,0,1,Switzerland
9686,Pak Chol-min,0,96.0,0,0,2,1,3,Mongolia
9687,Pak Doo-ik,2,57.0,0,0,1,1,2,North Korea
9688,Pak Jong-hun,2,109.0,0,1,0,2,2,Iran
9689,Pak Kwang-ryong,1,58.0,0,1,2,1,3,North Korea
9690,Pak Nam-Chol,0,115.0,0,0,3,0,3,North Korea
9691,Pak Seung-zin,5,276.0,0,0,3,2,5,North Korea
9692,Pak Song-Gwan,0,63.0,0,0,1,0,1,North Korea
9693,Pak Sung-Jin,0,48.0,0,0,0,1,1,Iran
9694,Palhinha,3,573.0,0,0,5,4,9,Venezuela
9695,Pambos Papadopoulos,0,46.0,0,0,1,0,1,Cyprus
9696,Pambos Pittas,1,184.0,0,3,4,0,4,Cyprus
9697,Panagiotis Kone,0,86.0,0,0,1,0,1,Greece
9698,Panagiotis Sofianopoulos,0,25.0,0,0,1,0,1,Greece
9699,Panagiotis Tachtsidis,0,57.0,0,0,1,0,1,Greece
9700,Panagiotis Tsalouchidis,0,392.0,0,0,1,6,7,Greece
9701,Panajot Pano,0,67.0,0,0,2,0,2,Albania
9702,Panayiotis Engomitis,0,70.0,0,0,2,0,2,Cyprus
9703,Panayiotis Marangos,0,8.0,0,0,0,1,1,Netherlands
9704,Panayiotis Xiourouppas,0,20.0,0,0,1,1,2,Hungary
9705,Panayot Panayotov,0,61.0,0,0,2,0,2,Bulgaria
9706,Pang Gwang-Chol,1,4.0,0,0,0,1,1,Indonesia
9707,Panicos Efthimiadis,0,89.0,0,0,1,0,1,Cyprus
9708,Paolo Amodio,0,14.0,0,0,1,0,1,Luxembourg
9709,Paolo Barison,1,265.0,0,0,3,1,4,Italy
9710,Paolo Guerrero,14,1484.0,0,1,13,12,25,Peru
9711,Paolo Hurtado,0,95.0,0,0,0,2,2,Venezuela
9712,Paolo Maldini,0,226.0,0,0,5,0,5,Italy
9713,Paolo Montero,1,256.0,0,0,4,1,5,Uruguay
9714,Paolo Rossi,9,418.0,0,1,5,5,10,France
9715,Papa Bouba Diop,6,350.0,0,0,3,5,8,Nigeria
9716,Papa Camara,2,178.0,0,0,4,0,4,Guinea
9717,Papa Dia,0,84.0,0,0,0,1,1,Mali
9718,Papa Yakhya Lette,0,34.0,0,0,0,1,1,Gabon
9719,Papakouli Diop,1,43.0,0,0,1,0,1,Senegal
9720,Pape Abou Cissé,0,45.0,1,0,1,0,1,Togo
9721,Pape Fall,1,28.0,0,0,0,1,1,Mozambique
9722,Pape Sarr,1,45.0,0,0,0,1,1,Burkina Faso
9723,Pape Seydou Diop,0,16.0,0,0,0,1,1,Algeria
9724,Pape Thiaw,0,45.0,0,0,0,2,2,Namibia
9725,Papi Kimoto,2,117.0,0,1,1,1,2,Tunisia
9726,Papiss Cissé,0,221.0,0,1,0,5,5,Uganda
9727,Papito Merencia,0,24.0,0,0,1,1,2,Curaçao
9728,Papu Gómez,2,16.0,0,0,2,0,2,Argentina
9729,Papy Okitankoy Kimoto,0,90.0,0,0,1,0,1,DR Congo
9730,Paramasivan Ravindran,2,162.0,0,0,0,2,2,Macau
9731,Park Chang-Sun,1,85.0,0,0,1,1,2,South Korea
9732,Park Chu-young,2,620.0,1,2,6,8,14,Uzbekistan
9733,Park Ji-sung,2,565.0,0,0,6,3,9,South Korea
9734,Park Jin-seop,1,51.0,1,0,0,1,1,South Korea
9735,Park Jung-bae,1,57.0,0,0,1,1,2,South Korea
9736,Park Kun-Ha,0,86.0,0,0,1,0,1,South Korea
9737,Park Kyung-Hoon,1,41.0,0,0,0,1,1,Nepal
9738,Park Lee-chun,3,260.0,0,1,1,3,4,Cambodia
9739,Park Nam-Yeol,0,63.0,0,0,1,0,1,South Korea
9740,Park Sang-in,0,234.0,0,0,3,0,3,South Korea
9741,Park Seung-ok,1,74.0,0,0,0,1,1,Hong Kong
9742,Park Soo-Il,0,68.0,0,0,2,0,2,South Korea
9743,Park Su-deok,1,37.0,0,0,0,1,1,Cambodia
9744,Park Yi-Chun,0,52.0,0,0,1,0,1,South Korea
9745,Parviz Ghelichkhani,1,240.0,0,1,5,0,5,Iran
9746,Pascal Anicet,0,53.0,1,0,1,0,1,Benin
9747,Pascal Feindouno,8,1010.0,0,4,10,9,19,Uganda
9748,Pascal Miézan,0,91.0,0,0,1,1,2,Congo
9749,Pascal Ochieng,0,41.0,0,0,0,1,1,Seychelles
9750,Paschalis Christoforou,0,72.0,0,0,1,0,1,Cyprus
9751,Pascual Somma,0,88.0,0,0,1,0,1,Uruguay
9752,Pat Nevin,0,262.0,0,1,4,0,4,Scotland
9753,Pat Stanton,0,22.0,1,0,1,0,1,Portugal
9754,Patesko,6,205.0,0,0,6,0,6,Brazil
9755,Patiparn Phetphun,0,82.0,0,0,1,0,1,Thailand
9756,Patou Ebunga-Simbi,0,81.0,0,0,0,1,1,Togo
9757,Patrice Abanda,0,18.0,0,0,1,0,1,Cameroon
9758,Patrice Bernier,1,25.0,0,0,0,1,1,Costa Rica
9759,Patrice Loko,2,146.0,0,0,1,1,2,Azerbaijan
9760,Patricio Urrutia,0,69.0,0,0,0,1,1,Argentina
9761,Patricio Yáñez,1,209.0,0,0,3,1,4,Chile
9762,Patrick Aisa,0,123.0,0,0,0,2,2,Tahiti
9763,Patrick Battiston,0,73.0,0,0,0,2,2,Sweden
9764,Patrick Blair,0,51.0,0,0,1,0,1,Jamaica
9765,Patrick Bühlmann,0,59.0,0,0,0,1,1,Wales
9766,Patrick Diaike,0,87.0,0,0,1,0,1,New Caledonia
9767,Patrick Kaddu,1,14.0,0,0,0,1,1,DR Congo
9768,Patrick Kluivert,5,1154.0,0,0,13,9,22,Netherlands
9769,Patrick M'Boma,13,1351.0,0,0,14,10,24,Cameroon
9770,Patrick Mabedi,0,174.0,0,1,1,1,2,Malawi
9771,Patrick Mayo,1,29.0,0,0,0,1,1,Morocco
9772,Patrick Mkontwana,0,53.0,0,0,0,1,1,Egypt
9773,Patrick Modeste,0,105.0,0,0,1,1,2,Haiti
9774,Patrick Mutesa Mafisango,0,19.0,0,0,0,1,1,Algeria
9775,Patrick Müller,0,74.0,0,0,1,0,1,Switzerland
9776,Patrick Nachok,0,88.0,0,0,1,0,1,Kenya
9777,Patrick Percin,1,51.0,0,0,0,1,1,Trinidad and Tobago
9778,Patrick Phiri,1,20.0,0,0,0,1,1,Burkina Faso
9779,Patrick Ranaivoson,0,42.0,1,0,1,0,1,Congo
9780,Patrick Reichelt,0,12.0,0,0,0,1,1,Guam
9781,Patrick Ronaldinho Wleh,0,32.0,0,0,1,0,1,Liberia
9782,Patrick Vervoort,2,123.0,0,0,2,1,3,Belgium
9783,Patrick Vieira,2,197.0,0,0,1,4,5,South Korea
9784,Patrick Zinhagel,0,153.0,0,0,1,1,2,Aruba
9785,Patrik Andersson,0,110.0,0,0,1,1,2,Sweden
9786,Patrik Berger,1,737.0,0,4,12,2,14,Czech Republic
9787,Patrik Schick,5,467.0,0,2,4,7,11,Czech Republic
9788,Patson Daka,0,125.0,0,0,2,1,3,Algeria
9789,Patterson Daudau,4,156.0,0,0,4,0,4,Solomon Islands
9790,Pau Torres,0,62.0,0,0,1,0,1,Spain
9791,Paul Agostino,3,139.0,0,0,3,0,3,Australia
9792,Paul Aguilar,1,64.0,0,0,1,1,2,Mexico
9793,Paul Arriola,0,200.0,0,0,4,0,4,United States
9794,Paul Bodin,0,166.0,0,2,1,1,2,Germany
9795,Paul Bravo,1,27.0,0,0,1,0,1,United States
9796,Paul Breitner,1,354.0,0,2,6,1,7,Germany
9797,Paul Caligiuri,1,60.0,0,0,1,0,1,United States
9798,Paul Cam,0,22.0,0,0,0,1,1,British Virgin Islands
9799,Paul Cann,0,70.0,0,0,0,1,1,Antigua and Barbuda
9800,Paul Cominges,2,72.0,0,0,2,0,2,Peru
9801,Paul Courant,0,60.0,0,0,1,0,1,Belgium
9802,Paul Davis,2,333.0,0,0,3,3,6,Jamaica
9803,Paul Dickov,0,45.0,0,0,1,0,1,Scotland
9804,Paul Fenech,0,40.0,0,0,1,0,1,Malta
9805,Paul Fenwick,0,81.0,1,0,1,0,1,Mexico
9806,Paul Gascoigne,0,445.0,0,0,6,2,8,England
9807,Paul Hall,2,159.0,0,0,0,3,3,El Salvador
9808,Paul Hartley,0,84.0,0,0,0,1,1,Slovenia
9809,Paul Ince,2,95.0,0,0,0,2,2,San Marino
9810,Paul Kakai,1,16.0,0,0,0,1,1,Fiji
9811,Paul Kay,2,213.0,0,0,2,2,4,New Caledonia
9812,Paul Komboi,2,81.0,0,0,0,2,2,Fiji
9813,Paul Lambert,0,62.0,0,0,0,1,1,Faroe Islands
9814,Paul Mariner,1,385.0,0,0,4,3,7,Luxembourg
9815,Paul May,0,33.0,0,0,0,1,1,Netherlands
9816,Paul McGee,0,46.0,0,0,0,2,2,Cyprus
9817,Paul McGrath,0,368.0,0,0,4,3,7,Republic of Ireland
9818,Paul McStay,1,190.0,0,0,5,2,7,Scotland
9819,Paul Moukila,2,91.0,0,0,2,0,2,Congo
9820,Paul Papp,0,153.0,0,0,2,0,2,Romania
9821,Paul Peschisolido,0,148.0,0,0,4,0,4,Canada
9822,Paul Philipp,0,129.0,0,2,2,1,3,Luxembourg
9823,Paul Poatinda,3,147.0,0,0,3,0,3,New Caledonia
9824,Paul Pogba,3,394.0,0,0,5,2,7,Belarus
9825,Paul Ritchie,0,30.0,0,0,0,1,1,Czech Republic
9826,Paul Ruben Corte,0,180.0,0,0,2,0,2,Suriname
9827,Paul Scholes,3,476.0,0,0,5,6,11,England
9828,Paul Sixsmith,0,69.0,0,0,1,0,1,Malta
9829,Paul Stalteri,1,59.0,0,0,0,1,1,Costa Rica
9830,Paul Sturrock,0,84.0,0,0,1,1,2,Portugal
9831,Paul Trimboli,3,572.0,0,0,10,1,11,Australia
9832,Paul Urlovic,0,189.0,0,0,3,0,3,New Zealand
9833,Paul Van Himst,0,694.0,0,1,10,5,15,Belgium
9834,Paul Vandenberg,0,246.0,0,0,1,3,4,Belgium
9835,Paul Wade,1,169.0,0,1,2,1,3,Tahiti
9836,Paul Young,0,125.0,0,0,1,2,3,Saint Vincent and the Grenadines
9837,Paul-Gaston N'Dongo,2,224.0,0,0,4,1,5,Cameroon
9838,Paul-José M'Poku,2,195.0,0,0,2,1,3,Togo
9839,Pauleta,5,1283.0,0,0,17,8,25,Portugal
9840,Paulinho,1,524.0,0,1,5,5,10,Brazil
9841,Paulinho Santos,0,82.0,0,0,0,2,2,Liechtenstein
9842,Paulino Vieira Dias,0,30.0,0,0,1,0,1,Angola
9843,Paulo Alves,0,383.0,0,0,2,3,5,Portugal
9844,Paulo António Alves,1,445.0,0,1,8,2,10,Angola
9845,Paulo César Chávez,0,1.0,0,0,1,0,1,Mexico
9846,Paulo Dybala,2,112.0,0,0,1,1,2,Argentina
9847,Paulo Figueiredo,0,60.0,0,0,0,1,1,Nigeria
9848,Paulo Futre,0,232.0,0,1,2,3,5,Switzerland
9849,Paulo Jorge Da Silva,2,136.0,0,2,2,2,4,Uganda
9850,Paulo Madeira,0,181.0,0,0,1,2,3,Portugal
9851,Paulo Pisaneschi,3,142.0,0,0,3,1,4,Brazil
9852,Paulo Roberto Falcão,3,248.0,0,0,3,1,4,Brazil
9853,Paulo Roberto Jamelli Júnior,2,92.0,0,0,0,2,2,Honduras
9854,Paulo Silas,0,37.0,0,0,1,0,1,Brazil
9855,Paulo Valentim,5,275.0,0,0,3,2,5,Bolivia
9856,Paulo Wanchope,15,1962.0,0,0,22,15,37,Costa Rica
9857,Paulo da Silva,0,110.0,0,0,1,2,3,Chile
9858,Paulus Arajuuri,0,181.0,0,0,3,0,3,Finland
9859,Paulus Roiha,0,87.0,0,0,0,1,1,North Macedonia
9860,Paulus Shipanga,0,83.0,0,0,2,0,2,Namibia
9861,Pavel Badea,0,77.0,0,0,1,0,1,Romania
9862,Pavel Chaloupka,0,70.0,0,0,0,1,1,Italy
9863,Pavel Hapal,1,23.0,0,0,1,0,1,Czech Republic
9864,Pavel Kadeřábek,0,69.0,0,0,1,1,2,Czech Republic
9865,Pavel Kuka,1,715.0,0,0,8,5,13,Albania
9866,Pavel Matyash,1,50.0,1,0,1,0,1,China PR
9867,Pavel Nedvěd,3,511.0,0,0,8,6,14,Czech Republic
9868,Pavel Panov,0,210.0,0,0,3,2,5,Bulgaria
9869,Pavel Pashayev,0,26.0,1,0,1,0,1,Wales
9870,Pavel Pogrebnyak,0,237.0,0,1,2,2,4,Russia
9871,Pavel Savitski,0,241.0,0,0,3,0,3,Belarus
9872,Pavel Sedko,1,31.0,0,0,1,0,1,Belarus
9873,Pavel Sitko,0,28.0,0,0,1,0,1,Belarus
9874,Pavel Solomin,1,82.0,0,0,0,1,1,Saudi Arabia
9875,Pavel Verbíř,0,84.0,0,0,1,0,1,Czech Republic
9876,Pavel Yevteyev,0,187.0,0,0,2,1,3,Kazakhstan
9877,Pavlo Yakovenko,1,2.0,0,0,1,0,1,Russia
9878,Pavlos Savva,0,60.0,0,0,0,1,1,Greece
9879,Pavol Molnár,0,89.0,0,0,1,0,1,Czechoslovakia
9880,Pawel Janas,0,5.0,1,0,0,1,1,Poland
9881,Paweł Brożek,0,27.0,0,0,1,0,1,Poland
9882,Paweł Kaczorowski,0,75.0,0,0,0,1,1,San Marino
9883,Paweł Kryszałowicz,1,122.0,0,0,2,1,3,Wales
9884,Paweł Król,0,90.0,0,0,0,1,1,Portugal
9885,Pedri,1,20.0,1,0,1,0,1,Croatia
9886,Pedro,1,392.0,0,0,3,4,7,Belarus
9887,Pedro Acosta,1,105.0,1,1,3,0,3,Venezuela
9888,Pedro Alcides Bareiro,0,10.0,0,0,1,0,1,Paraguay
9889,Pedro Alejandro García,0,76.0,0,0,0,1,1,Paraguay
9890,Pedro Amorim,2,99.0,0,0,2,0,2,Brazil
9891,Pedro Antonio Cabral,1,90.0,0,0,0,1,1,Argentina
9892,Pedro Aquino,0,101.0,0,0,0,2,2,Aruba
9893,Pedro Araya,2,160.0,0,0,3,0,3,Chile
9894,Pedro Arnauda,0,192.0,0,0,3,0,3,Mexico
9895,Pedro Barbosa,0,240.0,0,0,3,1,4,Portugal
9896,Pedro Calomino,1,15.0,0,0,1,0,1,Argentina
9897,Pedro Cea,0,249.0,0,0,5,0,5,Uruguay
9898,Pedro Eugenio Callá,0,86.0,0,0,2,0,2,Argentina
9899,Pedro Febles,0,106.0,0,0,1,1,2,Venezuela
9900,Pedro Fernández,1,51.0,0,0,0,1,1,Bolivia
9901,Pedro González Vera,0,44.0,0,0,0,1,1,Bolivia
9902,Pedro Hugo López,2,294.0,0,1,1,4,5,Ecuador
9903,Pedro Lago,3,149.0,0,0,0,3,3,Ecuador
9904,Pedro Monzón,1,62.0,0,0,1,0,1,Argentina
9905,Pedro Munitis,1,51.0,0,0,0,1,1,Serbia
9906,Pedro Pablo León,1,338.0,0,0,1,5,6,Ecuador
9907,Pedro Pasculli,1,165.0,0,0,2,2,4,Colombia
9908,Pedro Petrone,3,544.0,0,0,7,3,10,Uruguay
9909,Pedro Reyes,2,199.0,0,0,3,1,4,Chile
9910,Pedro Rocha,1,347.0,0,0,6,3,9,Uruguay
9911,Pedro Sarmiento,0,40.0,0,0,0,1,1,Uruguay
9912,Pedro Troglio,1,27.0,0,0,1,0,1,Argentina
9913,Pedro Waldemar Manfredini,0,55.0,0,0,2,0,2,Argentina
9914,Pedro Zaballa,0,113.0,0,0,0,2,2,Republic of Ireland
9915,Pedro Zingone,0,73.0,0,0,1,0,1,Uruguay
9916,Pelayo Ayala,1,83.0,0,0,0,1,1,Brazil
9917,Pele Kaimana,0,69.0,0,0,1,0,1,Zambia
9918,Pelé,17,1370.0,0,0,20,6,26,Brazil
9919,Peng Weiguo,3,183.0,0,0,2,3,5,China PR
9920,Penieli Moa,1,71.0,0,1,0,1,1,American Samoa
9921,Pep Guardiola,1,114.0,0,1,3,1,4,Spain
9922,Pepe,5,273.0,0,0,3,3,6,Portugal
9923,Per Edmund Mordt,0,71.0,0,0,1,0,1,Norway
9924,Per Kristoffersen,0,77.0,0,0,1,0,1,Norway
9925,Per Mertesacker,0,84.0,0,0,2,1,3,Germany
9926,Per Pedersen,0,28.0,0,0,1,0,1,Denmark
9927,Per Pettersen,0,80.0,0,0,0,1,1,Iceland
9928,Per Røntved,0,258.0,0,2,4,0,4,Denmark
9929,Percival Piggott,0,33.0,0,0,0,1,1,United States
9930,Percy Colque,0,54.0,0,0,1,0,1,Bolivia
9931,Percy Rojas,1,149.0,0,0,2,1,3,Chile
9932,Percy Tau,0,65.0,0,0,1,1,2,South Africa
9933,Peregrino Anselmo,0,82.0,0,0,3,0,3,Uruguay
9934,Pereira Tavares,0,47.0,0,0,2,0,2,Guinea-Bissau
9935,Peri Neufeld,1,36.0,0,0,1,0,1,Israel
9936,Pertti Mäkipää,0,57.0,0,0,0,1,1,Greece
9937,Pervis Estupiñán,0,99.0,0,0,1,1,2,Ecuador
9938,Petar Radaković,1,152.0,0,0,1,1,2,Yugoslavia
9939,Petar Stojanović,0,42.0,0,0,1,0,1,Slovenia
9940,Petar Velichkov,0,86.0,0,0,1,0,1,Bulgaria
9941,Petar Zhekov,0,299.0,0,0,4,2,6,Bulgaria
9942,Pete Matevich,2,65.0,0,0,2,0,2,United States
9943,Peter Anieke,0,90.0,0,0,0,1,1,Cameroon
9944,Peter Ankersen,0,78.0,0,0,1,0,1,Denmark
9945,Peter Artner,0,9.0,1,0,0,1,1,Austria
9946,Peter Barnes,0,54.0,0,0,0,1,1,Bulgaria
9947,Peter Beardsley,1,286.0,0,0,5,1,6,England
9948,Peter Byers,0,526.0,0,1,5,6,11,Antigua and Barbuda
9949,Peter Cargill,0,66.0,0,0,1,0,1,Jamaica
9950,Peter Crouch,1,509.0,0,0,8,2,10,England
9951,Peter Crève,0,81.0,0,0,1,0,1,Belgium
9952,Peter Dahl,0,86.0,0,0,0,1,1,Romania
9953,Peter Dawo,0,47.0,0,0,1,0,1,Kenya
9954,Peter Dubovský,4,738.0,0,4,10,4,14,Czechoslovakia
9955,Peter Ducke,0,455.0,0,0,2,5,7,German DR
9956,Peter Dzúrik,0,56.0,0,0,0,1,1,North Macedonia
9957,Peter Farrell,0,65.0,0,0,0,1,1,Finland
9958,Peter Fregene,1,81.0,1,0,0,1,1,Nigeria
9959,Peter Greenaway,0,23.0,0,0,0,1,1,Antigua and Barbuda
9960,Peter Hlinka,0,72.0,0,0,1,0,1,Slovakia
9961,Peter Houtman,0,270.0,0,0,4,1,5,Netherlands
9962,Peter Hrstic,0,2.0,0,0,1,0,1,Austria
9963,Peter Isaacs,0,52.0,0,0,0,1,1,Trinidad and Tobago
9964,Peter Jehle,0,12.0,1,0,0,1,1,Liechtenstein
9965,Peter Kaumba,2,56.0,0,0,0,3,3,Nigeria
9966,Peter Kotte,0,3.0,0,1,1,0,1,German DR
9967,Peter Larsson,0,97.0,0,1,1,2,3,Sweden
9968,Peter Lorimer,1,72.0,0,0,1,1,2,Scotland
9969,Peter McParland,5,276.0,0,0,0,7,7,Wales
9970,Peter Mgangira,0,88.0,0,0,0,1,1,Ethiopia
9971,Peter Millar,0,175.0,0,0,3,0,3,United States
9972,Peter Méndez,3,134.0,0,1,0,3,3,Ecuador
9973,Peter Møller,1,89.0,0,0,3,1,4,Denmark
9974,Peter Ndlovu,3,548.0,0,1,6,8,14,Zimbabwe
9975,Peter Nicholas,0,15.0,0,0,0,1,1,Malta
9976,Peter Nielsen,0,70.0,0,0,1,0,1,Denmark
9977,Peter Németh,0,126.0,0,0,1,1,2,Slovakia
9978,Peter O'Sullivan,0,18.0,0,0,1,0,1,Wales
9979,Peter Odemwingie,3,278.0,0,0,6,0,6,Nigeria
9980,Peter Ollerton,0,273.0,0,0,2,4,6,Australia
9981,Peter Ouma,1,100.0,0,0,2,0,2,Kenya
9982,Peter Pekarík,0,52.0,0,0,2,0,2,Slovakia
9983,Peter Pumm,0,78.0,0,0,1,0,1,Austria
9984,Peter Rasmussen,2,163.0,0,0,2,0,2,Denmark
9985,Peter Risi,0,125.0,0,0,0,2,2,Russia
9986,Peter Rock,0,89.0,0,0,1,0,1,German DR
9987,Peter Roronamahava,1,45.0,0,0,0,1,1,New Zealand
9988,Peter Shalulile,1,209.0,0,0,2,2,4,Eritrea
9989,Peter Sharne,4,388.0,0,0,4,1,5,Australia
9990,Peter Stöger,0,438.0,0,0,8,1,9,Austria
9991,Peter Tino,0,142.0,0,0,3,0,3,Tanzania
9992,Peter Van Der Heyden,0,75.0,0,0,0,1,1,Japan
9993,Peter Vermes,0,70.0,0,0,2,0,2,United States
9994,Peter Wilson,2,165.0,0,0,3,0,3,Australia
9995,Peter Withe,0,70.0,0,0,1,0,1,England
9996,Peter van Vossen,0,398.0,0,1,3,3,6,Netherlands
9997,Peterkins Kayira,0,150.0,0,0,3,0,3,Malawi
9998,Petit,0,239.0,1,0,3,0,3,Portugal
9999,Petit Sory,1,126.0,0,0,1,2,3,DR Congo
10000,Petko Petkov,0,48.0,0,0,1,0,1,Bulgaria
10001,Petr Janečka,0,388.0,0,0,6,2,8,Turkey
10002,Petr Jiráček,1,156.0,0,0,0,3,3,Montenegro
10003,Petr Kachuro,0,73.0,0,1,0,1,1,Scotland
10004,Petr Rada,0,139.0,0,1,2,0,2,Czechoslovakia
10005,Petr Vrabec,1,13.0,0,0,1,0,1,Czech Republic
10006,Petri Helin,0,83.0,0,0,0,1,1,Faroe Islands
10007,Petri Järvinen,0,105.0,0,0,1,1,2,Finland
10008,Petri Pasanen,0,23.0,1,0,1,0,1,Russia
10009,Petri Tiainen,0,82.0,0,0,1,0,1,Finland
10010,Petros Mantalos,0,89.0,0,0,2,0,2,Greece
10011,Petros Marinakis,0,67.0,0,0,0,1,1,Malta
10012,Petru Racu,0,65.0,1,0,0,1,1,Moldova
10013,Petter Hansson,1,72.0,0,0,0,1,1,Greece
10014,Petter Rudi,0,21.0,0,0,0,2,2,Hungary
10015,Petter Villegas,0,137.0,0,1,2,0,2,Puerto Rico
10016,Phan Thanh Bình,0,32.0,0,0,1,0,1,Vietnam
10017,Phan Thanh Hùng,1,77.0,0,0,1,0,1,Vietnam
10018,Phan Văn Tài Em,0,118.0,0,0,3,0,3,Vietnam
10019,Phan Văn Đức,0,76.0,0,0,1,0,1,Vietnam
10020,Phengta Phounsamay,0,15.0,0,0,1,0,1,Laos
10021,Phil Babb,0,88.0,1,0,1,0,1,Russia
10022,Phil Evans,1,28.0,0,0,1,0,1,South Africa
10023,Phil Foden,1,51.0,0,0,0,1,1,Wales
10024,Phil Gray,0,321.0,0,0,3,2,5,Northern Ireland
10025,Phil Jagielka,0,25.0,0,0,1,0,1,England
10026,Phil Masinga,1,231.0,0,0,5,2,7,South Africa
10027,Phil Neal,0,174.0,0,0,1,1,2,Denmark
10028,Phil Roberts,0,70.0,0,0,1,0,1,Wales
10029,Phil Woosnam,0,7.0,0,0,1,0,1,Wales
10030,Phil Younghusband,0,100.0,0,1,2,0,2,Philippines
10031,Philip Mulryne,0,118.0,0,0,0,2,2,Czech Republic
10032,Philip Zialor,0,137.0,0,0,3,0,3,Seychelles
10033,Philipp Hosiner,0,28.0,0,0,2,0,2,Austria
10034,Philipp Lahm,2,135.0,0,0,3,0,3,Germany
10035,Philippe Albert,2,272.0,0,0,1,3,4,Faroe Islands
10036,Philippe Anziani,0,89.0,0,0,1,0,1,France
10037,Philippe Clement,0,55.0,0,0,0,1,1,Bulgaria
10038,Philippe Coutinho,5,713.0,0,2,14,0,14,Brazil
10039,Philippe Erne,0,7.0,0,0,1,0,1,Liechtenstein
10040,Philippe Fargeon,0,55.0,0,0,1,0,1,France
10041,Philippe Gondet,0,112.0,0,0,3,0,3,France
10042,Philippe Mahut,0,5.0,1,0,1,0,1,Republic of Ireland
10043,Philippe Mexès,0,28.0,0,0,0,1,1,Luxembourg
10044,Philippe Michel Mouthé,0,34.0,0,0,1,0,1,Cameroon
10045,Philippe Senderos,1,149.0,0,0,2,3,5,Cyprus
10046,Philippe Vorbe,0,52.0,0,0,1,0,1,Haiti
10047,Phillemon Tegire,1,22.0,1,0,0,1,1,Zimbabwe
10048,Phillip Cocu,3,349.0,0,0,6,4,10,Netherlands
10049,Phillip Omondi,3,95.0,0,0,0,3,3,Congo
10050,Phillip Skeal,0,68.0,1,0,0,1,1,Antigua and Barbuda
10051,Phutthadavong Chanthalome,0,88.0,0,0,1,0,1,Laos
10052,Phạm Thành Lương,0,62.0,0,0,1,0,1,Vietnam
10053,Phạm Văn Quyến,0,80.0,0,1,1,0,1,Vietnam
10054,Pier Domenico Della Valle,0,34.0,0,0,0,1,1,Finland
10055,Pier Janssen,0,48.0,0,0,1,0,1,Belgium
10056,Pierino Prati,0,250.0,0,0,3,2,5,Bulgaria
10057,Pierluigi Casiraghi,2,295.0,0,0,4,3,7,Portugal
10058,Piero Alva,0,47.0,0,0,2,0,2,Peru
10059,Piero Hincapié,0,86.0,1,0,2,0,2,Ecuador
10060,Pieros Sotiriou,1,479.0,0,2,7,2,9,Cyprus
10061,Pierre Flamion,0,160.0,0,0,0,2,2,Luxembourg
10062,Pierre Issa,0,77.0,1,0,1,0,1,France
10063,Pierre Kalala Mukendi,3,154.0,0,1,3,0,3,DR Congo
10064,Pierre Lingongo,0,23.0,0,0,1,0,1,Congo
10065,Pierre Littbarski,2,416.0,0,0,5,5,10,Austria
10066,Pierre Njanka,1,77.0,0,0,1,0,1,Cameroon
10067,Pierre Tchibota,2,58.0,0,0,0,2,2,Algeria
10068,Pierre Wacapo,1,90.0,0,0,1,0,1,New Caledonia
10069,Pierre Wajoka,3,180.0,0,1,5,0,5,New Caledonia
10070,Pierre Webó,0,360.0,0,0,3,5,8,Cameroon
10071,Pierre Womé,1,44.0,0,0,1,0,1,Cameroon
10072,Pierre van Hooijdonk,3,703.0,0,2,6,5,11,Wales
10073,Pierre-Emerick Aubameyang,1,733.0,0,5,11,2,13,Gabon
10074,Pierre-Emile Højbjerg,0,208.0,0,0,2,1,3,Denmark
10075,Piet Keizer,0,412.0,0,1,6,2,8,German DR
10076,Piet Kruiver,0,41.0,0,0,1,1,2,Switzerland
10077,Piet Wildschut,0,19.0,0,0,0,1,1,Switzerland
10078,Piet de Boer,0,228.0,0,0,3,0,3,Netherlands
10079,Pietro Anastasi,1,145.0,0,0,2,1,3,Italy
10080,Pietro Ferraris,1,2.0,0,0,1,0,1,Italy
10081,Pietro Marsetti,0,72.0,0,0,1,0,1,Ecuador
10082,Pietro Vierchowod,0,63.0,0,0,1,1,2,Cyprus
10083,Pinga,4,176.0,0,0,2,2,4,Bolivia
10084,Pini Balili,1,215.0,0,0,2,1,3,Israel
10085,Pinula Contreras,0,169.0,0,0,3,1,4,Guatemala
10086,Piotr Czachowski,0,59.0,0,0,1,0,1,Poland
10087,Piotr Nowak,0,70.0,0,0,2,0,2,Poland
10088,Piotr Trochowski,0,72.0,0,0,1,0,1,Germany
10089,Piotr Włodarczyk,0,36.0,0,0,0,1,1,Northern Ireland
10090,Piotr Zieliński,1,187.0,0,0,2,2,4,San Marino
10091,Pipat Thonkanya,0,148.0,0,0,2,0,2,Thailand
10092,Piqueti,1,60.0,0,0,0,3,3,Cameroon
10093,Pirmurod Burkhanov,0,84.0,0,0,0,2,2,Kyrgyzstan
10094,Pirri,1,388.0,0,2,8,2,10,Argentina
10095,Pita David Maki,1,74.0,0,0,0,1,1,Cook Islands
10096,Pita Rabo,1,24.0,0,0,1,0,1,Fiji
10097,Pius Ndiefi,1,73.0,0,0,1,1,2,Zambia
10098,Piyapong Pue-on,9,468.0,0,1,5,6,11,South Korea
10099,Pizzi,0,52.0,0,0,1,0,1,Portugal
10100,Plamen Getov,1,96.0,0,0,2,1,3,Bulgaria
10101,Plamen Markov,0,28.0,0,0,0,1,1,Finland
10102,Plamen Nikolov,0,68.0,0,0,1,0,1,Bulgaria
10103,Platini,1,35.0,0,0,0,1,1,Morocco
10104,Pokklaw Anan,0,214.0,0,0,2,1,3,Thailand
10105,Pollen Ndlanya,1,77.0,0,0,0,1,1,Uruguay
10106,Polly Ouma,0,163.0,0,0,1,1,2,Ethiopia
10107,Polo Carrera,0,96.0,0,0,2,0,2,Ecuador
10108,Ponaryo Astaman,1,48.0,0,0,0,1,1,Qatar
10109,Ponciano Castro,0,121.0,0,0,1,1,2,Ecuador
10110,Pongthorn Thiubthong,1,54.0,0,0,0,1,1,Bangladesh
10111,Pontus Wernbloom,0,124.0,0,0,2,0,2,Sweden
10112,Porfirio Jiménez,0,141.0,0,0,2,1,3,Bolivia
10113,Porfirio Rolón,1,14.0,0,0,0,1,1,Chile
10114,Poul Pedersen,0,17.0,0,0,1,0,1,Denmark
10115,Prapon Tantariyanond,0,237.0,0,0,3,0,3,Thailand
10116,Prasert Changmool,0,79.0,0,0,0,1,1,Bangladesh
10117,Preben Elkjær,6,1214.0,0,0,19,7,26,Denmark
10118,Predrag Mijatović,12,1067.0,0,4,13,10,23,Serbia
10119,Predrag Pašić,0,73.0,0,0,1,0,1,Yugoslavia
10120,Predrag Spasić,0,11.0,0,0,1,0,1,Yugoslavia
10121,Predrag Đorđević,1,51.0,0,0,1,0,1,Serbia
10122,Preguinho,3,202.0,0,0,1,2,3,Brazil
10123,Preki,1,232.0,0,0,3,1,4,Guatemala
10124,Presley Carson,1,40.0,0,0,0,1,1,Canada
10125,Primož Gliha,0,346.0,0,0,2,4,6,Slovenia
10126,Prince Akim Daye,1,7.0,0,0,1,0,1,Liberia
10127,Prince Daye,0,5.0,0,0,1,0,1,Liberia
10128,Prince Mumba,0,57.0,0,0,0,1,1,Mauritania
10129,Prince Oniangué,1,102.0,0,0,0,2,2,São Tomé and Príncipe
10130,Prince Opoku Polley,1,42.0,0,0,1,0,1,Ghana
10131,Prince Polley,1,54.0,0,0,0,1,1,Nigeria
10132,Prince Tagoe,0,47.0,0,0,3,0,3,Ghana
10133,Prvoslav Mihajlović,2,96.0,0,1,0,2,2,France
10134,Przemysław Frankowski,0,74.0,0,0,1,0,1,Poland
10135,Przemysław Kaźmierczak,0,84.0,0,0,1,0,1,Poland
10136,Préjuce Nakoulma,1,490.0,0,0,6,3,9,Burkina Faso
10137,Putut Widjanarko,1,55.0,0,0,1,0,1,Indonesia
10138,Pyry Soiri,0,168.0,0,0,0,2,2,Croatia
10139,Pál Dárdai,0,108.0,0,0,0,2,2,Azerbaijan
10140,Pál Teleki,1,11.0,0,0,0,1,1,Egypt
10141,Pál Titkos,2,138.0,0,0,4,0,4,Hungary
10142,Pável Pardo,2,491.0,0,1,7,1,8,Mexico
10143,Pär Zetterberg,0,217.0,0,1,2,2,4,Sweden
10144,Pål Jacobsen,0,49.0,0,0,2,0,2,Norway
10145,Pål Lydersen,0,49.0,0,1,1,0,1,Norway
10146,Péter Hannich,0,56.0,0,0,0,1,1,Luxembourg
10147,Péter Juhász,0,51.0,0,0,1,0,1,Hungary
10148,Péter Kovács,0,93.0,0,0,0,1,1,Malta
10149,Péter Palotás,2,158.0,0,0,2,0,2,Hungary
10150,Péter Rajczi,0,175.0,0,0,2,0,2,Hungary
10151,Pétur Marteinsson,0,70.0,0,0,0,1,1,Faroe Islands
10152,Pétur Ormslev,0,65.0,0,0,2,0,2,Iceland
10153,Pétur Pétursson,0,219.0,0,1,3,2,5,German DR
10154,Pól Jóhannus Justinussen,0,73.0,1,0,0,1,1,Faroe Islands
10155,Pāvels Šteinbors,0,76.0,1,0,1,0,1,Austria
10156,Přemysl Bičovský,0,177.0,0,0,3,2,5,Czechoslovakia
10157,Qahtan Chathir,1,175.0,0,0,1,3,4,Pakistan
10158,Qasim Said,0,1.0,0,0,0,1,1,India
10159,Qazim Laçi,0,58.0,0,0,1,0,1,Albania
10160,Qi Hong,3,372.0,0,0,5,2,7,China PR
10161,Qiu Li,0,22.0,0,0,1,0,1,Singapore
10162,Qu Bo,0,194.0,0,0,3,2,5,Cambodia
10163,Quah Kim Song,0,85.0,0,0,2,0,2,Singapore
10164,Quentin Clarke,1,135.0,0,0,1,2,3,Curaçao
10165,Quincy Owusu-Abeyie,0,70.0,0,0,1,0,1,Ghana
10166,Quincy Promes,0,116.0,0,0,3,0,3,Netherlands
10167,Quini,1,133.0,0,0,0,3,3,Scotland
10168,Quino Sierra,0,35.0,0,0,2,0,2,Spain
10169,Quinton Fortune,1,111.0,0,2,1,1,2,Paraguay
10170,Quinton Griffith,0,182.0,0,1,1,3,4,Antigua and Barbuda
10171,Quinzinho,1,52.0,0,0,0,1,1,Ivory Coast
10172,Qusay Munir,4,294.0,0,0,3,2,5,Turkmenistan
10173,Quế Ngọc Hải,2,201.0,0,3,1,2,3,Vietnam
10174,Raafat Attia,0,21.0,0,1,0,1,1,Sudan
10175,Rabah Gamouh,0,129.0,0,0,0,2,2,Guinea
10176,Rabah Madjer,3,808.0,0,1,11,3,14,Algeria
10177,Rabia Al-Alawi,1,331.0,0,0,1,4,5,India
10178,Rabih Ataya,1,73.0,0,0,0,1,1,Turkmenistan
10179,Rachad Chitou,0,60.0,0,0,1,0,1,Benin
10180,Rached Meddeb,1,128.0,0,0,1,1,2,Morocco
10181,Rachid Alioui,1,64.0,0,0,1,0,1,Morocco
10182,Rachid Benmahmoud,1,94.0,0,1,0,2,2,Algeria
10183,Rachid Daoudi,0,123.0,0,0,0,3,3,Benin
10184,Rachid Maâtar,1,86.0,0,0,1,0,1,Algeria
10185,Rachid Rokki,0,49.0,0,0,1,0,1,Morocco
10186,Radamel Falcao,3,923.0,0,4,12,4,16,Colombia
10187,Rade Krunić,0,47.0,0,0,2,0,2,Bosnia and Herzegovina
10188,Radek Bejbl,1,142.0,0,0,2,1,3,Czech Republic
10189,Radek Drulák,0,170.0,0,0,3,0,3,Czech Republic
10190,Radhi Jaïdi,2,239.0,0,0,2,2,4,Tunisia
10191,Radhi Shenaishil,1,90.0,0,0,1,0,1,Iraq
10192,Radhwan Nairooz,0,52.0,0,0,1,0,1,Oman
10193,Radike Nawasu,0,110.0,0,0,0,2,2,Vanuatu
10194,Radivoje Ognjanović,1,18.0,0,0,0,1,1,Paraguay
10195,Radja Nainggolan,2,167.0,0,0,0,4,4,Bosnia and Herzegovina
10196,Radomir Đalović,0,53.0,0,0,1,0,1,Montenegro
10197,Radoslav Batak,0,13.0,0,0,1,0,1,Montenegro
10198,Radoslav Dimitrov,0,9.0,0,0,0,1,1,Malta
10199,Radoslav Kováč,0,69.0,0,0,1,1,2,Czech Republic
10200,Radoslav Látal,1,78.0,0,0,2,0,2,Czech Republic
10201,Radoslav Zabavník,0,90.0,0,0,1,0,1,Slovakia
10202,Radostin Kishishev,0,77.0,1,0,2,0,2,Albania
10203,Radosław Kałużny,0,229.0,0,0,3,3,6,Ukraine
10204,Radosław Matusiak,0,95.0,0,0,1,2,3,Poland
10205,Radu Gînsari,0,15.0,0,0,1,0,1,Moldova
10206,Radu Nunweiller,0,129.0,0,0,1,1,2,Romania
10207,Radu Rebeja,0,158.0,0,0,0,2,2,Germany
10208,Radwan Abduljabar,0,49.0,0,0,1,0,1,Yemen
10209,Radwan Al-Sheikh Hassan,1,52.0,0,0,2,0,2,Syria
10210,Raed Ibrahim Saleh,0,7.0,0,0,1,0,1,Oman
10211,Raf de Gregorio,1,117.0,0,0,1,1,2,New Zealand
10212,Rafael Albrecht,1,231.0,0,1,3,0,3,Argentina
10213,Rafael Alsua,0,65.0,0,0,1,0,1,Spain
10214,Rafael Arlex Castillo,0,82.0,0,0,0,1,1,Paraguay
10215,Rafael Burgos,0,236.0,0,0,2,1,3,El Salvador
10216,Rafael Castellín,0,55.0,0,0,0,1,1,Uruguay
10217,Rafael Dick,0,56.0,0,0,1,0,1,Honduras
10218,Rafael Dudamel,0,87.0,0,0,1,0,1,Venezuela
10219,Rafael García Torres,0,42.0,0,0,1,0,1,Mexico
10220,Rafael Gordillo,1,201.0,0,0,1,2,3,Malta
10221,Rafael Granados,1,90.0,0,0,0,1,1,Chile
10222,Rafael Iriarte,0,86.0,0,0,1,0,1,Venezuela
10223,Rafael Leão,2,170.0,0,0,2,0,2,Portugal
10224,Rafael Maldonado,1,74.0,0,0,0,1,1,Colombia
10225,Rafael Morales,0,85.0,0,0,2,0,2,Guatemala
10226,Rafael Márquez,6,684.0,0,0,8,5,13,Mexico
10227,Rafael Olarra,1,40.0,0,0,0,1,1,Costa Rica
10228,Rafael Santana,3,295.0,0,0,3,2,5,Venezuela
10229,Rafael Urazbakhtin,1,21.0,0,0,0,1,1,Nepal
10230,Rafael van der Vaart,1,673.0,0,1,8,7,15,Netherlands
10231,Rafael Ávalos,0,6.0,0,0,0,1,1,Haiti
10232,Rafał Boguski,0,28.0,0,0,2,0,2,Poland
10233,Rafał Murawski,0,28.0,0,0,0,1,1,Serbia
10234,Rafał Siadaczka,0,22.0,0,0,0,1,1,Luxembourg
10235,Rafał Wolski,0,89.0,0,0,0,1,1,Armenia
10236,Rafi Ali,1,60.0,0,0,0,1,1,Kyrgyzstan
10237,Rafi Joulfagi,1,122.0,0,0,1,1,2,Lebanon
10238,Rafi Levi,1,13.0,0,0,1,0,1,Israel
10239,Rafik Djebbour,0,91.0,0,0,2,0,2,Algeria
10240,Rafik Halliche,2,71.0,0,0,0,2,2,Mali
10241,Rafik Saïfi,0,231.0,0,0,4,1,5,Algeria
10242,Rafik Yusupov,1,28.0,0,0,1,0,1,Kyrgyzstan
10243,Rafiou Moutairou,1,56.0,0,0,0,1,1,Cameroon
10244,Raghdan Shehadeh,0,92.0,0,0,2,0,2,Syria
10245,Ragnar Klavan,0,165.0,3,0,2,1,3,Hungary
10246,Ragnar Margeirsson,0,48.0,0,0,0,1,1,Austria
10247,Ragnar Sigurðsson,1,158.0,0,0,3,2,5,Czech Republic
10248,Rahamim Talbi,0,48.0,0,0,1,0,1,Israel
10249,Raheem Sterling,1,830.0,0,0,12,4,16,England
10250,Raheim Sargeant,0,4.0,0,0,0,1,1,United States Virgin Islands
10251,Rahid Amirguliyev,0,177.0,0,0,0,3,3,Israel
10252,Rahmad Darmawan,1,35.0,0,0,1,0,1,Indonesia
10253,Rahman Hisham Abdullah,0,66.0,0,0,1,0,1,Bahrain
10254,Rahman Rezaei,1,61.0,1,0,1,1,2,Iran
10255,Rahmatullo Fuzailov,1,52.0,0,0,1,0,1,Tajikistan
10256,Raimondo Ponte,0,59.0,0,0,0,1,1,Iceland
10257,Raimonds Krollis,0,75.0,0,0,0,1,1,Gibraltar
10258,Raimundo Infante,3,208.0,0,1,2,1,3,Bolivia
10259,Raimundo Orsi,0,170.0,0,0,3,0,3,Italy
10260,Raimundo Sandoval,1,9.0,0,0,1,0,1,Argentina
10261,Rainer Bonhof,0,71.0,0,1,2,0,2,Germany
10262,Rainer Ernst,0,591.0,0,1,4,5,9,German DR
10263,Rainer Rauffmann,0,111.0,0,0,2,0,2,Cyprus
10264,Rainford Kalaba,2,126.0,0,0,1,2,3,Zambia
10265,Raio Piiroja,0,488.0,3,0,4,5,9,Faroe Islands
10266,Raja Rafe,2,481.0,0,0,4,4,8,Syria
10267,Rajab Elharbi,0,35.0,0,0,1,0,1,Libya
10268,Rajabu Mwinyi,0,16.0,1,0,1,0,1,Gabon
10269,Rajko Mitić,1,59.0,0,0,0,1,1,Switzerland
10270,Raju Kaji Shakya,1,1.0,1,0,0,1,1,Nepal
10271,Ralf Edström,3,367.0,0,0,7,2,9,Sweden
10272,Ralf Minge,0,213.0,0,0,2,3,5,Luxembourg
10273,Ralph Bean,0,122.0,0,0,2,1,3,Bermuda
10274,Ralph Brand,0,140.0,0,0,2,1,3,Scotland
10275,Ralph McPate,0,108.0,0,0,2,0,2,Canada
10276,Ramadan Agab,0,154.0,0,0,0,3,3,Chad
10277,Ramadan El Sayed,1,47.0,0,0,0,1,1,Algeria
10278,Ramadan Sobhi,0,72.0,0,0,0,1,1,Libya
10279,Raman Vasilyuk,0,351.0,0,2,5,2,7,Belarus
10280,Raman Vijayan,1,81.0,0,0,1,0,1,India
10281,Ramaz Shengelia,4,299.0,0,0,5,1,6,Russia
10282,Ramazan Rragami,0,25.0,0,1,1,0,1,Albania
10283,Ramez Dayoub,0,72.0,1,0,0,1,1,Lebanon
10284,Rami Bedoui,1,90.0,1,0,1,0,1,Ghana
10285,Rami Gershon,0,160.0,0,0,1,1,2,Malta
10286,Ramil Sheydayev,0,82.0,0,0,1,2,3,Germany
10287,Ramin Ott,1,94.0,0,0,1,1,2,American Samoa
10288,Ramin Rezaeian,1,139.0,0,0,0,2,2,Guam
10289,Ramiro Blacut,0,83.0,0,0,2,0,2,Bolivia
10290,Ramiro Borja,0,57.0,0,0,0,1,1,Dominican Republic
10291,Ramiro Castillo,0,119.0,0,0,1,1,2,Venezuela
10292,Ramiro Funes Mori,0,15.0,0,0,0,1,1,Peru
10293,Ramiro Navarro,0,57.0,0,0,1,0,1,Mexico
10294,Ramiro Tobar,0,79.0,1,0,1,0,1,Chile
10295,Ramiro Vaca,0,83.0,0,0,1,0,1,Bolivia
10296,Ramiz Zerrouki,0,69.0,0,0,1,0,1,Algeria
10297,Ramkel Lok,0,74.0,0,0,1,0,1,Ethiopia
10298,Ramon Djamali,1,98.0,0,0,1,1,2,New Caledonia
10299,Ramon Gjamaci,0,66.0,0,0,0,1,1,Fiji
10300,Ramon Menezes,1,30.0,0,0,0,1,1,France
10301,Ramoseli Thietsi,0,30.0,0,0,0,1,1,Zambia
10302,Ramy Bensebaini,0,27.0,0,0,1,0,1,Algeria
10303,Ramón Bóveda,0,80.0,0,0,1,0,1,Argentina
10304,Ramón Calderé,2,164.0,0,0,0,3,3,Algeria
10305,Ramón Castro,3,172.0,0,0,0,4,4,Ecuador
10306,Ramón Colmán,1,81.0,0,0,0,1,1,Venezuela
10307,Ramón Díaz,1,89.0,0,0,1,0,1,Argentina
10308,Ramón Grosso,0,63.0,0,0,1,0,1,Spain
10309,Ramón Heredia,1,60.0,0,0,0,1,1,Poland
10310,Ramón Hicks,0,15.0,0,0,1,0,1,Paraguay
10311,Ramón Iriarte,0,14.0,0,0,1,0,1,Venezuela
10312,Ramón Mariano,0,50.0,0,0,1,0,1,Dominican Republic
10313,Ramón Medina Bello,0,217.0,0,0,1,3,4,Paraguay
10314,Ramón Morales,2,62.0,0,0,0,3,3,Argentina
10315,Ramón Núñez,0,168.0,0,0,1,2,3,Canada
10316,Ramón Quevedo,0,29.0,0,0,1,0,1,Bolivia
10317,Ramón Ramírez,4,531.0,0,0,7,4,11,Mexico
10318,Ramón Santos,2,91.0,0,0,2,0,2,Bolivia
10319,Ramón Sánchez,1,38.0,0,0,1,0,1,El Salvador
10320,Ramón Víctor Castro,1,73.0,0,0,0,1,1,Bolivia
10321,Ramūnas Stonkus,0,47.0,0,0,1,0,1,Lithuania
10322,Randal Kolo Muani,1,79.0,0,0,1,0,1,France
10323,Randall Azofeifa,0,160.0,0,0,1,1,2,Costa Rica
10324,Randall Brenes,3,368.0,0,1,5,1,6,Costa Rica
10325,Randolph Burton,0,262.0,0,0,2,2,4,United States Virgin Islands
10326,Randolph Peltier,0,80.0,0,0,1,0,1,Dominica
10327,Rangelo Janga,0,87.0,0,0,0,1,1,Panama
10328,Rangsan Viwatchaichok,1,15.0,1,0,1,0,1,Oman
10329,Ranjae Christian,0,18.0,0,0,0,1,1,United States Virgin Islands
10330,Raouf Bouzaiene,1,17.0,0,0,1,0,1,Tunisia
10331,Raoul Lambert,2,709.0,0,5,11,2,13,Belgium
10332,Raphael Chukwu,0,45.0,0,0,1,0,1,Nigeria
10333,Raphael Lea'i,4,233.0,0,0,4,0,4,Solomon Islands
10334,Raphael Rohrer,0,69.0,0,0,0,1,1,Iceland
10335,Raphaël Guerreiro,1,178.0,1,0,2,1,3,Hungary
10336,Raphaël Mirval,1,45.0,0,0,0,1,1,Costa Rica
10337,Raphaël Varane,1,102.0,0,0,1,2,3,Uruguay
10338,Raphaël Wicky,0,25.0,0,0,0,1,1,Faroe Islands
10339,Raphel Ortiz,0,19.0,0,0,1,1,2,Aruba
10340,Raphinha,0,104.0,0,0,3,0,3,Brazil
10341,Rashad Sadygov,0,348.0,3,0,6,0,6,Azerbaijan
10342,Rasheed Yekini,0,176.0,0,0,2,1,3,Nigeria
10343,Rashid Abdulrahman,0,24.0,0,0,1,0,1,United Arab Emirates
10344,Rashid Al-Wahaibi,2,116.0,0,0,0,2,2,Taiwan
10345,Rashid Juma Al-Farsi,0,90.0,1,0,1,0,1,Thailand
10346,Rashid Mohammed Rashid,0,90.0,0,0,1,0,1,Libya
10347,Rashida Williams,0,43.0,0,0,0,1,1,Dominica
10348,Rashidi Yekini,14,781.0,0,1,15,6,21,Kenya
10349,Rasmus Elm,0,127.0,0,0,1,1,2,Sweden
10350,Rateb Al-Awadat,0,85.0,0,0,1,0,1,Jordan
10351,Rateb Al-Dawud,0,139.0,0,0,1,1,2,Jordan
10352,Rathnayake Mudyanselage,0,57.0,0,0,1,0,1,Sri Lanka
10353,Ratu Jone,0,200.0,0,0,2,1,3,Fiji
10354,Rauf Aliyev,0,144.0,0,0,2,1,3,Azerbaijan
10355,Raul Meireles,2,231.0,0,0,3,2,5,Portugal
10356,Raul Rusescu,0,45.0,0,0,1,0,1,Romania
10357,Rauno Sappinen,1,12.0,0,0,1,0,1,Estonia
10358,Ravel Morrison,0,45.0,0,0,1,0,1,Jamaica
10359,Ravshan Bazarav,0,90.0,0,0,1,0,1,Uzbekistan
10360,Ravshan Bozorov,0,101.0,0,0,1,2,3,Cambodia
10361,Ravuame Madigi,0,66.0,0,0,1,0,1,Fiji
10362,Ray Baartz,1,272.0,0,0,2,3,5,Japan
10363,Ray Daniel,0,21.0,1,0,1,0,1,Czechoslovakia
10364,Ray Houghton,2,229.0,0,0,3,3,6,England
10365,Ray Kennedy,0,96.0,0,0,1,1,2,England
10366,Ray Pointer,0,46.0,0,0,2,0,2,England
10367,Ray Richards,0,121.0,0,0,2,0,2,Australia
10368,Ray Treacy,0,168.0,0,0,2,1,3,Czechoslovakia
10369,Ray Wilkins,1,26.0,0,0,0,1,1,Belgium
10370,Raydell Schuurman,1,88.0,0,0,0,1,1,Montserrat
10371,Rayed Al-Boloushi,1,65.0,0,0,0,1,1,Vietnam
10372,Raymond Braine,0,55.0,0,0,0,1,1,Luxembourg
10373,Raymond Cicci,0,41.0,0,0,0,1,1,Luxembourg
10374,Raymond Davelaar,0,98.0,0,1,1,1,2,Dominican Republic
10375,Raymond Gunemba,0,382.0,0,0,6,1,7,Papua New Guinea
10376,Raymond Kalla,1,29.0,0,0,1,0,1,Cameroon
10377,Raymond Kopa,4,323.0,0,3,5,2,7,Luxembourg
10378,Raymond Valette,0,90.0,0,0,0,1,1,New Zealand
10379,Raymond Xuereb,0,84.0,0,0,1,0,1,Malta
10380,Razak Omotoyossi,2,597.0,0,2,6,7,13,Ivory Coast
10381,Razali Saad,0,214.0,0,0,3,0,3,Singapore
10382,Razimie Ramlli,0,39.0,0,0,2,0,2,Brunei
10383,Razmik Grigoryan,0,84.0,0,0,1,1,2,Armenia
10384,Razundara Tjikuzu,0,150.0,0,0,4,0,4,Namibia
10385,Razzaq Farhan,4,116.0,0,0,2,2,4,Palestine
10386,Raí,1,126.0,0,2,2,2,4,Venezuela
10387,Raúl,6,1496.0,0,0,18,14,32,Spain
10388,Raúl Alvarez,0,139.0,0,0,2,0,2,Bolivia
10389,Raúl Armando Savoy,4,210.0,0,0,4,0,4,Argentina
10390,Raúl Avilés,0,166.0,0,0,1,1,2,Paraguay
10391,Raúl Belén,0,150.0,0,0,3,0,3,Argentina
10392,Raúl Bernao,2,197.0,0,0,3,1,4,Argentina
10393,Raúl Cárdenas,1,77.0,1,0,2,0,2,France
10394,Raúl Díaz Arce,2,1046.0,0,2,14,6,20,El Salvador
10395,Raúl Echeverría,2,191.0,0,0,2,1,3,Uruguay
10396,Raúl Fernández,1,57.0,0,0,1,0,1,Bolivia
10397,Raúl Jiménez,9,1041.0,0,6,12,5,17,Mexico
10398,Raúl Justiniano,0,38.0,0,0,1,0,1,Bolivia
10399,Raúl Leguías,0,174.0,0,0,1,4,5,Dominica
10400,Raúl Morales,0,30.0,0,0,1,0,1,Bolivia
10401,Raúl Muñoz,1,3.0,0,0,1,0,1,Chile
10402,Raúl Noriega,0,104.0,0,0,2,0,2,Ecuador
10403,Raúl Núñez Velloso,1,78.0,0,0,0,1,1,Chile
10404,Raúl Palacios,1,81.0,0,0,1,0,1,Chile
10405,Raúl Pérez,0,20.0,0,0,1,0,1,Chile
10406,Raúl Ruidíaz,1,165.0,0,0,1,1,2,Peru
10407,Raúl Sarro,1,38.0,0,0,0,2,2,Chile
10408,Raúl Schiaffino,1,57.0,0,0,0,1,1,Paraguay
10409,Raúl Servín,0,61.0,0,0,1,0,1,Mexico
10410,Raúl Tamudo,0,14.0,0,0,0,1,1,Denmark
10411,Raúl Toro Julio,7,327.0,0,0,6,3,9,Argentina
10412,Raşit Çetiner,0,73.0,1,0,1,0,1,Albania
10413,Recep Adanır,0,31.0,0,0,0,1,1,Spain
10414,Recep Çetin,0,39.0,0,0,1,0,1,Turkey
10415,Reda Al-Senussi,0,33.0,0,0,1,0,1,Libya
10416,Redha Abujabarah,0,90.0,0,0,1,0,1,Kuwait
10417,Redha Tukar,0,188.0,0,0,3,0,3,Saudi Arabia
10418,Redjep Agabaev,0,39.0,0,0,1,0,1,Turkmenistan
10419,Redouane Guezzar,1,87.0,0,0,1,0,1,Morocco
10420,Redwan Abrash,2,170.0,0,0,0,2,2,Maldives
10421,Reece Styche,0,147.0,0,1,1,2,3,Gibraltar
10422,Reg Ryan,0,106.0,0,2,2,0,2,Republic of Ireland
10423,Reginal Garo,0,27.0,0,0,0,1,1,Papua New Guinea
10424,Reginald Davani,6,237.0,0,0,1,6,7,Papua New Guinea
10425,Reid Klopp,0,147.0,0,0,1,1,2,United States Virgin Islands
10426,Reidar Kvammen,2,143.0,0,0,2,2,4,Norway
10427,Reinaldo Gomes,0,42.0,0,0,1,0,1,Portugal
10428,Reinaldo Navia,1,256.0,0,1,1,3,4,Peru
10429,Reinhard Häfner,0,177.0,0,0,0,3,3,Belgium
10430,Reinhard Libuda,1,99.0,0,0,1,1,2,Germany
10431,Reinhold Hintermaier,1,68.0,0,0,1,0,1,Austria
10432,Rejepmyrat Agabaýew,1,262.0,0,0,4,0,4,Turkmenistan
10433,Remo Eyoma,0,34.0,0,0,1,0,1,Equatorial Guinea
10434,Remo Freuler,1,157.0,0,0,2,1,3,Switzerland
10435,Renan Bardini Bressan,0,6.0,0,0,1,0,1,Belarus
10436,Renato Augusto,3,357.0,0,0,5,1,6,Brazil
10437,Renato Gaúcho,1,41.0,0,0,2,0,2,Brazil
10438,Renato Sanches,1,35.0,0,0,1,1,2,Poland
10439,Renato Steffen,0,42.0,0,0,0,1,1,Lithuania
10440,Renato Tapia,1,185.0,1,0,4,0,4,Peru
10441,Renato Zaccarelli,1,125.0,0,0,1,1,2,Italy
10442,Rene Krhin,0,163.0,0,0,0,2,2,Iceland
10443,Rene N'Djeya,1,32.0,0,0,1,0,1,Cameroon
10444,Renedy Singh,0,68.0,0,0,2,0,2,India
10445,Renne Regis,0,46.0,0,0,1,0,1,Saint Lucia
10446,Renny Ribera,1,40.0,0,0,1,0,1,Bolivia
10447,Renson Haynes,0,58.0,0,0,0,2,2,Nicaragua
10448,Rensy Barradas,0,76.0,0,0,0,1,1,Saint Lucia
10449,Renán Bengoche,0,89.0,0,0,0,1,1,Saint Vincent and the Grenadines
10450,Renán López,0,16.0,0,0,1,0,1,Bolivia
10451,René Aufhauser,0,295.0,0,0,5,0,5,Austria
10452,René Bader,1,10.0,0,0,0,1,1,Mexico
10453,René Borjas,1,44.0,0,0,0,2,2,Chile
10454,René Dereuddre,0,36.0,0,0,1,0,1,France
10455,René Girard,1,13.0,0,0,0,1,1,Poland
10456,René Higuita,2,121.0,1,1,1,1,2,Venezuela
10457,René Houseman,3,125.0,0,0,4,0,4,Argentina
10458,René Maillard,0,21.0,0,0,1,1,2,Switzerland
10459,René Meléndez,2,188.0,0,0,3,2,5,Bolivia
10460,René Nsi-Akoue,0,25.0,1,0,1,0,1,Angola
10461,René Peters,1,52.0,0,0,1,1,2,Serbia
10462,René Pontoni,8,225.0,0,0,8,0,8,Argentina
10463,René Vandereycken,1,96.0,0,2,2,0,2,Belgium
10464,René van de Kerkhof,1,212.0,0,0,2,2,4,Netherlands
10465,René-Pierre Quentin,1,259.0,0,0,6,3,9,Switzerland
10466,Renārs Rode,0,90.0,0,0,1,0,1,Latvia
10467,Reon Moore,1,12.0,0,0,0,1,1,Guatemala
10468,Reung Bunheing,1,89.0,0,0,0,1,1,Pakistan
10469,Reuven Atar,0,90.0,0,0,0,1,1,France
10470,Reuven Young,0,38.0,0,0,1,0,1,Israel
10471,Rey Manaj,0,240.0,0,0,2,2,4,Moldova
10472,Reynald Pedros,0,49.0,0,0,1,0,1,France
10473,Reynald Temarii,1,8.0,0,1,1,0,1,Tahiti
10474,Reynaldo Clavasquín,1,32.0,0,0,1,0,1,Honduras
10475,Reynaldo Mejia,0,73.0,0,0,1,0,1,Honduras
10476,Reynaldo Parks,1,58.0,0,0,1,0,1,Costa Rica
10477,Reynier Alcántara,2,97.0,0,0,0,2,2,Mexico
10478,Reynold Carrington,0,30.0,0,0,1,0,1,Trinidad and Tobago
10479,Reynold Saint Surin,0,90.0,0,0,1,0,1,Haiti
10480,Reza Enayati,1,139.0,0,0,1,2,3,Laos
10481,Reza Ghoochannejhad,3,553.0,0,0,4,3,7,Qatar
10482,Reza Hassanzadeh,1,45.0,0,0,0,1,1,Japan
10483,Reza Shahroudi,1,134.0,0,0,2,1,3,Maldives
10484,Rezaul Karim,0,56.0,0,0,1,0,1,Bangladesh
10485,Rhyan Grant,0,43.0,0,0,0,1,1,Vietnam
10486,Rhys Browne,0,20.0,0,0,1,0,1,Antigua and Barbuda
10487,Ri Han-jae,0,1.0,0,0,1,0,1,North Korea
10488,Ri Hyok-chol,0,146.0,0,0,2,2,4,North Korea
10489,Ri Hyok-chon,0,102.0,0,0,2,0,2,North Korea
10490,Riadh Bouazizi,1,53.0,0,0,1,0,1,Tunisia
10491,Riadh Jelassi,1,177.0,0,0,1,1,2,Liberia
10492,Ricard Fernández,0,89.0,0,0,0,1,1,San Marino
10493,Ricardo Adé,1,111.0,0,0,1,1,2,Haiti
10494,Ricardo Alcón,3,122.0,0,0,3,1,4,Bolivia
10495,Ricardo Altamirano,1,67.0,0,0,1,0,1,Argentina
10496,Ricardo Aquino,1,88.0,0,0,0,1,1,Chile
10497,Ricardo Bonelli,1,11.0,0,0,1,0,1,Argentina
10498,Ricardo Buitrago,0,82.0,0,0,1,1,2,Dominica
10499,Ricardo Cabanas,0,71.0,0,0,1,0,1,Switzerland
10500,Ricardo Carvalho,0,151.0,1,0,3,1,4,Portugal
10501,Ricardo Clark,1,97.0,0,0,1,1,2,United States
10502,Ricardo Costa,0,28.0,0,0,1,0,1,Portugal
10503,Ricardo Díaz,0,89.0,0,0,1,0,1,Colombia
10504,Ricardo Francisco Rojas,0,64.0,0,0,0,1,1,Colombia
10505,Ricardo Fuller,1,127.0,0,0,1,2,3,Guatemala
10506,Ricardo Gardner,0,73.0,0,0,2,0,2,Jamaica
10507,Ricardo Gareca,0,136.0,0,0,2,0,2,Argentina
10508,Ricardo Gomes,0,135.0,0,0,3,0,3,Brazil
10509,Ricardo González,0,15.0,1,0,1,0,1,Argentina
10510,Ricardo Horta,1,5.0,0,0,0,1,1,South Korea
10511,Ricardo Hyde,0,57.0,0,0,1,0,1,Jamaica
10512,Ricardo José Maria Ramaciotti,0,75.0,0,0,0,1,1,Ecuador
10513,Ricardo Mannetti,1,70.0,0,0,0,1,1,Ivory Coast
10514,Ricardo Oliveira,1,239.0,0,0,1,2,3,Mexico
10515,Ricardo Osorio,1,97.0,1,0,2,0,2,Mexico
10516,Ricardo Pavoni,1,87.0,0,0,0,1,1,Bulgaria
10517,Ricardo Peláez,4,351.0,0,0,2,4,6,Mexico
10518,Ricardo Pepi,0,186.0,0,0,2,1,3,Honduras
10519,Ricardo Phillips,2,123.0,0,0,1,2,3,Panama
10520,Ricardo Páez,0,111.0,0,0,1,1,2,Chile
10521,Ricardo Quaresma,4,354.0,0,0,2,3,5,Portugal
10522,Ricardo Rivera,1,140.0,0,1,3,1,4,Puerto Rico
10523,Ricardo Rodríguez,0,228.0,0,2,1,3,4,Hungary
10524,Ricardo Sá Pinto,1,396.0,0,0,4,4,8,Denmark
10525,Riccardo Carapellese,2,19.0,0,0,2,0,2,Italy
10526,Riccardo Ferri,0,12.0,0,0,0,1,1,Malta
10527,Riccardo Montolivo,0,34.0,0,0,1,0,1,Italy
10528,Riccardo Orsolini,0,78.0,0,0,1,0,1,Italy
10529,Richard Aquilina,0,33.0,0,0,1,0,1,Malta
10530,Richard Báez,0,5.0,0,0,0,1,1,Ecuador
10531,Richard Daddy Owubokiri,0,34.0,0,0,1,0,1,Nigeria
10532,Richard Daniel,0,15.0,0,0,1,0,1,Papua New Guinea
10533,Richard Dunne,0,187.0,0,0,3,3,6,Republic of Ireland
10534,Richard Dürr,0,56.0,0,1,1,0,1,Switzerland
10535,Richard Gough,0,175.0,0,0,1,2,3,Cyprus
10536,Richard Hastings,1,92.0,0,0,0,1,1,Mexico
10537,Richard Herrmann,1,84.0,0,0,1,0,1,Germany
10538,Richard Iwai,9,414.0,0,0,2,7,9,New Zealand
10539,Richard José Blanco,0,55.0,0,0,0,1,1,Bolivia
10540,Richard Kreß,0,29.0,0,0,1,0,1,Germany
10541,Richard Kuremaa,0,117.0,0,0,0,2,2,Sweden
10542,Richard Mbulu,1,10.0,0,0,1,0,1,Malawi
10543,Richard Morales,2,238.0,0,0,2,2,4,Mexico
10544,Richard O'Connor,0,40.0,0,1,0,1,1,Bahamas
10545,Richard Odada,0,15.0,0,1,1,0,1,Kenya
10546,Richard Orlans,0,61.0,0,0,2,0,2,Belgium
10547,Richard Ortiz,0,260.0,0,0,2,1,3,Paraguay
10548,Richard Pacquette,0,21.0,0,0,1,0,1,Dominica
10549,Richard Rodríguez,0,25.0,0,0,1,0,1,Nicaragua
10550,Richard Sele,0,73.0,0,0,1,0,1,New Caledonia
10551,Richard Smith,0,142.0,0,0,3,0,3,Costa Rica
10552,Richard Socrier,1,20.0,0,0,0,1,1,Honduras
10553,Richard Sánchez,1,37.0,0,0,0,1,1,Argentina
10554,Richard Witschge,0,20.0,0,0,1,0,1,Netherlands
10555,Richard Zambrano,2,110.0,0,0,0,2,2,Brazil
10556,Richardo Nabuth,0,18.0,0,0,1,0,1,Mauritius
10557,Richardson Smith,0,208.0,1,1,2,2,4,Costa Rica
10558,Richarlison,3,743.0,0,1,7,4,11,Brazil
10559,Richie Laryea,1,53.0,0,0,1,0,1,Canada
10560,Richmond Boakye,1,215.0,0,0,1,3,4,Congo
10561,Richárd Guzmics,0,133.0,0,0,0,2,2,Northern Ireland
10562,Ricki Herbert,0,130.0,0,0,2,0,2,New Zealand
10563,Rickie Lambert,0,26.0,0,0,1,0,1,England
10564,Ricky Charles,0,384.0,0,0,6,2,8,Guyana
10565,Ricky Phuka,0,44.0,0,0,0,1,1,Mauritius
10566,Ricky Shakes,0,168.0,0,0,1,2,3,Bermuda
10567,Ridle Baku,0,80.0,0,0,1,0,1,Germany
10568,Rifaat Turk,0,137.0,0,0,3,0,3,Israel
10569,Rifat Zhemaletdinov,0,55.0,0,0,0,1,1,Cyprus
10570,Rigobert Song,0,72.0,0,0,2,1,3,Cameroon
10571,Rigoberto Gómez,1,82.0,0,0,2,0,2,Honduras
10572,Rigoberto Rojas,0,28.0,0,0,1,0,1,Costa Rica
10573,Rihairo Meulens,0,9.0,0,0,0,1,1,Antigua and Barbuda
10574,Rija Rakotomandimby,0,127.0,0,0,1,1,2,Madagascar
10575,Riki van Steeden,0,85.0,0,0,1,0,1,New Zealand
10576,Riku Riski,0,131.0,0,0,0,2,2,Faroe Islands
10577,Rildo da Costa Menezes,1,73.0,0,0,1,0,1,Brazil
10578,Riley McGree,0,76.0,0,0,1,0,1,Australia
10579,Rinaldo Martino,4,232.0,0,0,5,0,5,Argentina
10580,Rinat Abdulin,0,27.0,0,0,1,1,2,Kazakhstan
10581,Rino Moretta,1,80.0,0,0,1,0,1,Tahiti
10582,Rinus Israël,0,208.0,0,1,2,1,3,Denmark
10583,Rio Ferdinand,1,141.0,0,0,2,1,3,Denmark
10584,Risdianto,1,44.0,0,0,0,1,1,Thailand
10585,Risto Božinov,0,67.0,0,0,2,0,2,North Macedonia
10586,Risto Radunović,0,90.0,0,0,0,1,1,Turkey
10587,Ritsu Dōan,4,251.0,0,1,2,2,4,Japan
10588,Rivaldo,12,1043.0,0,3,17,4,21,Brazil
10589,Rivaldo Vítor Borba Ferreira,1,42.0,0,0,0,1,1,Mexico
10590,Rivellino,6,368.0,0,0,5,2,7,Brazil
10591,Riyad Mahrez,6,534.0,0,1,10,2,12,Senegal
10592,Riyadh Nouri,1,161.0,0,0,1,1,2,Australia
10593,Rizvi Karim Rumi,2,80.0,0,0,1,1,2,Sri Lanka
10594,Ro Hak-su,0,34.0,0,0,1,0,1,North Korea
10595,Roald Jensen,0,59.0,0,0,0,1,1,Turkey
10596,Rob Rensenbrink,6,565.0,0,5,6,5,11,German DR
10597,Rob Witschge,1,109.0,0,0,3,0,3,Netherlands
10598,Rob de Wit,0,141.0,0,0,1,1,2,Hungary
10599,Robbie Brady,1,259.0,0,1,1,3,4,Bosnia and Herzegovina
10600,Robbie Dunn,0,91.0,0,1,2,0,2,Australia
10601,Robbie Earle,1,45.0,0,0,1,0,1,Jamaica
10602,Robbie Fowler,0,88.0,0,0,1,0,1,England
10603,Robbie Hooker,0,11.0,0,0,1,0,1,Australia
10604,Robbie James,0,159.0,0,0,2,1,3,Wales
10605,Robbie Keane,5,1935.0,0,10,28,16,44,Republic of Ireland
10606,Robbie Kruse,2,229.0,0,0,2,2,4,Uzbekistan
10607,Robbie Rogers,0,60.0,0,0,1,0,1,United States
10608,Robbie Savage,0,30.0,0,0,0,2,2,Turkey
10609,Robbie Slater,0,15.0,0,0,1,0,1,Australia
10610,Robby Darwis,1,77.0,1,0,1,0,1,North Korea
10611,Robby Langers,0,365.0,0,0,5,1,6,German DR
10612,Robert Arboleda,0,7.0,0,0,1,0,1,Ecuador
10613,Robert Arzumanyan,0,172.0,0,0,3,1,4,Kazakhstan
10614,Robert Ballaman,0,254.0,0,0,8,0,8,Switzerland
10615,Robert Berić,0,63.0,0,0,1,0,1,Slovenia
10616,Robert Cavallo,1,21.0,1,0,1,0,1,Peru
10617,Robert Clarke,1,25.0,0,0,1,0,1,Liberia
10618,Robert Dienst,0,106.0,0,0,1,1,2,Austria
10619,Robert Earnshaw,0,272.0,0,0,4,1,5,Wales
10620,Robert Edmond,0,28.0,0,0,1,0,1,Madagascar
10621,Robert Gadocha,0,209.0,0,0,7,0,7,Poland
10622,Robert Herbin,0,175.0,0,0,2,1,3,France
10623,Robert Hosp,0,10.0,0,0,1,0,1,Switzerland
10624,Robert Huth,0,79.0,0,0,1,0,1,Germany
10625,Robert Ironside,0,64.0,0,0,1,0,1,New Zealand
10626,Robert Jama Mba,0,42.0,0,0,2,0,2,Cameroon
10627,Robert Jarni,1,129.0,0,0,0,2,2,Denmark
10628,Robert Jashari,0,49.0,0,0,0,1,1,Northern Ireland
10629,Robert Kaumé,1,72.0,0,0,1,0,1,New Caledonia
10630,Robert Kizito,0,3.0,0,0,0,1,1,Angola
10631,Robert Koren,1,216.0,0,0,3,1,4,Slovenia
10632,Robert Lewandowski,9,2838.0,0,11,29,27,56,San Marino
10633,Robert Lüthi,0,75.0,0,0,0,1,1,Romania
10634,Robert Morales,0,10.0,0,0,1,0,1,Paraguay
10635,Robert Nauseb,1,33.0,0,0,0,1,1,Angola
10636,Robert Ng'ambi,0,214.0,0,0,3,0,3,Malawi
10637,Robert Pires,2,266.0,0,1,5,1,6,Russia
10638,Robert Prosinečki,3,526.0,0,1,5,5,10,Yugoslavia
10639,Robert Prytz,0,274.0,0,2,3,3,6,Sweden
10640,Robert Sara,0,59.0,0,0,0,1,1,Italy
10641,Robert Seni,2,389.0,0,0,4,2,6,Tahiti
10642,Robert Skov,0,163.0,0,0,3,1,4,Gibraltar
10643,Robert Snodgrass,0,297.0,0,1,1,5,6,Croatia
10644,Robert St. Fort,0,110.0,0,2,2,0,2,Haiti
10645,Robert Suzette,0,69.0,0,0,0,1,1,Zambia
10646,Robert Tasso,3,216.0,0,0,2,1,3,Vanuatu
10647,Robertas Fridrikas,0,133.0,0,0,1,1,2,Northern Ireland
10648,Robertas Poškus,0,37.0,0,0,1,0,1,Lithuania
10649,Roberto Acuña,1,147.0,0,1,1,2,3,Chile
10650,Roberto Alvarado,1,40.0,0,0,1,0,1,Mexico
10651,Roberto Ayala,2,228.0,3,0,2,4,6,Venezuela
10652,Roberto Baggio,7,1018.0,0,4,9,8,17,Italy
10653,Roberto Batata,0,139.0,0,0,3,0,3,Brazil
10654,Roberto Bettega,1,662.0,0,0,6,7,13,Luxembourg
10655,Roberto Boninsegna,2,147.0,0,0,2,4,6,Germany
10656,Roberto Brown,0,315.0,0,1,5,2,7,Panama
10657,Roberto Cabañas,3,256.0,0,0,6,0,6,Paraguay
10658,Roberto Carlos,1,147.0,0,0,2,1,3,Brazil
10659,Roberto Castillo,1,11.0,0,0,1,0,1,Peru
10660,Roberto Challe,1,118.0,0,0,0,2,2,Bolivia
10661,Roberto Chen,0,90.0,0,0,0,1,1,Honduras
10662,Roberto Cherro,3,94.0,0,0,4,0,4,Argentina
10663,Roberto Colautti,0,231.0,0,0,3,3,6,Estonia
10664,Roberto Di Matteo,0,24.0,0,0,1,0,1,Italy
10665,Roberto Dinamite,4,380.0,0,2,8,3,11,Brazil
10666,Roberto Donadoni,0,24.0,0,0,4,0,4,Italy
10667,Roberto Drago,5,292.0,0,0,0,5,5,Paraguay
10668,Roberto Emílio da Cunha,3,137.0,0,0,3,0,3,Brazil
10669,Roberto Fernández,0,90.0,0,0,1,0,1,Bolivia
10670,Roberto Fernández Bonillo,0,30.0,0,0,0,1,1,Czechoslovakia
10671,Roberto Figueroa,3,155.0,0,0,0,3,3,Bolivia
10672,Roberto Firmino,2,527.0,0,0,9,0,9,Brazil
10673,Roberto Gayón,1,75.0,0,0,0,1,1,Argentina
10674,Roberto Guadalupe Martínez,0,14.0,0,0,1,0,1,El Salvador
10675,Roberto Gámez,2,131.0,0,0,1,1,2,Colombia
10676,Roberto Holsen,4,210.0,0,0,3,1,4,Peru
10677,Roberto Jonas,1,42.0,0,0,1,0,1,Andorra
10678,Roberto Juan Martínez,0,119.0,0,0,1,1,2,Spain
10679,Roberto Kettlun,3,210.0,0,0,3,0,3,Palestine
10680,Roberto Linares,0,133.0,0,0,3,1,4,Cuba
10681,Roberto Luco,1,39.0,0,0,1,0,1,Chile
10682,Roberto López Ufarte,0,65.0,0,1,1,0,1,Spain
10683,Roberto Mancini,0,258.0,0,0,2,2,4,Germany
10684,Roberto Mosquera,0,71.0,0,0,1,0,1,Peru
10685,Roberto Nurse,0,55.0,0,0,0,1,1,United States
10686,Roberto Orlando Affonso Júnior,0,83.0,0,0,1,0,1,Hong Kong
10687,Roberto Osvaldo Díaz,0,71.0,0,0,1,0,1,Argentina
10688,Roberto Palacios,4,837.0,0,0,8,6,14,Argentina
10689,Roberto Perfumo,1,35.0,1,0,0,1,1,Argentina
10690,Roberto Porta,6,582.0,0,0,5,7,12,Ecuador
10691,Roberto Rivellino,0,85.0,0,0,1,0,1,Brazil
10692,Roberto Soldado,1,118.0,0,0,1,1,2,Georgia
10693,Roberto Troncoso,0,55.0,1,0,1,0,1,Uruguay
10694,Roberto Zárate,3,203.0,0,0,5,0,5,Argentina
10695,Roberts Savaļnieks,0,35.0,0,0,0,1,1,Turkey
10696,Roberts Uldriķis,0,113.0,0,0,0,2,2,Turkey
10697,Robin Betancourth,1,147.0,0,0,1,1,2,British Virgin Islands
10698,Robin Gosens,0,60.0,0,0,1,0,1,Germany
10699,Robin Lod,0,90.0,0,0,0,2,2,Iceland
10700,Robin Ngalande,0,47.0,0,0,1,0,1,Malawi
10701,Robin Quaison,0,469.0,0,0,4,4,8,Sweden
10702,Robin Singh,0,10.0,0,0,1,0,1,India
10703,Robin van Persie,8,1915.0,1,4,23,13,36,Finland
10704,Robinho,12,764.0,0,2,10,8,18,Brazil
10705,Robiul Hasan,0,72.0,0,0,0,1,1,Laos
10706,Roby Young,1,70.0,0,0,0,1,1,Hong Kong
10707,Rocky Putiray,0,126.0,0,0,3,0,3,Indonesia
10708,Rocky Siberie,1,256.0,0,0,3,4,7,Curaçao
10709,Roda Antar,2,612.0,0,0,8,4,12,Lebanon
10710,Roderick Briffa,0,38.0,0,0,0,1,1,Czech Republic
10711,Roderick Reid,2,110.0,0,0,2,1,3,Mexico
10712,Rodger Gray,0,74.0,0,0,0,1,1,Vanuatu
10713,Rodion Cămătaru,0,359.0,0,0,3,5,8,Romania
10714,Rodney Jack,0,244.0,0,0,8,2,10,Saint Vincent and the Grenadines
10715,Rodney Wallace,1,79.0,0,0,1,0,1,Costa Rica
10716,Rodolfo Bodipo,0,83.0,0,1,0,1,1,Sierra Leone
10717,Rodolfo Carvajal,0,70.0,0,0,1,0,1,Venezuela
10718,Rodolfo Dubó,0,34.0,0,0,2,0,2,Chile
10719,Rodolfo Herrera González,0,144.0,0,0,3,0,3,Costa Rica
10720,Rodolfo Micheli,7,355.0,0,1,7,1,8,Argentina
10721,Rodolfo Pizarro,1,4.0,0,0,1,0,1,Mexico
10722,Rodolfo Zelaya,8,660.0,0,3,12,3,15,El Salvador
10723,Rodolph Austin,1,172.0,0,1,3,0,3,Jamaica
10724,Rodrigo,2,185.0,0,0,4,1,5,Spain
10725,Rodrigo Barrera,0,23.0,0,0,1,0,1,Chile
10726,Rodrigo Bentancur,0,1.0,0,0,1,0,1,Uruguay
10727,Rodrigo Cordero,0,90.0,0,0,1,0,1,Costa Rica
10728,Rodrigo De Paul,1,84.0,0,0,2,0,2,Argentina
10729,Rodrigo Lemos,1,61.0,0,1,1,0,1,Uruguay
10730,Rodrigo Meléndez,0,21.0,0,0,0,1,1,Uruguay
10731,Rodrigo Millar,1,100.0,0,0,2,0,2,Chile
10732,Rodrigo Palacio,0,137.0,0,0,2,0,2,Argentina
10733,Rodrigo Ramallo,0,85.0,0,0,3,0,3,Bolivia
10734,Rodrigo Tello,0,29.0,0,0,0,1,1,Argentina
10735,Rodrygo,0,88.0,0,0,1,0,1,Brazil
10736,Rogelio Delgado,0,46.0,0,0,1,0,1,Paraguay
10737,Rogelio Farias,1,58.0,0,0,1,0,1,Chile
10738,Rogelio Funes Mori,3,186.0,0,0,2,2,4,Guatemala
10739,Roger Beck,0,20.0,0,0,0,1,1,North Macedonia
10740,Roger Claessen,0,185.0,0,0,1,2,3,Switzerland
10741,Roger Espinoza,1,25.0,0,0,1,0,1,Honduras
10742,Roger Guerreiro,0,30.0,0,0,0,1,1,Austria
10743,Roger Hunt,0,228.0,0,0,3,1,4,England
10744,Roger Ljung,1,93.0,0,0,1,1,2,Sweden
10745,Roger Lukaku,1,162.0,0,1,2,1,3,DR Congo
10746,Roger Mandin,1,90.0,0,0,1,0,1,New Caledonia
10747,Roger Marche,0,85.0,1,0,1,0,1,Greece
10748,Roger Martínez,1,140.0,0,0,0,2,2,Argentina
10749,Roger Milla,11,996.0,0,1,15,5,20,Congo
10750,Roger Nilsen,0,113.0,0,0,2,0,2,Norway
10751,Roger Piantoni,3,486.0,0,0,6,2,8,Luxembourg
10752,Roger Proverbs,0,63.0,0,0,0,1,1,Dominica
10753,Roger Rojas,0,88.0,0,0,1,0,1,Honduras
10754,Roger Suárez,0,162.0,0,0,3,0,3,Bolivia
10755,Roger Van Gool,0,56.0,0,0,2,0,2,Belgium
10756,Roger Vonlanthen,0,92.0,0,0,1,1,2,Switzerland
10757,Roguy Méyé,1,226.0,0,0,2,2,4,Gabon
10758,Roh Sang-Rae,0,18.0,0,0,0,1,1,Thailand
10759,Rohan Ince,1,60.0,0,0,1,0,1,Montserrat
10760,Rohan Lennon,0,68.0,0,0,0,1,1,Bahamas
10761,Rohann Simons,0,83.0,0,0,1,0,1,Bermuda
10762,Roihau Degage,1,86.0,0,0,1,0,1,Tahiti
10763,Rok Kronaveter,0,74.0,0,0,1,0,1,Slovenia
10764,Rokonuzzaman Kanchan,1,85.0,0,0,0,1,1,Mongolia
10765,Roland Alberg,1,74.0,0,0,0,1,1,Aruba
10766,Roland Citherlet,0,28.0,0,0,1,0,1,Switzerland
10767,Roland Ducke,0,26.0,0,0,0,1,1,Hungary
10768,Roland Grip,0,49.0,0,0,0,1,1,Norway
10769,Roland Hattenberger,1,82.0,0,0,1,1,2,Austria
10770,Roland Juhász,0,184.0,0,0,2,1,3,Hungary
10771,Roland Kirchler,0,53.0,0,0,1,0,1,Austria
10772,Roland Kollmann,0,115.0,0,0,2,0,2,Austria
10773,Roland Linz,0,231.0,0,0,1,2,3,Poland
10774,Roland Sallai,0,101.0,0,1,1,2,3,Hungary
10775,Roland Sandberg,2,371.0,0,0,4,4,8,Sweden
10776,Roland Ugrai,0,89.0,0,0,0,1,1,Switzerland
10777,Roland de Marigny,1,90.0,0,0,0,1,1,Fiji
10778,Rolandas Baravykas,0,55.0,0,0,1,0,1,Lithuania
10779,Rolando Blackburn,2,232.0,0,0,4,4,8,Panama
10780,Rolando Fonseca,5,828.0,0,1,9,7,16,Costa Rica
10781,Rolando Vargas,0,55.0,0,0,0,1,1,Argentina
10782,Rolf Blättler,0,207.0,0,0,6,0,6,Switzerland
10783,Rolf Feltscher,0,54.0,1,0,1,0,1,Argentina
10784,Rolf Wüthrich,0,74.0,0,0,1,1,2,Switzerland
10785,Rolf-Christel Guié-Mien,0,67.0,0,0,0,1,1,Sierra Leone
10786,Roly Paniagua,0,85.0,0,0,1,0,1,Bolivia
10787,Romain Michaux,0,73.0,0,0,1,0,1,Luxembourg
10788,Romain Saïss,2,94.0,0,0,1,1,2,Morocco
10789,Romain Schreiner,0,55.0,0,0,1,0,1,Luxembourg
10790,Romaine Sawyers,0,138.0,0,0,2,0,2,Saint Kitts and Nevis
10791,Roman Bezjak,0,190.0,0,0,3,0,3,Slovenia
10792,Roman Bezus,0,218.0,0,0,1,2,3,Montenegro
10793,Roman Eremenko,0,156.0,0,1,0,2,2,Georgia
10794,Roman Hubník,0,69.0,0,0,1,0,1,Czech Republic
10795,Roman Kosecki,0,292.0,0,0,3,1,4,Poland
10796,Roman Lentner,0,52.0,0,0,1,0,1,Poland
10797,Roman Ogaza,0,185.0,0,1,3,0,3,Poland
10798,Roman Pavlyuchenko,4,872.0,0,5,13,3,16,Russia
10799,Roman Shirokov,1,252.0,0,2,3,2,5,Republic of Ireland
10800,Roman Szewczyk,0,32.0,0,0,1,0,1,Poland
10801,Roman Týce,0,40.0,0,0,0,1,1,Denmark
10802,Roman Uzdenov,0,44.0,0,0,1,0,1,Kazakhstan
10803,Roman Wallner,0,142.0,0,1,2,0,2,Austria
10804,Roman Wójcicki,0,142.0,1,0,0,2,2,Poland
10805,Roman Yaremchuk,1,320.0,0,0,5,5,10,Ukraine
10806,Roman Zozulya,0,107.0,0,0,1,1,2,Poland
10807,Romar Frank,1,76.0,0,0,0,1,1,Panama
10808,Romaric,1,93.0,0,0,1,2,3,Ivory Coast
10809,Romario Ibarra,0,83.0,0,0,1,1,2,Chile
10810,Romario Williams,2,108.0,0,0,1,1,2,Curaçao
10811,Romell Quioto,3,458.0,0,0,6,4,10,Honduras
10812,Romelu Lukaku,9,1936.0,0,3,23,13,36,Croatia
10813,Romeo Benetti,2,208.0,0,0,1,2,3,Italy
10814,Romeo Castelen,0,3.0,0,0,1,0,1,Netherlands
10815,Romeo Kambou,0,117.0,0,0,2,0,2,Burkina Faso
10816,Romeu Evangelista,0,2.0,0,0,0,1,1,Venezuela
10817,Romeu Pellicciari,3,156.0,0,0,3,0,3,Brazil
10818,Romik Khachatryan,0,73.0,0,0,1,0,1,Armenia
10819,Romulo Gómez,1,100.0,2,0,1,2,3,Ecuador
10820,Román Torres,2,341.0,1,0,6,0,6,Nicaragua
10821,Romário,17,1850.0,0,4,23,10,33,Brazil
10822,Ron Davies,1,213.0,0,1,2,2,4,Russia
10823,Ron Flowers,2,217.0,0,3,2,2,4,Portugal
10824,Ronald Cerritos,2,344.0,0,0,4,2,6,Trinidad and Tobago
10825,Ronald García Nacho,0,106.0,0,0,2,0,2,Bolivia
10826,Ronald Hernández,1,90.0,0,0,1,0,1,Venezuela
10827,Ronald Koeman,2,471.0,0,4,4,4,8,Netherlands
10828,Ronald Kreer,0,115.0,0,0,2,0,2,German DR
10829,Ronald Leaky,0,21.0,0,0,1,0,1,Honduras
10830,Ronald Raldes,1,89.0,1,0,1,1,2,Ecuador
10831,Ronald Rivero,0,33.0,1,0,0,1,1,Bolivia
10832,Ronald Spelbos,0,40.0,0,0,1,0,1,Netherlands
10833,Ronald Vargas,0,121.0,0,0,1,1,2,Uruguay
10834,Ronald Worm,0,32.0,0,0,2,0,2,Germany
10835,Ronald de Boer,3,669.0,0,1,6,5,11,Netherlands
10836,Ronaldinho,11,799.0,0,5,13,4,17,Brazil
10837,Ronaldo,28,1800.0,0,5,29,10,39,Brazil
10838,Ronaldo Rodrigues de Jesus,1,73.0,0,0,1,0,1,Brazil
10839,Ronan Carolino Falcão,0,47.0,0,0,1,0,1,Equatorial Guinea
10840,Ronen Harazi,1,474.0,0,0,7,3,10,Bulgaria
10841,Rong Zhixing,2,90.0,0,0,3,0,3,China PR
10842,Roni Porokara,0,78.0,0,0,2,0,2,Finland
10843,Ronnie Allen,0,68.0,0,0,0,1,1,Scotland
10844,Ronnie McKinnon,0,117.0,1,0,2,0,2,Scotland
10845,Ronnie Rees,0,93.0,0,0,2,0,2,Wales
10846,Ronnie Whelan,1,144.0,0,0,2,1,3,Luxembourg
10847,Ronny Johnsen,0,106.0,0,0,1,1,2,Poland
10848,Ronny Pattinasarany,0,4.0,0,0,0,1,1,Singapore
10849,Ronny Rosenthal,1,246.0,0,0,3,4,7,Israel
10850,Ronny Wabia,2,165.0,0,0,3,1,4,Indonesia
10851,Rony Martínez,1,4.0,0,0,0,1,1,Haiti
10852,Rony Morales,0,54.0,0,0,0,1,1,Trinidad and Tobago
10853,Roody Lormera,1,10.0,0,1,0,1,1,Turks and Caicos Islands
10854,Roosevelt Desir,0,69.0,0,0,0,1,1,Dominica
10855,Roque Júnior,0,90.0,0,0,1,0,1,Brazil
10856,Roque Santa Cruz,5,1071.0,0,0,17,4,21,Paraguay
10857,Rory Fallon,2,188.0,0,0,3,1,4,New Zealand
10858,Rosdee Sulong,0,16.0,0,0,1,0,1,Malaysia
10859,Rosdi Talib,1,48.0,0,0,1,1,2,Qatar
10860,Rosemond Pierre,1,84.0,0,0,0,1,1,Cuba
10861,Roshan Pereta,2,135.0,0,0,0,2,2,Philippines
10862,Ross Barkley,0,225.0,0,0,0,6,6,San Marino
10863,Ross McCormack,0,39.0,0,0,1,0,1,Scotland
10864,Rostislav Vojáček,0,34.0,0,0,1,0,1,Czechoslovakia
10865,Rotson Kilambe,1,136.0,0,0,1,2,3,Zambia
10866,Roudolphe Douala,0,20.0,0,0,1,0,1,Cameroon
10867,Rouzbeh Cheshmi,1,90.0,0,0,0,1,1,Wales
10868,Rowan Liburd,0,53.0,0,1,0,1,1,Bahamas
10869,Roxey Fer,0,3.0,0,0,1,0,1,Suriname
10870,Roy Bentley,0,64.0,0,0,0,1,1,Scotland
10871,Roy Chipolina,1,84.0,1,0,1,1,2,Gibraltar
10872,Roy Contout,1,69.0,0,0,1,0,1,French Guiana
10873,Roy Karang,0,89.0,0,0,1,0,1,Papua New Guinea
10874,Roy Kayara,4,161.0,0,0,4,2,6,Vanuatu
10875,Roy Keane,0,456.0,0,0,4,5,9,Northern Ireland
10876,Roy Krishna,3,406.0,0,2,4,2,6,Fiji
10877,Roy Lassiter,0,184.0,0,0,1,2,3,United States
10878,Roy Makaay,1,114.0,0,0,1,1,2,Austria
10879,Roy Miller,1,58.0,0,0,2,0,2,Costa Rica
10880,Roy Myers,3,154.0,0,0,1,2,3,Canada
10881,Roy Myrie,0,264.0,0,0,1,3,4,Costa Rica
10882,Roy Sáenz,0,89.0,0,0,1,0,1,Costa Rica
10883,Roy Vanenburg,0,180.0,0,0,2,0,2,Suriname
10884,Roy Vernon,0,250.0,0,0,5,0,5,Wales
10885,Roy Wegerle,0,226.0,0,0,1,2,3,Canada
10886,Ruben Mendoza,0,73.0,0,0,1,1,2,Haiti
10887,Ruben Schaken,0,134.0,0,0,2,0,2,Netherlands
10888,Ruben Vargas,0,107.0,0,0,1,1,2,Gibraltar
10889,Ruberth Morán,1,633.0,0,0,9,2,11,Venezuela
10890,Rubilio Castillo,1,155.0,0,0,1,1,2,Jamaica
10891,Rubin Okotie,0,97.0,0,0,2,0,2,Austria
10892,Rubén Aveiro,2,161.0,0,0,0,2,2,Argentina
10893,Rubén Ayala,1,318.0,0,1,5,1,6,Argentina
10894,Rubén Baraja,0,135.0,0,0,2,1,3,Austria
10895,Rubén Cano,0,219.0,0,0,2,1,3,Spain
10896,Rubén Darío Bustos,0,144.0,0,0,2,0,2,Colombia
10897,Rubén Darío Hernández,0,67.0,0,0,1,0,1,Colombia
10898,Rubén Espinoza,0,51.0,0,0,1,0,1,Chile
10899,Rubén Fernández,3,206.0,0,0,0,4,4,Chile
10900,Rubén Guevara,0,112.0,0,0,1,1,2,Belize
10901,Rubén Héctor Sosa,0,391.0,0,0,5,2,7,Argentina
10902,Rubén Jiménez,0,140.0,0,0,2,2,4,Guatemala
10903,Rubén Jiménez Rodríguez,0,29.0,0,0,1,1,2,Guatemala
10904,Rubén Marcos,5,250.0,0,1,6,1,7,Chile
10905,Rubén Paz,1,192.0,0,0,2,1,3,Uruguay
10906,Rubén Sosa,4,499.0,0,0,5,6,11,Uruguay
10907,Rubén Toribio Díaz,1,83.0,0,0,0,1,1,Italy
10908,Rubén de la Red,1,61.0,0,0,0,1,1,Greece
10909,Rubén Óscar Valdez,0,126.0,0,0,0,2,2,Greece
10910,Rudel Calero,0,79.0,0,0,1,0,1,Nicaragua
10911,Rudi Elsener,0,75.0,0,0,1,0,1,Switzerland
10912,Rudi Flögel,0,102.0,0,0,1,1,2,Republic of Ireland
10913,Rudi Istenič,0,15.0,1,0,1,0,1,Norway
10914,Rudi Smidts,0,27.0,0,0,1,0,1,Belgium
10915,Rudi Vata,0,158.0,0,0,0,2,2,Moldova
10916,Rudi Völler,10,1060.0,0,0,17,9,26,Albania
10917,Rudinilson Silva,1,12.0,1,0,0,1,1,Guinea-Bissau
10918,Rudis Corrales,1,374.0,0,0,7,1,8,El Salvador
10919,Rudolf Belin,0,2.0,0,0,1,0,1,Yugoslavia
10920,Rudolf Bester,0,138.0,0,0,2,2,4,Namibia
10921,Rudolf Brunnenmeier,0,194.0,0,0,1,2,3,Germany
10922,Rudolf Kučera,0,90.0,0,0,0,1,1,German DR
10923,Rudolf Noack,1,62.0,0,0,0,1,1,Czechoslovakia
10924,Rudolf Pichler,0,65.0,0,0,0,1,1,France
10925,Rudolf Viertl,0,62.0,0,0,1,0,1,Austria
10926,Rudolph Smith,0,8.0,1,0,0,1,1,Bermuda
10927,Rudy Barrientos,0,12.0,0,0,1,0,1,Guatemala
10928,Rudy Bhebey,0,76.0,0,0,0,2,2,Liberia
10929,Rudy Cardozo,0,66.0,0,0,1,1,2,Uruguay
10930,Rudy Gestede,0,57.0,0,0,1,1,2,Algeria
10931,Rudy Ramírez,1,98.0,0,0,0,2,2,Trinidad and Tobago
10932,Rufat Dadashov,0,58.0,0,0,1,0,1,Azerbaijan
10933,Rufino Gama,0,72.0,0,0,0,1,1,Malaysia
10934,Ruggiero Rizzitelli,0,83.0,0,0,1,0,1,Italy
10935,Rui Barros,1,147.0,0,0,2,1,3,Luxembourg
10936,Rui Campos,1,20.0,0,0,1,0,1,Brazil
10937,Rui Costa,1,1002.0,0,4,8,9,17,Portugal
10938,Rui Jordão,0,479.0,0,1,7,4,11,Portugal
10939,Rui Jorge,1,45.0,0,0,0,1,1,Andorra
10940,Rui Rodrigues,0,89.0,0,0,2,1,3,Portugal
10941,Rui da Gracia,0,14.0,0,0,1,0,1,Equatorial Guinea
10942,Rui Águas,2,468.0,0,0,3,6,9,Switzerland
10943,Rumen Hristov,0,78.0,0,0,1,0,1,Bulgaria
10944,Rune Bratseth,0,119.0,0,0,2,0,2,Norway
10945,Rune Börjesson,0,142.0,0,0,3,0,3,Sweden
10946,Rune Ottesen,0,34.0,0,0,1,0,1,Norway
10947,Rupak Ray Sharma,0,35.0,1,0,0,1,1,Nepal
10948,Rupena Raumati,0,31.0,1,0,1,0,1,Australia
10949,Rupert Ryan,2,99.0,0,0,2,0,2,New Zealand
10950,Ruphin Menakely,0,58.0,0,0,1,0,1,Madagascar
10951,Rusi Gochev,0,93.0,0,0,1,1,2,Bulgaria
10952,Ruslan Abishov,0,152.0,0,0,2,1,3,Belgium
10953,Ruslan Baltiyev,1,492.0,0,2,4,4,8,Kazakhstan
10954,Ruslan Barburoş,0,72.0,0,0,0,1,1,North Macedonia
10955,Ruslan Koryan,0,95.0,0,0,1,1,2,Montenegro
10956,Ruslan Malinovskyi,0,149.0,0,0,2,1,3,Lithuania
10957,Ruslan Mingazow,0,45.0,0,0,1,0,1,Turkmenistan
10958,Ruslan Qurbanov,0,45.0,0,0,0,1,1,San Marino
10959,Ruslan Rotan,1,367.0,0,0,3,2,5,Kazakhstan
10960,Ruslan Valiullin,0,164.0,0,0,2,0,2,Kazakhstan
10961,Rusli Ramang,0,207.0,0,0,2,2,4,Indonesia
10962,Russel Mwafulirwa,2,142.0,0,0,3,1,4,Malawi
10963,Russell Latapy,3,641.0,0,0,9,3,12,Barbados
10964,Russell Teibert,0,64.0,0,1,0,1,1,Dominica
10965,Rustam Khojaev,3,135.0,0,0,3,0,3,Tajikistan
10966,Rustam Usmonov,1,87.0,0,0,1,0,1,Tajikistan
10967,Rutger Backe,0,24.0,0,0,1,0,1,Sweden
10968,Ruud Geels,0,634.0,0,2,6,4,10,Netherlands
10969,Ruud Gullit,2,677.0,0,0,7,8,15,Netherlands
10970,Ruud Krol,2,198.0,1,0,4,0,4,Bulgaria
10971,Ruud Schoonhoven,0,180.0,0,0,2,0,2,Suriname
10972,Ruud van Nistelrooy,7,1656.0,0,1,21,8,29,Netherlands
10973,Ruy Ramos,1,31.0,0,0,0,1,1,Sri Lanka
10974,Ryan Babel,0,148.0,0,0,0,3,3,Romania
10975,Ryan Bertrand,0,86.0,0,0,0,1,1,Malta
10976,Ryan Camilleri,0,52.0,1,0,0,1,1,Malta
10977,Ryan Christie,0,64.0,0,0,0,2,2,Cyprus
10978,Ryan Donk,0,38.0,0,1,1,0,1,Suriname
10979,Ryan Fraser,0,126.0,0,0,1,1,2,Israel
10980,Ryan Giggs,0,498.0,0,0,7,4,11,Wales
10981,Ryan Johnson,2,121.0,0,0,2,1,3,Jamaica
10982,Ryan Malmberg,0,84.0,0,0,0,1,1,Dominican Republic
10983,Ryan Mendes,0,90.0,0,0,1,0,1,Cape Verde
10984,Ryan Mmaee,0,114.0,0,1,4,0,4,Morocco
10985,Ryan Nelsen,2,331.0,0,0,5,0,5,New Zealand
10986,Ryan Robbins,0,73.0,0,0,0,1,1,Turks and Caicos Islands
10987,Ryan Simpson,0,90.0,0,0,1,0,1,Belize
10988,Ryan Telfer,1,44.0,0,0,1,0,1,Trinidad and Tobago
10989,Ryan Thomas,0,151.0,0,0,3,0,3,New Zealand
10990,Ryang Yong-gi,1,12.0,0,0,1,0,1,North Korea
10991,Ryoichi Maeda,3,282.0,0,0,4,3,7,Saudi Arabia
10992,Ryszard Grzegorczyk,0,134.0,0,0,1,1,2,Poland
10993,Ryszard Tarasiewicz,0,342.0,0,0,3,2,5,Poland
10994,Ryu Song-Gun,4,347.0,0,0,3,3,6,North Korea
10995,Ryuzo Morioka,1,90.0,1,0,1,0,1,Saudi Arabia
10996,Réginal Goreux,0,64.0,0,0,0,1,1,United States Virgin Islands
10997,Régis Manon,0,33.0,0,0,1,0,1,Gabon
10998,Rémy Ebanega,0,57.0,0,0,1,0,1,Gabon
10999,Ríkharður Daðason,0,160.0,1,0,5,0,5,Iceland
11000,Ríkharður Jónsson,0,205.0,0,0,1,3,4,Belgium
11001,Róaldur Jakobsen,0,11.0,0,0,0,1,1,Hungary
11002,Róbert Boženík,0,139.0,0,0,1,3,4,Hungary
11003,Róbert Feczesin,0,34.0,0,0,1,0,1,Hungary
11004,Róbert Mak,0,235.0,0,0,3,3,6,Ukraine
11005,Róbert Tomaschek,0,165.0,0,0,0,3,3,Liechtenstein
11006,Róbert Vittek,4,750.0,0,1,6,8,14,Liechtenstein
11007,Róger Flores,1,75.0,0,0,0,1,1,Sweden
11008,Róger Gómez,1,14.0,0,0,1,0,1,Costa Rica
11009,Rógvi Baldvinsson,0,213.0,1,0,2,2,4,Faroe Islands
11010,Rógvi Jacobsen,0,548.0,0,0,3,5,8,Iceland
11011,Rómulo Otero,0,231.0,0,1,4,1,5,Venezuela
11012,Rónald González Brenes,2,146.0,1,0,1,2,3,Czechoslovakia
11013,Rónald Gómez,5,773.0,0,0,8,6,14,Trinidad and Tobago
11014,Rónald Matarrita,0,174.0,0,0,1,1,2,Costa Rica
11015,Rôni,1,109.0,0,0,1,1,2,Brazil
11016,Rúben Bareño,0,31.0,0,0,0,1,1,Ecuador
11017,Rúben Dias,0,35.0,1,0,1,0,1,Germany
11018,Rúnar Kristinsson,0,46.0,0,0,1,0,1,Iceland
11019,Rúnar Már Sigurjónsson,0,90.0,0,1,0,1,1,Liechtenstein
11020,Rúrik Gíslason,0,90.0,0,0,0,1,1,Latvia
11021,Rüdiger Abramczik,1,3.0,0,0,1,0,1,Germany
11022,Rüdiger Schnuphase,0,116.0,0,2,3,1,4,German DR
11023,Răzvan Cociş,0,59.0,0,0,0,1,1,Faroe Islands
11024,Răzvan Marin,0,12.0,0,0,0,1,1,Armenia
11025,Rıdvan Dilmen,0,152.0,0,0,2,1,3,German DR
11026,Rıza Çalımbay,0,13.0,0,1,1,0,1,Turkey
11027,Saad Abdul-Amir,0,145.0,0,1,0,2,2,Japan
11028,Saad Al-Harthi,0,351.0,0,0,5,1,6,Saudi Arabia
11029,Saad Al-Houti,0,27.0,0,0,2,0,2,Kuwait
11030,Saad Al-Mukhaini,0,52.0,0,0,1,0,1,Oman
11031,Saad Al-Shammari,0,174.0,0,0,1,1,2,Laos
11032,Saad Attiya,0,75.0,0,0,0,1,1,Taiwan
11033,Saad Bakheet Mubarak,0,80.0,0,0,1,0,1,United Arab Emirates
11034,Saad Bguir,0,84.0,0,0,1,0,1,Tunisia
11035,Saad Dahane,0,126.0,0,2,2,0,2,Morocco
11036,Saad Qais,6,408.0,0,0,3,3,6,Yemen
11037,Saad Uddin,0,42.0,0,0,0,1,1,India
11038,Saado Al-Suwaiti,1,57.0,0,0,1,0,1,Saudi Arabia
11039,Saba Lobzhanidze,0,25.0,0,0,0,1,1,Denmark
11040,Sabah Abdul-Jalil,1,46.0,0,0,1,0,1,Iraq
11041,Sabah Bizi,0,87.0,0,0,1,0,1,Albania
11042,Sabah Hatim,4,126.0,0,0,4,0,4,Iraq
11043,Sabah Jeayer,0,170.0,0,0,2,2,4,Lebanon
11044,Sabbir,1,100.0,0,0,2,0,2,Bangladesh
11045,Sabelo Ndzinisa,0,61.0,0,0,0,1,1,Djibouti
11046,Saber Ben Frej,0,20.0,0,0,1,0,1,Tunisia
11047,Saber Khelifa,1,55.0,0,0,0,2,2,Ghana
11048,Sabri Sarıoğlu,0,39.0,0,0,0,1,1,Bosnia and Herzegovina
11049,Sacha Kljestan,0,122.0,0,0,1,1,2,Saint Vincent and the Grenadines
11050,Sacha Schneider,0,49.0,0,0,1,0,1,Luxembourg
11051,Sadio Diallo,2,120.0,0,1,2,2,4,Botswana
11052,Sadio Mané,10,955.0,0,4,7,9,16,Senegal
11053,Sadiq Saadoun,0,58.0,1,0,2,0,2,Iraq
11054,Saeed Al Kass,2,407.0,0,1,5,2,7,United Arab Emirates
11055,Saeed Al-Owairan,6,427.0,0,0,7,4,11,Saudi Arabia
11056,Saeed Murjan,0,96.0,0,0,0,2,2,Nepal
11057,Saeed Shaaban Al Busaidy,1,88.0,0,0,1,1,2,Oman
11058,Saeid Daghighi,0,86.0,0,0,1,0,1,Iran
11059,Saeid Ezatolahi,0,64.0,0,0,1,0,1,Iran
11060,Safaa Hadi,1,90.0,0,0,1,0,1,Iraq
11061,Safar Iranpak,2,64.0,0,0,2,0,2,Iran
11062,Safawi Rasid,1,259.0,0,1,4,1,5,Malaysia
11063,Safee Sali,0,129.0,0,0,1,2,3,Singapore
11064,Safet Sušić,1,382.0,0,0,5,4,9,Romania
11065,Saffet Akyüz,0,8.0,0,0,1,0,1,Turkey
11066,Saffet Sancaklı,0,37.0,0,0,2,0,2,Turkey
11067,Safuwan Baharudin,0,183.0,0,1,2,2,4,Cambodia
11068,Safwan Habaib,2,52.0,0,0,2,0,2,Palestine
11069,Sahib Abbas,0,160.0,0,0,2,0,2,Iraq
11070,Saibi Eklou Dodji,0,79.0,0,0,1,0,1,Togo
11071,Said Bayazid,0,522.0,0,0,11,0,11,Syria
11072,Said Brahimi,0,49.0,0,0,1,0,1,France
11073,Said Riyad,0,90.0,1,0,1,0,1,Egypt
11074,Said Rokbi,1,89.0,0,0,1,0,1,Morocco
11075,Saif Eldin Ali Idris Farah,1,76.0,0,0,0,1,1,Chad
11076,Saif Mohammed Al Bishr,0,90.0,0,0,0,1,1,Kuwait
11077,Saimon Msuva,1,158.0,0,0,0,5,5,Kenya
11078,Saio Ernest Mokili,1,42.0,0,0,1,0,1,DR Congo
11079,Sairusi Nalaubu,2,100.0,0,0,0,2,2,New Caledonia
11080,Sakdarin,0,90.0,0,0,1,0,1,Thailand
11081,Salaah Al-Yahyaei,0,63.0,0,1,1,0,1,Oman
11082,Saladin Said,1,290.0,0,0,2,3,5,Mauritania
11083,Salah Al-Hasawi,2,287.0,0,0,3,2,5,Kuwait
11084,Salah Assad,5,220.0,0,1,5,0,5,Algeria
11085,Salah Ibrahim,0,70.0,0,0,0,1,1,Zambia
11086,Salah Obeid,1,33.0,0,0,1,0,1,Iraq
11087,Salaheddine Bassir,3,352.0,0,0,1,6,7,Ghana
11088,Salam Kouko,0,65.0,0,0,1,0,1,Togo
11089,Saleh Ahmed Farhan,1,57.0,0,0,0,1,1,Iran
11090,Saleh Al-Mutlaq,1,20.0,0,0,0,1,1,Syria
11091,Saleh Al-Shehri,2,515.0,0,1,4,5,9,Thailand
11092,Saleh Eid Al-Mehaizaa,0,18.0,0,0,0,1,1,Iraq
11093,Saleh Khalifa Al-Dosari,1,66.0,0,0,0,1,1,Syria
11094,Saleh Obaid,0,58.0,0,0,1,0,1,United Arab Emirates
11095,Saleh Rabiah Ben,1,62.0,0,0,1,0,1,Yemen
11096,Saleh Selim,1,57.0,0,0,1,0,1,Egypt
11097,Salem Al-Ajalin,0,43.0,0,0,1,0,1,Jordan
11098,Salem Al-Dawsari,5,778.0,0,3,8,5,13,Australia
11099,Salem Ould Ely,0,85.0,0,0,1,0,1,Mauritania
11100,Salesh Kumar,0,7.0,0,0,1,0,1,Fiji
11101,Salif Coulibaly,0,31.0,1,0,1,0,1,Ivory Coast
11102,Salif Diao,3,233.0,0,0,1,3,4,Senegal
11103,Salif Keita,1,86.0,0,0,0,1,1,Burkina Faso
11104,Salif Kéïta,1,22.0,0,0,1,0,1,Central African Republic
11105,Salih Sadir,0,47.0,0,0,0,2,2,Taiwan
11106,Salim Moin,0,76.0,0,0,2,0,2,Singapore
11107,Salim Tuama,0,81.0,0,0,0,1,1,Luxembourg
11108,Saliou Ciss,0,4.0,1,0,1,0,1,Egypt
11109,Salissou Ali,0,69.0,0,0,1,0,1,Togo
11110,Salman Al-Faraj,1,241.0,0,2,4,2,6,Saudi Arabia
11111,Salman Al-Moasher,0,90.0,0,0,0,1,1,Thailand
11112,Salman Ghuloom,0,139.0,0,0,1,1,2,Trinidad and Tobago
11113,Salman Isa,1,201.0,0,0,3,1,4,Bahrain
11114,Salomon Kalou,7,673.0,0,1,9,4,13,Nigeria
11115,Salomon Olembé,1,221.0,0,0,2,2,4,Cameroon
11116,Salomón Rondón,4,683.0,0,0,6,8,14,Paraguay
11117,Salvador Cabañas,3,484.0,0,1,4,6,10,Ecuador
11118,Salvador Kaçaj,0,41.0,0,0,1,0,1,Albania
11119,Salvador Reyes Monteón,0,538.0,0,0,8,3,11,Mexico
11120,Salvador Soto,0,78.0,0,0,0,1,1,Haiti
11121,Salvador Villalba,1,89.0,0,0,0,1,1,Argentina
11122,Salvatore Bagni,0,4.0,0,0,1,0,1,Italy
11123,Salvatore Schillaci,0,370.0,0,1,6,1,7,Italy
11124,Sam Adekugbe,0,90.0,0,0,1,0,1,Canada
11125,Sam El Nasa,0,185.0,1,0,3,1,4,Indonesia
11126,Sam Garba,0,19.0,0,0,0,1,1,Ghana
11127,Sam Johnson,0,88.0,0,0,1,0,1,Liberia
11128,Sam Ojebode,2,174.0,0,2,2,1,3,Nigeria
11129,Sam Tabu,0,57.0,0,0,1,0,1,Kenya
11130,Sam Vines,0,8.0,0,0,1,0,1,United States
11131,Sam Vokes,1,207.0,0,0,3,0,3,Wales
11132,Samad Marfavi,0,81.0,0,0,1,0,1,Iran
11133,Saman Ghoddos,1,78.0,0,0,1,0,1,Iran
11134,Samat Smakov,0,164.0,0,2,1,1,2,Kazakhstan
11135,Samba Sow,0,56.0,0,0,0,1,1,Botswana
11136,Sambou Yatabaré,1,89.0,0,0,1,1,2,Mali
11137,Sambégou Bangoura,1,458.0,0,0,4,4,8,Guinea
11138,Sameh Maraaba,0,97.0,0,0,0,2,2,Malaysia
11139,Sami Al-Hashash,0,89.0,0,0,1,0,1,Kuwait
11140,Sami Al-Husaini,1,45.0,0,0,0,1,1,Yemen
11141,Sami Al-Jaber,7,956.0,0,3,15,6,21,Macau
11142,Sami Al-Najei,0,53.0,0,0,2,0,2,Saudi Arabia
11143,Sami Hyypiä,0,218.0,0,0,3,1,4,Finland
11144,Sami Khedira,2,207.0,0,0,3,3,6,Uruguay
11145,Samir Aliyev,0,26.0,0,0,1,0,1,Azerbaijan
11146,Samir Kamouna,2,271.0,0,1,3,2,5,Zambia
11147,Samir Mubarak,1,46.0,0,0,1,0,1,Bahrain
11148,Samir Nasri,1,221.0,0,1,3,1,4,France
11149,Samir Said,1,101.0,0,0,2,0,2,Syria
11150,Samir Sultan Al Fahad,0,22.0,0,0,1,0,1,Saudi Arabia
11151,Sammy Ayoyi,0,48.0,0,0,0,1,1,Ethiopia
11152,Sammy Baird,1,58.0,0,0,0,1,1,France
11153,Sammy Lee,0,87.0,0,0,0,2,2,Greece
11154,Sammy McIlroy,0,109.0,0,0,3,0,3,Northern Ireland
11155,Sammy Morgan,2,77.0,0,0,3,0,3,Northern Ireland
11156,Sammy Onyango,0,88.0,0,0,0,1,1,Ethiopia
11157,Sammy Owino,0,137.0,0,1,2,0,2,Kenya
11158,Sammy Swan,0,76.0,0,0,0,1,1,Canada
11159,Samson Siasia,2,224.0,0,0,2,4,6,Nigeria
11160,Samuel Barlay,0,22.0,0,0,0,1,1,Equatorial Guinea
11161,Samuel Caballero,2,519.0,0,0,3,5,8,Jamaica
11162,Samuel Camille,0,23.0,1,0,1,0,1,United States
11163,Samuel Chukwueze,2,30.0,0,0,2,0,2,Nigeria
11164,Samuel Eto'o,21,2205.0,0,7,30,10,40,Cameroon
11165,Samuel Garcia,2,54.0,0,1,1,1,2,Tahiti
11166,Samuel Holmén,0,64.0,0,0,1,0,1,Sweden
11167,Samuel Hyanine,1,78.0,0,0,1,0,1,Tahiti
11168,Samuel Johnson,1,230.0,0,1,3,0,3,Ghana
11169,Samuel Kuffour,0,40.0,0,0,1,1,2,Tanzania
11170,Samuel Musenze,1,71.0,0,0,0,1,1,Tunisia
11171,Samuel Okwaraji,1,2.0,0,0,0,1,1,Cameroon
11172,Samuel Opone,0,72.0,0,0,0,1,1,Sudan
11173,Samuel Smyth,0,164.0,0,0,2,1,3,Northern Ireland
11174,Samuel Tray,0,70.0,0,0,1,0,1,Sierra Leone
11175,Samuel Umtiti,1,63.0,0,0,2,0,2,France
11176,Samuela Kautoga,1,51.0,0,0,1,0,1,Fiji
11177,Sanad Al Warfali,0,139.0,0,1,2,0,2,Libya
11178,Sanda Seydou,0,36.0,0,0,1,0,1,Niger
11179,Sander Berge,0,34.0,0,0,1,0,1,Norway
11180,Sander Puri,0,83.0,0,0,1,0,1,Estonia
11181,Sandesh Jhingan,0,26.0,0,0,1,0,1,India
11182,Sandi Lovrić,0,60.0,0,1,2,0,2,Slovenia
11183,Sandile Hlatjwako,0,121.0,0,0,2,1,3,Djibouti
11184,Sandro Mazzola,1,491.0,0,0,10,4,14,Italy
11185,Sandro Wagner,0,205.0,0,0,4,1,5,Germany
11186,Sandro Wieser,0,20.0,0,0,1,0,1,Liechtenstein
11187,Sandy Kaposa,0,58.0,0,0,1,0,1,Zambia
11188,Sanel Jahić,0,75.0,0,0,0,1,1,Belgium
11189,Saneliso Dlamini,0,74.0,0,0,0,1,1,Djibouti
11190,Sanharib Malki,2,280.0,0,0,1,3,4,United Arab Emirates
11191,Sanjar Kodirkulov,0,3.0,0,0,1,0,1,Uzbekistan
11192,Santana Vander Kross,0,43.0,0,0,0,1,1,Puerto Rico
11193,Santi Cazorla,0,250.0,0,0,4,0,4,Spain
11194,Santiago Acasiete,0,110.0,0,0,2,0,2,Peru
11195,Santiago Ostolaza,3,141.0,0,0,3,0,3,Uruguay
11196,Santiago Salfate,1,84.0,0,1,0,1,1,Brazil
11197,Santiago Veiga,1,50.0,0,0,0,1,1,United States
11198,Santillana,1,589.0,0,0,8,5,13,Romania
11199,Santino Quaranta,0,74.0,0,0,1,0,1,United States
11200,Santos Cabrera,1,58.0,0,0,0,1,1,Guatemala
11201,Santos Iriarte,0,129.0,0,0,2,0,2,Uruguay
11202,Sanzhar Tursunov,0,107.0,0,0,2,1,3,Uzbekistan
11203,Saoud Al Gassem Mohammed Bo Saeed,0,54.0,0,0,1,0,1,Saudi Arabia
11204,Saphir Sliti Taïder,0,110.0,0,0,1,1,2,Algeria
11205,Sarayoot Chaikamdee,0,402.0,0,0,4,5,9,Yemen
11206,Sardar Azmoun,7,1052.0,0,0,16,11,27,Qatar
11207,Sardor Rashidov,2,369.0,0,0,3,4,7,Uzbekistan
11208,Sargis Hovsepyan,0,89.0,0,1,1,1,2,Kazakhstan
11209,Sarkis Oganessian,0,10.0,1,0,1,0,1,North Macedonia
11210,Sarman Panggabean,2,38.0,0,0,1,1,2,Indonesia
11211,Sath Rosib,1,64.0,0,0,0,1,1,Pakistan
11212,Saturnino Arrúa,0,217.0,0,0,4,0,4,Paraguay
11213,Saud Jassem,0,180.0,0,0,2,0,2,Saudi Arabia
11214,Saud Khariri,0,29.0,0,0,1,0,1,Saudi Arabia
11215,Saula Waqa,0,45.0,0,0,1,0,1,Fiji
11216,Sauli Pietiläinen,0,10.0,0,0,0,1,1,Bulgaria
11217,Saulius Mikoliūnas,0,291.0,0,0,3,1,4,Lithuania
11218,Savo Milošević,12,1255.0,0,0,11,15,26,Serbia
11219,Saydrel Lewis,0,84.0,0,0,2,0,2,Grenada
11220,Sayed Abdel Razek,1,139.0,0,0,2,0,2,Egypt
11221,Sayed Ali Bechir,1,216.0,0,0,1,2,3,Qatar
11222,Sayed Ali Eftekhari,0,16.0,0,0,1,0,1,Iran
11223,Sayed Dhiya Saeed,1,363.0,0,0,4,2,6,Indonesia
11224,Sayed Jaafar Ahmed,1,82.0,0,0,0,1,1,Qatar
11225,Sayed Mahfoodh,0,27.0,0,0,0,1,1,Syria
11226,Sayed Mahmood Jalal,0,27.0,0,0,0,1,1,Indonesia
11227,Sayed Mohamed Adnan,1,195.0,0,0,1,2,3,Thailand
11228,Saïd Benrahma,1,40.0,0,0,0,1,1,Djibouti
11229,Saïd Chiba,2,75.0,0,0,2,0,2,Morocco
11230,Saïd Makasi,1,303.0,0,1,3,2,5,Rwanda
11231,Saïdou Panandétiguiri,0,15.0,1,0,2,0,2,Burkina Faso
11232,Saúl Coco,0,94.0,0,0,1,1,2,Equatorial Guinea
11233,Saúl Martínez,2,193.0,0,0,0,3,3,Brazil
11234,Saúl Ñíguez,0,47.0,0,0,0,1,1,Norway
11235,Saša Ilić,2,176.0,0,0,2,1,3,Serbia
11236,Saša Kalajdžić,1,293.0,0,0,1,3,4,Scotland
11237,Saša Ognenovski,1,35.0,0,0,0,1,1,Uzbekistan
11238,Saša Ćirić,0,296.0,0,1,1,4,5,Liechtenstein
11239,Sašo Miloševski,0,6.0,0,0,1,0,1,North Macedonia
11240,Sašo Udovič,0,267.0,0,0,4,1,5,Slovenia
11241,Schubert Gambetta,2,97.0,0,0,1,2,3,Ecuador
11242,Scott Arfield,2,112.0,0,0,1,1,2,French Guiana
11243,Scott Booth,0,152.0,0,0,4,1,5,Estonia
11244,Scott Brown,0,56.0,0,0,1,0,1,Scotland
11245,Scott Chipperfield,3,470.0,0,0,8,2,10,Australia
11246,Scott McTominay,0,90.0,0,0,1,0,1,Scotland
11247,Scott Sealy,0,85.0,0,0,1,0,1,Trinidad and Tobago
11248,Scott Wiseman,1,44.0,1,0,0,1,1,Gibraltar
11249,Sea Cheng Eang,1,80.0,0,0,1,0,1,Cambodia
11250,Sead Kolašinac,1,3.0,1,0,1,0,1,Argentina
11251,Sean St Ledger,1,122.0,0,0,2,1,3,Republic of Ireland
11252,Seb Larsson,1,90.0,0,0,1,0,1,Sweden
11253,Sebastian Andersson,0,29.0,0,0,1,0,1,Sweden
11254,Sebastian Broderick Imasuen,0,62.0,0,0,1,0,1,Nigeria
11255,Sebastian Deisler,0,67.0,0,0,2,0,2,Germany
11256,Sebastian Giovinco,1,86.0,0,0,1,0,1,Italy
11257,Sebastian Larsson,0,341.0,0,4,2,4,6,Sweden
11258,Sebastian Lletget,0,95.0,0,0,1,1,2,United States
11259,Sebastian Mila,0,161.0,0,0,1,1,2,Poland
11260,Sebastian Prödl,0,67.0,0,0,1,1,2,Austria
11261,Sebastian Rudy,0,2.0,0,0,0,1,1,Northern Ireland
11262,Sebastian Szymański,0,3.0,0,0,1,0,1,Poland
11263,Sebastien Lakou,1,47.0,0,0,1,0,1,Congo
11264,Sebastián Abreu,2,577.0,0,0,7,3,10,Uruguay
11265,Sebastián Coates,0,12.0,0,0,1,0,1,Uruguay
11266,Sebastián Córdova,0,18.0,0,0,1,0,1,Mexico
11267,Sebastián Eguren,0,192.0,0,0,2,1,3,Colombia
11268,Sebastián González,1,161.0,0,0,0,2,2,Paraguay
11269,Sebastián Pérez Cardona,0,48.0,0,0,1,0,1,Colombia
11270,Sebastián Rambert,1,31.0,0,0,0,1,1,Japan
11271,Sebastián Rozental,1,63.0,0,0,0,1,1,United States
11272,Sebastián Soria,2,751.0,0,2,8,6,14,Japan
11273,Sebastián Tagliabúe,0,86.0,0,0,1,0,1,United Arab Emirates
11274,Sebastião Gilberto,0,153.0,0,1,2,1,3,Zambia
11275,Sebastjan Cimirotič,1,258.0,0,0,2,2,4,Switzerland
11276,Sedat Özden,0,123.0,0,0,1,3,4,Malta
11277,Sedonoude Abouta,1,70.0,0,0,0,1,1,Nigeria
11278,Sefedin Braho,0,2.0,0,0,1,0,1,Albania
11279,Segin Wayewol,3,270.0,0,0,1,2,3,New Caledonia
11280,Segun Odegbami,2,508.0,0,0,8,2,10,Nigeria
11281,Segundo Castillo,0,130.0,0,0,2,1,3,Ecuador
11282,Segundo Luna,3,144.0,0,0,3,0,3,Argentina
11283,Segundo Villadóniga,1,1.0,0,0,0,1,1,Brazil
11284,Seif Teiri,1,72.0,0,0,1,0,1,Sudan
11285,Seifeddine Jaziri,1,152.0,0,0,2,0,2,Tunisia
11286,Seiichiro Maki,0,161.0,0,0,1,2,3,Vietnam
11287,Seimata Chilia,2,157.0,0,0,0,3,3,American Samoa
11288,Seiminlen Doungel,1,90.0,0,0,0,1,1,Afghanistan
11289,Sejad Salihović,0,46.0,0,1,1,1,2,Bosnia and Herzegovina
11290,Sekou Cissé,0,191.0,0,0,3,0,3,Ivory Coast
11291,Seksan Piturat,3,368.0,0,0,5,4,9,Iran
11292,Sele Leboela,0,44.0,0,0,0,1,1,Guinea
11293,Selemani Ndikumana,0,169.0,0,1,2,0,2,Burundi
11294,Selim Amallah,1,124.0,0,0,3,0,3,Morocco
11295,Selim Benachour,1,116.0,0,0,2,0,2,Tunisia
11296,Sellam Riahi,0,40.0,0,0,0,1,1,Spain
11297,Sello Muso,1,90.0,0,0,1,0,1,Lesotho
11298,Selvyn Ponciano,0,53.0,0,0,0,1,1,Mexico
11299,Selwyn Murren,0,66.0,1,0,1,0,1,Guatemala
11300,Selçuk Yula,0,162.0,0,1,3,0,3,Turkey
11301,Selçuk İnan,0,333.0,0,1,3,2,5,Turkey
11302,Semi Nuoranen,0,27.0,0,0,1,0,1,Finland
11303,Semih Şentürk,2,432.0,0,0,2,4,6,Switzerland
11304,Senad Lulić,1,176.0,0,0,1,2,3,Latvia
11305,Senad Tiganj,0,82.0,0,0,1,0,1,Slovenia
11306,Sendley Sidney Bito,0,40.0,0,0,0,2,2,Haiti
11307,Sengphet Thongphachan,0,53.0,0,0,1,0,1,Laos
11308,Senijad Ibričić,0,100.0,0,0,1,2,3,Bosnia and Herzegovina
11309,Seninho,0,11.0,0,0,1,0,1,Portugal
11310,Sentayehu Getachew,0,64.0,0,0,1,0,1,Ethiopia
11311,Sentu Johnson,0,79.0,0,0,0,1,1,Algeria
11312,Seo Jung-won,2,283.0,0,0,0,4,4,Hong Kong
11313,Seol Ki-hyeon,1,246.0,0,0,4,0,4,South Korea
11314,Seppo Pyykkö,0,53.0,0,0,1,0,1,Finland
11315,Sercan Yıldırım,0,37.0,0,0,1,0,1,Turkey
11316,Serdar Annaorazow,0,12.0,1,0,1,0,1,Guam
11317,Serdar Aziz,0,83.0,0,0,1,0,1,Turkey
11318,Serdar Dursun,0,157.0,0,0,1,1,2,Latvia
11319,Serdaraly Ataýew,0,70.0,0,0,0,1,1,India
11320,Serey Dié,2,125.0,0,0,1,1,2,Ivory Coast
11321,Serge Chiesa,0,78.0,0,0,1,0,1,France
11322,Serge Gakpé,1,45.0,0,0,1,1,2,Guinea-Bissau
11323,Serge Gnabry,1,585.0,0,0,9,8,17,San Marino
11324,Serge Maguy,1,73.0,0,0,1,0,1,Ivory Coast
11325,Serge Trinchero,0,40.0,0,1,1,0,1,Switzerland
11326,Sergei Aleinikov,2,176.0,0,0,2,2,4,Russia
11327,Sergei Bragin,0,57.0,0,0,0,1,1,Scotland
11328,Sergei Gurenko,0,116.0,0,0,2,1,3,Belarus
11329,Sergei Hohlov-Simson,0,165.0,1,0,2,1,3,Estonia
11330,Sergei Ignashevich,0,299.0,1,1,1,6,7,Switzerland
11331,Sergei Ivanov,1,47.0,0,0,0,1,1,Maldives
11332,Sergei Khizhnichenko,0,184.0,0,0,3,2,5,Andorra
11333,Sergei Kiriakov,0,327.0,0,0,1,6,7,Luxembourg
11334,Sergei Kornilenko,0,573.0,0,2,5,5,10,Romania
11335,Sergei Mošnikov,0,88.0,0,0,1,0,1,Estonia
11336,Sergei Omelyanchuk,0,45.0,0,0,1,0,1,Belarus
11337,Sergei Ostapenko,0,275.0,1,0,4,2,6,Armenia
11338,Sergei Pavlovich Baltacha,1,70.0,0,0,2,0,2,Russia
11339,Sergei Petrov,0,19.0,0,0,0,1,1,San Marino
11340,Sergei Semak,0,173.0,0,0,2,1,3,Luxembourg
11341,Sergei Terehhov,0,264.0,0,0,2,2,4,Estonia
11342,Sergei Yuran,0,285.0,0,0,4,1,5,Cyprus
11343,Sergei Zenjov,1,440.0,0,0,5,3,8,Belgium
11344,Sergej Barbarez,0,501.0,0,1,4,7,11,Bosnia and Herzegovina
11345,Sergej Milinković-Savić,1,249.0,0,0,0,4,4,Norway
11346,Sergen Yalçın,0,287.0,0,0,3,1,4,Turkey
11347,Sergey Andreyev,2,274.0,0,0,4,1,5,Russia
11348,Sergey Chikishev,0,161.0,0,0,1,2,3,Pakistan
11349,Sergey Gotsmanov,0,68.0,0,0,0,1,1,Denmark
11350,Sergey Gridin,0,125.0,0,0,2,0,2,Kazakhstan
11351,Sergey Grishin,0,55.0,0,0,1,0,1,Russia
11352,Sergey Krivets,0,77.0,0,0,1,0,1,Belarus
11353,Sergey Kutsov,2,131.0,0,0,1,2,3,Iran
11354,Sergey Lebedev,1,164.0,0,1,3,0,3,Uzbekistan
11355,Sergey Lushan,1,29.0,0,0,0,1,1,Japan
11356,Sergey Rodionov,1,120.0,0,0,2,0,2,Russia
11357,Serghei Alexeev,0,247.0,0,0,2,1,3,Moldova
11358,Serghei Belous,0,8.0,0,0,1,0,1,Moldova
11359,Serghei Cleșcenco,0,189.0,0,1,2,3,5,Bulgaria
11360,Serghei Covalciuc,0,175.0,0,0,2,0,2,Moldova
11361,Serghei Dadu,0,126.0,0,1,2,1,3,Moldova
11362,Serghei Pogreban,0,10.0,0,0,0,1,1,North Macedonia
11363,Serghei Rogaciov,0,142.0,0,1,5,0,5,Moldova
11364,Serghei Secu,0,28.0,0,0,1,0,1,Moldova
11365,Serghei Stroenco,0,16.0,1,0,1,0,1,Germany
11366,Sergi Moreno,0,53.0,0,0,0,1,1,San Marino
11367,Sergi Roberto,0,55.0,0,0,1,0,1,Spain
11368,Serginho,0,43.0,0,1,0,1,1,Mexico
11369,Serginho Chulapa,2,136.0,0,0,1,1,2,Brazil
11370,Sergio Agüero,8,1025.0,0,1,15,5,20,Argentina
11371,Sergio Ahumada,1,243.0,0,0,4,0,4,Chile
11372,Sergio Angulo,0,66.0,0,0,1,0,1,Colombia
11373,Sergio Barila,0,25.0,0,1,1,0,1,Equatorial Guinea
11374,Sergio Berti,1,83.0,0,0,1,0,1,Argentina
11375,Sergio Busquets,0,64.0,0,0,2,0,2,Spain
11376,Sergio Cervato,0,3.0,0,0,1,0,1,Italy
11377,Sergio Espinoza,1,62.0,0,0,1,0,1,Chile
11378,Sergio Herrera,1,156.0,0,1,2,0,2,Colombia
11379,Sergio Peña,1,120.0,0,0,2,1,3,Colombia
11380,Sergio Ramos,0,499.0,0,4,7,6,13,San Marino
11381,Sergio Salgado,1,83.0,0,0,0,1,1,Venezuela
11382,Sergio Santana,2,287.0,0,0,2,2,4,Mexico
11383,Sergio Zanatta,0,10.0,0,0,1,0,1,Canada
11384,Sergiu Epureanu,0,3.0,0,0,1,0,1,Moldova
11385,Sergiño Dest,0,25.0,0,0,1,0,1,United States
11386,Serguei Prado,0,87.0,0,0,1,0,1,Cuba
11387,Serhat Akın,0,185.0,0,0,3,0,3,Turkey
11388,Serhii Rebrov,2,511.0,0,3,4,5,9,Northern Ireland
11389,Serhiy Fedorov,0,90.0,0,0,1,0,1,Ukraine
11390,Serhiy Konovalov,0,29.0,0,0,1,0,1,Ukraine
11391,Serhiy Malyi,0,44.0,1,0,0,1,1,Kazakhstan
11392,Serhiy Nazarenko,0,234.0,0,0,3,2,5,Kazakhstan
11393,Serhiy Popov,0,56.0,0,0,3,0,3,Ukraine
11394,Serhiy Serebrennikov,0,2.0,0,0,0,1,1,Armenia
11395,Serhiy Skachenko,0,55.0,0,0,2,0,2,Ukraine
11396,Serhiy Sydorchuk,0,192.0,0,0,1,2,3,Belarus
11397,Serikzhan Muzhikov,0,59.0,0,0,0,1,1,Ukraine
11398,Servaas Wilkes,0,26.0,0,0,1,0,1,Netherlands
11399,Server Djeparov,3,731.0,0,2,8,6,14,Uzbekistan
11400,Servet Çetin,0,106.0,0,0,1,1,2,Malta
11401,Servílio de Jesús,1,37.0,0,0,0,1,1,Argentina
11402,Seth Amphadu,1,32.0,0,0,1,0,1,Ghana
11403,Seveci Rokotakala,3,240.0,0,0,3,1,4,Fiji
11404,Severino Da Silva,4,200.0,0,0,4,0,4,Brazil
11405,Severino Varela,9,539.0,0,1,5,10,15,Paraguay
11406,Severo Orgaz,2,168.0,0,0,2,0,2,Bolivia
11407,Seweryn Gancarczyk,0,3.0,1,0,0,1,1,Poland
11408,Seyd Bechir,0,72.0,0,0,2,0,2,Qatar
11409,Seydou Doumbia,1,232.0,0,0,1,2,3,Ivory Coast
11410,Seydou Keita,4,722.0,0,0,8,5,13,Mali
11411,Seydou Traoré,0,77.0,0,0,1,0,1,Burkina Faso
11412,Seydouba Bangoura,1,145.0,0,0,1,1,2,Algeria
11413,Seydouba Soumah,0,80.0,0,1,1,1,2,Egypt
11414,Seydouba Sylla,1,31.0,0,0,1,0,1,Guinea
11415,Seyoum Tesfaye,0,127.0,0,0,2,0,2,Ethiopia
11416,Shabani Nonda,1,437.0,0,1,9,2,11,DR Congo
11417,Shabib Al-Khaldi,0,73.0,0,0,1,0,1,Kuwait
11418,Shadrack Nsajigwa,0,12.0,0,0,0,1,1,Mauritius
11419,Shaharuddin Abdullah,1,70.0,0,0,0,1,1,Thailand
11420,Shahdon Winchester,0,66.0,0,0,0,1,1,Mexico
11421,Shahin Bayani,1,88.0,1,0,1,0,1,Saudi Arabia
11422,Shahrel Fikri,0,115.0,0,0,4,0,4,Malaysia
11423,Shahrokh Bayani,2,183.0,0,2,1,2,3,Iran
11424,Shahrom Samiev,1,174.0,0,0,2,0,2,Tajikistan
11425,Shailemdra Lal,5,159.0,0,0,5,0,5,Fiji
11426,Shailend Lal,1,28.0,0,0,0,1,1,Tahiti
11427,Shait Ahmed Jehad,2,180.0,0,0,0,2,2,Qatar
11428,Shaker Mahmoud,1,49.0,0,0,1,0,1,Iraq
11429,Shakir Hamzah,0,3.0,0,0,1,0,1,Singapore
11430,Shalom Luani,2,98.0,0,0,2,0,2,American Samoa
11431,Shamar Nicholson,2,201.0,0,0,2,3,5,Jamaica
11432,Shamveel Qasim,0,14.0,0,0,1,0,1,Maldives
11433,Shandel Samuel,0,278.0,0,0,3,2,5,Nicaragua
11434,Shane Duffy,0,249.0,0,0,2,3,5,Georgia
11435,Shane Long,1,319.0,0,0,3,2,5,Republic of Ireland
11436,Shane Malcolm,0,51.0,0,0,1,0,1,Guam
11437,Shane Marshall,0,89.0,0,0,1,0,1,Dominica
11438,Shane Rennie,0,96.0,0,1,2,1,3,Grenada
11439,Shane Smeltz,3,613.0,0,1,5,9,14,Fiji
11440,Shannon Burgess,0,208.0,0,2,4,0,4,Bermuda
11441,Shanon Carmelia,0,111.0,0,0,2,0,2,Curaçao
11442,Shao Jiayi,1,238.0,0,0,6,1,7,China PR
11443,Shaq Moore,0,1.0,0,0,1,0,1,United States
11444,Shaquille Pinas,0,96.0,0,0,2,0,2,Suriname
11445,Sharaf Mahfood,1,52.0,0,0,1,0,1,Yemen
11446,Sharif Mukhammad,0,63.0,1,0,1,0,1,Japan
11447,Shaun Bartlett,7,555.0,0,1,14,1,15,South Africa
11448,Shaun Easthope,0,43.0,0,1,1,0,1,Samoa
11449,Shaun Francis,1,6.0,0,0,1,0,1,Jamaica
11450,Shaun Goater,0,564.0,0,1,3,7,10,Bermuda
11451,Shaun Maloney,1,304.0,0,2,3,4,7,Faroe Islands
11452,Shaun Murphy,3,144.0,0,0,2,1,3,Australia
11453,Shaun Wright-Phillips,0,91.0,0,0,3,0,3,England
11454,Shavkat Salomov,0,68.0,0,0,1,0,1,Uzbekistan
11455,Shawky Gharieb,0,73.0,0,0,1,0,1,Egypt
11456,Shawn Beveney,0,26.0,0,0,1,0,1,Guyana
11457,Shawn Martin,0,25.0,0,0,2,1,3,El Salvador
11458,Shay Holtzman,1,90.0,0,0,1,0,1,Israel
11459,Shaye Al Nafeesah,0,90.0,0,0,1,0,1,Saudi Arabia
11460,Shaye Al-Nafisah,1,10.0,0,0,1,0,1,Saudi Arabia
11461,Shayne Lavery,0,67.0,0,0,0,1,1,Lithuania
11462,Shefki Kuqi,0,362.0,0,0,3,2,5,Albania
11463,Sheikh Mohammad Aslam,0,70.0,0,0,1,0,1,Bangladesh
11464,Sheldon Bateau,3,79.0,0,0,4,0,4,Trinidad and Tobago
11465,Sheldon Emmanuel,0,79.0,0,1,2,0,2,Saint Lucia
11466,Shen Si,1,7.0,0,1,1,0,1,China PR
11467,Shen Xiangfu,3,329.0,0,0,4,0,4,China PR
11468,Sheraldo Becker,0,39.0,0,0,2,0,2,Suriname
11469,Sheridan Grosvenor,0,90.0,0,0,0,1,1,Bermuda
11470,Sheriddin Boboev,1,78.0,0,0,1,0,1,Tajikistan
11471,Sherif Touré Coubageat,0,63.0,0,0,1,0,1,Togo
11472,Sheriff Suma,0,169.0,0,0,3,0,3,Sierra Leone
11473,Shewangizaw Agonafer,0,19.0,0,0,1,0,1,Ethiopia
11474,Shi Jiayi,2,213.0,0,0,1,3,4,Palestine
11475,Shibuzor Ehilegbu,1,31.0,0,0,0,1,1,Ghana
11476,Shigeyoshi Mochizuki,1,30.0,0,0,1,0,1,Japan
11477,Shikabala,0,61.0,0,0,0,1,1,Ghana
11478,Shimelis Bekele,0,217.0,0,0,3,0,3,Ethiopia
11479,Shimon Gershon,1,98.0,0,2,2,0,2,Israel
11480,Shin Hong-Ki,1,63.0,0,0,1,0,1,South Korea
11481,Shin Tae-Yong,1,35.0,0,0,1,0,1,South Korea
11482,Shingayi Kaondera,0,178.0,0,0,2,2,4,Gabon
11483,Shinji Kagawa,5,719.0,0,1,8,7,15,Qatar
11484,Shinji Okazaki,12,1213.0,0,0,8,14,22,Uzbekistan
11485,Shinji Ono,1,207.0,0,0,1,2,3,Saudi Arabia
11486,Shiva N'Zigou,1,23.0,0,0,1,1,2,South Africa
11487,Shkodran Mustafi,1,66.0,0,0,2,0,2,Germany
11488,Shkëlqim Muça,0,27.0,0,0,1,0,1,Albania
11489,Shkëlzen Gashi,0,81.0,0,0,1,0,1,Albania
11490,Shlomo Levi,2,207.0,0,0,5,0,5,Israel
11491,Shlomo Nahari,0,34.0,0,0,1,0,1,Israel
11492,Shmuel Rosenthal,1,70.0,0,0,1,0,1,Israel
11493,Sho Inagaki,0,158.0,0,0,2,0,2,Japan
11494,Sho Sasaki,0,72.0,0,0,1,0,1,Japan
11495,Shojae Khalilzadeh,1,22.0,0,0,0,1,1,Cambodia
11496,Shoji Jo,1,119.0,0,0,2,0,2,Japan
11497,Shomari Kapombe,0,61.0,0,0,1,0,1,Tanzania
11498,Shon Weissman,0,117.0,0,0,2,0,2,Israel
11499,Shota Arveladze,0,747.0,0,0,8,11,19,Georgia
11500,Shoya Nakajima,1,31.0,0,0,0,2,2,Ecuador
11501,Shukhrat Dzhaborov,0,148.0,0,0,3,0,3,Tajikistan
11502,Shukhrat Jabbarov,1,77.0,0,0,1,0,1,Tajikistan
11503,Shukhrat Maksudov,0,124.0,0,0,2,0,2,Uzbekistan
11504,Shunsuke Nakamura,7,491.0,0,1,5,8,13,New Zealand
11505,Shurland David,1,75.0,1,0,1,0,1,Mexico
11506,Shusaku Hirasawa,1,28.0,0,0,0,1,1,Israel
11507,Siaka Tiéné,1,133.0,0,0,2,0,2,Ivory Coast
11508,Siboniso Mamba,0,56.0,0,0,0,1,1,Djibouti
11509,Sibusiso Vilakazi,0,45.0,0,0,1,0,1,South Africa
11510,Sibusiso Zuma,1,198.0,0,0,3,2,5,Burkina Faso
11511,Sid Ahmed Zerrouki,0,78.0,0,0,0,1,1,Kenya
11512,Siddiq Manzul,1,143.0,0,1,1,1,2,Sudan
11513,Sidi Napon,0,56.0,0,0,1,0,1,Burkina Faso
11514,Sidi Yaya Keita,0,127.0,0,0,2,0,2,Mali
11515,Sidique Mansaray,0,104.0,0,0,2,0,2,Sierra Leone
11516,Sidney Govou,0,303.0,0,0,4,2,6,France
11517,Sidumo Shongwe,0,126.0,0,0,1,1,2,Eswatini
11518,Siegfried Haltman,0,32.0,0,0,2,1,3,Trinidad and Tobago
11519,Siegfried Stritzl,0,89.0,0,0,0,1,1,Canada
11520,Sieng Chanthea,0,81.0,0,0,1,0,1,Cambodia
11521,Sigamary Diarra,1,90.0,0,0,1,0,1,Mali
11522,Sigfrido Mercado,0,100.0,0,0,2,1,3,United States
11523,Sigfried Held,1,57.0,0,0,2,0,2,Germany
11524,Sigifredo Cuchuca,0,18.0,0,0,0,1,1,Brazil
11525,Sigurd Rushfeldt,0,107.0,0,0,1,1,2,Luxembourg
11526,Sigurður Grétarsson,0,10.0,0,0,1,0,1,Iceland
11527,Sigurður Jónsson,0,194.0,0,0,1,2,3,Spain
11528,Siim Luts,1,10.0,0,0,0,1,1,Gibraltar
11529,Silao Malo,1,158.0,0,0,2,0,2,Samoa
11530,Silvan Widmer,0,11.0,0,0,0,1,1,Italy
11531,Silvestre Igoa,1,152.0,0,0,1,1,2,Spain
11532,Silvestre Varela,2,270.0,0,0,2,2,4,Denmark
11533,Silvio Garay,1,90.0,0,0,0,1,1,Peru
11534,Silvio Lagreca,1,39.0,0,1,0,1,1,Argentina
11535,Silvio Marić,0,39.0,0,0,1,0,1,Croatia
11536,Silvio Marzolini,1,50.0,0,0,1,0,1,Argentina
11537,Silvio Parodi,4,313.0,0,0,2,4,6,Paraguay
11538,Silvio Piola,3,315.0,0,0,1,4,5,Italy
11539,Silvio Rojas,0,89.0,0,0,1,1,2,Colombia
11540,Silvio Spann,1,8.0,0,0,0,1,1,El Salvador
11541,Silviu Bindea,1,35.0,0,0,0,1,1,Cuba
11542,Silvère Ganvoula,0,45.0,0,1,1,0,1,Congo
11543,Simen Brenne,1,31.0,0,0,0,1,1,Turkey
11544,Simeon Jackson,0,170.0,0,0,0,4,4,Puerto Rico
11545,Simo Emmanuel Mvé,0,79.0,0,0,1,0,1,Cameroon
11546,Simo Syrjävaara,0,25.0,0,0,1,0,1,Finland
11547,Simon Church,0,67.0,0,0,1,0,1,Wales
11548,Simon Colosimo,0,132.0,0,0,2,0,2,Australia
11549,Simon Davies,0,204.0,0,0,3,3,6,Finland
11550,Simon Dawkins,0,89.0,0,0,0,1,1,Nicaragua
11551,Simon Elliott,2,146.0,0,0,3,0,3,New Zealand
11552,Simon Kaushi,2,98.0,0,0,0,3,3,Kenya
11553,Simon Kjær,0,233.0,1,1,2,3,5,Czech Republic
11554,Simon Lauru,3,173.0,0,0,1,2,3,Vanuatu
11555,Simon Masaba,0,30.0,0,1,1,0,1,Uganda
11556,Simon Rolfes,0,64.0,0,0,0,1,1,Liechtenstein
11557,Simon Tahamata,0,57.0,0,0,0,1,1,Republic of Ireland
11558,Simon Uutoni,1,130.0,0,0,1,1,2,Namibia
11559,Simone Bacciocchi,0,61.0,1,0,1,0,1,Moldova
11560,Simone Perrotta,1,119.0,0,0,1,1,2,Italy
11561,Simone Zaza,0,16.0,0,0,0,1,1,Norway
11562,Simão,0,245.0,0,0,5,0,5,Brazil
11563,Simão Sabrosa,2,643.0,0,1,11,1,12,Portugal
11564,Sin Yong-nam,0,52.0,0,0,0,1,1,Thailand
11565,Singgih Pitono,0,85.0,0,0,0,1,1,Qatar
11566,Singo McDonald,0,2.0,0,0,0,1,1,Kenya
11567,Sinha,2,211.0,0,0,3,2,5,Mexico
11568,Siniša Gogić,0,104.0,0,1,4,0,4,Cyprus
11569,Siniša Mihajlović,4,340.0,1,0,4,2,6,Slovakia
11570,Sione Uhatahi,0,47.0,0,0,1,0,1,Tonga
11571,Siphiwe Tshabalala,1,105.0,0,0,1,2,3,Equatorial Guinea
11572,Sirous Dinmohammadi,0,84.0,0,0,0,1,1,Saudi Arabia
11573,Sirous Ghayeghran,1,108.0,0,0,0,2,2,Thailand
11574,Sisir Ghosh,0,34.0,0,0,0,1,1,Bangladesh
11575,Siyabonga Nkosi,1,45.0,0,0,0,1,1,Guatemala
11576,Siyabonga Nomvethe,6,430.0,0,0,5,3,8,Ghana
11577,Siyabonga Sangweni,0,116.0,0,0,2,0,2,South Africa
11578,Siza Dlamini,0,198.0,0,0,2,1,3,Angola
11579,Sjaak Roggeveen,0,90.0,0,0,1,0,1,Netherlands
11580,Sjaak Swart,0,132.0,0,0,2,0,2,Netherlands
11581,Skander Souayah,1,43.0,0,1,1,1,2,Tunisia
11582,Slava Metreveli,3,267.0,0,0,4,3,7,Russia
11583,Slaven Bilić,1,51.0,0,0,2,1,3,Bosnia and Herzegovina
11584,Slaven Zambata,0,314.0,0,0,3,4,7,Sweden
11585,Slaviša Jokanović,1,113.0,0,0,1,3,4,Faroe Islands
11586,Slimane Raho,0,60.0,1,0,1,0,1,Zimbabwe
11587,Sloan Privat,1,71.0,0,0,1,0,1,French Guiana
11588,Slobodan Komljenović,3,127.0,0,0,1,2,3,United States
11589,Smail Prevljak,0,91.0,0,0,0,2,2,Kazakhstan
11590,Smith Samuel,0,82.0,0,0,1,0,1,Guinea
11591,So Kyong-jin,0,45.0,0,0,0,1,1,Philippines
11592,Soeuy Visal,1,77.0,1,0,1,1,2,Iran
11593,Sofiane Bendebka,1,73.0,0,0,0,1,1,Ivory Coast
11594,Sofiane Boufal,3,253.0,0,2,2,2,4,Morocco
11595,Sofiane Daoud,0,48.0,0,0,1,0,1,Algeria
11596,Sofiane Feghouli,5,323.0,0,2,4,5,9,Algeria
11597,Sofiane Hanni,1,90.0,0,0,1,0,1,Algeria
11598,Sohrab Bakhtiarizadeh,1,187.0,0,0,3,0,3,Iran
11599,Sok Sun Hean,1,56.0,0,0,1,0,1,Cambodia
11600,Sokol Cikalleshi,0,286.0,0,1,2,3,5,Albania
11601,Sokol Kushta,0,278.0,0,2,6,3,9,Romania
11602,Sokratis Papastathopoulos,1,204.0,0,0,0,3,3,Costa Rica
11603,Sol Campbell,1,24.0,0,0,1,0,1,England
11604,Solome Pita,0,22.0,0,0,1,0,1,Fiji
11605,Solomon Sheferahu,0,42.0,0,0,2,0,2,Ethiopia
11606,Somen Tchoyi,0,65.0,0,0,0,1,1,Cape Verde
11607,Sompit Suwannapluoh,1,49.0,0,0,0,1,1,Malaysia
11608,Sompong Soleb,0,35.0,0,0,1,0,1,Thailand
11609,Son Heung-min,8,1491.0,0,3,16,6,22,South Korea
11610,Song Chong-gug,0,128.0,0,0,1,1,2,United States
11611,Songserm Maperm,1,110.0,0,0,1,1,2,Thailand
11612,Sonni Nattestad,0,38.0,0,0,0,2,2,Latvia
11613,Soony Saad,2,177.0,0,0,1,3,4,Turkmenistan
11614,Sor Rotana,1,32.0,1,0,0,1,1,Cambodia
11615,Soriba Soumah,3,194.0,0,4,1,3,4,Egypt
11616,Sorin Avram,0,71.0,0,0,0,1,1,Portugal
11617,Sory Kaba,1,34.0,0,0,1,0,1,Guinea
11618,Sos Suhana,0,65.0,0,0,0,1,1,Singapore
11619,Sotirios Kyrgiakos,0,43.0,0,0,1,2,3,Greece
11620,Sotiris Kaiafas,0,105.0,0,1,2,0,2,Cyprus
11621,Sotiris Ninis,0,115.0,0,0,1,1,2,Israel
11622,Soufiane Alloudi,3,34.0,0,0,0,3,3,Namibia
11623,Soukaphone Vongchiengkham,0,5.0,0,0,0,1,1,China PR
11624,Souleyman Sané,0,218.0,0,0,4,1,5,Senegal
11625,Souleymane Camara,2,148.0,0,0,1,1,2,Senegal
11626,Souleymane Diamouténé,0,48.0,0,1,1,0,1,Mali
11627,Souleymane Oularé,3,266.0,0,0,2,4,6,Guinea
11628,Souleymane Youla,1,268.0,0,0,2,3,5,Uganda
11629,Souliya Syphasay,0,46.0,0,0,1,0,1,Laos
11630,Soumaila Traoré,1,64.0,0,0,0,1,1,Egypt
11631,Soumaila Yattaga,0,32.0,0,0,0,1,1,Botswana
11632,Soumaïla Coulibaly,1,289.0,0,0,3,3,6,Guinea-Bissau
11633,Sousa Miyamou,0,89.0,0,0,1,0,1,Congo
11634,Spas Delev,0,25.0,0,0,2,0,2,Bulgaria
11635,Spiro Debarski,0,77.0,0,0,1,0,1,Bulgaria
11636,Srdjan Luchin,0,77.0,0,0,0,1,1,Albania
11637,Srečko Katanec,0,252.0,0,0,3,2,5,Yugoslavia
11638,Srgjan Zaharievski,0,141.0,0,0,1,1,2,North Macedonia
11639,Stalin Rivas,1,72.0,0,0,0,1,1,Uruguay
11640,Stan Mortensen,1,146.0,0,0,2,2,4,Wales
11641,Stan Pearson,0,101.0,0,0,2,0,2,England
11642,Stan Vanden Eynde,1,30.0,0,0,0,1,1,Republic of Ireland
11643,Stanislaus Kobierski,1,25.0,0,0,0,1,1,Belgium
11644,Stanislav Andreev,1,50.0,0,0,0,1,1,Yemen
11645,Stanislav Angelov,0,31.0,0,0,1,0,1,Bulgaria
11646,Stanislav Griga,0,93.0,0,0,2,0,2,Czechoslovakia
11647,Stanislav Karasi,2,229.0,0,0,0,4,4,Greece
11648,Stanislav Lobotka,0,11.0,0,0,0,2,2,England
11649,Stanislav Manolev,0,136.0,0,0,3,1,4,Bulgaria
11650,Stanislav Varga,0,58.0,0,0,1,0,1,Slovakia
11651,Stanislav Šesták,0,479.0,0,0,5,4,9,Slovakia
11652,Stanislaw Drahun,0,276.0,0,0,2,3,5,Romania
11653,Stanisław Terlecki,0,213.0,0,0,1,3,4,Poland
11654,Stanley Humbert Krenten,0,115.0,0,0,2,0,2,Suriname
11655,Stanley Mubiru,2,141.0,0,0,0,3,3,Egypt
11656,Stanley Ndunduma,0,90.0,0,0,1,0,1,Zimbabwe
11657,Stanley Simson,0,52.0,0,0,0,1,1,Guyana
11658,Stanley Waita,1,69.0,0,0,1,1,2,Vanuatu
11659,Stanton Lewis,0,60.0,0,0,1,0,1,Bermuda
11660,Stasys Baranauskas,0,63.0,0,0,1,0,1,Lithuania
11661,Stathis Chaitas,0,39.0,0,0,0,1,1,Finland
11662,Stavros Georgiou,0,71.0,0,0,1,0,1,Cyprus
11663,Stavros Sarafis,0,4.0,0,0,1,0,1,Greece
11664,Stavros Stylianou,0,74.0,0,1,1,0,1,Cyprus
11665,Steeve Yago,0,24.0,0,0,0,1,1,Cameroon
11666,Steeven Langil,1,66.0,0,0,1,0,1,Martinique
11667,Steeven Saba,1,22.0,0,0,0,1,1,Nicaragua
11668,Steevy Chong Hue,3,86.0,0,0,2,1,3,Samoa
11669,Stefan Bozhkov,0,55.0,0,1,1,0,1,Bulgaria
11670,Stefan Effenberg,1,47.0,0,0,0,1,1,Scotland
11671,Stefan Johansen,0,45.0,0,0,0,1,1,Sweden
11672,Stefan Kuntz,0,97.0,0,0,0,2,2,England
11673,Stefan Lainer,1,66.0,0,0,2,0,2,Austria
11674,Stefan Landberg,0,89.0,0,0,1,0,1,Sweden
11675,Stefan Maierhofer,0,1.0,0,0,1,0,1,Austria
11676,Stefan Majewski,1,92.0,0,0,2,0,2,Poland
11677,Stefan Mugoša,0,260.0,0,0,2,2,4,Montenegro
11678,Stefan Pettersson,0,76.0,0,0,1,0,1,Sweden
11679,Stefan Posch,0,21.0,0,0,0,1,1,Slovenia
11680,Stefan Reshko,0,22.0,1,0,1,0,1,Turkey
11681,Stefan Ristovski,0,66.0,0,0,1,0,1,North Macedonia
11682,Stefan Rusnák,0,5.0,0,0,0,1,1,Israel
11683,Stefan Savić,0,87.0,0,0,1,1,2,Moldova
11684,Stefan Sultana,0,50.0,0,0,2,0,2,Malta
11685,Stefan Velichkov,0,72.0,0,0,1,0,1,Bulgaria
11686,Stefan de Vrij,1,119.0,0,0,0,2,2,Spain
11687,Stefan Šćepović,0,74.0,0,0,1,0,1,Serbia
11688,Stefanis Michael,0,85.0,0,0,1,1,2,Russia
11689,Stefano Bensi,0,197.0,0,0,1,2,3,Azerbaijan
11690,Stefano Cincotta,0,50.0,0,0,0,2,2,Bermuda
11691,Stefano Eranio,0,170.0,0,0,2,0,2,Italy
11692,Stefano Fanelli,0,82.0,0,0,1,0,1,Luxembourg
11693,Stefano Fiore,0,66.0,0,0,0,1,1,Belgium
11694,Stefano Sensi,0,65.0,0,0,1,1,2,Italy
11695,Stefanos Borbokis,0,146.0,0,0,3,0,3,Greece
11696,Stefanos Lysandrou,0,42.0,0,0,0,1,1,Belgium
11697,Steffen Iversen,1,669.0,0,3,7,10,17,Georgia
11698,Stefán Teitur Þórðarson,0,19.0,0,0,1,0,1,Iceland
11699,Stein Thunberg,0,65.0,0,0,1,0,1,Norway
11700,Steinar Dagur Adolfsson,0,67.0,0,0,0,1,1,Andorra
11701,Stelios Giannakopoulos,0,211.0,0,0,0,4,4,Spain
11702,Stelios Manolas,0,68.0,0,0,1,0,1,Greece
11703,Stelios Okkarides,0,80.0,0,0,0,1,1,Republic of Ireland
11704,Sten-Ove Ramberg,0,35.0,0,0,1,0,1,Sweden
11705,Stephan El Shaarawy,0,125.0,0,0,0,2,2,Azerbaijan
11706,Stephan Lichtsteiner,0,343.0,0,0,6,0,6,Switzerland
11707,Stephan Rabemananjara,0,18.0,0,0,1,0,1,Madagascar
11708,Stephan Schröck,1,264.0,0,0,2,2,4,Philippines
11709,Stephen Appiah,1,290.0,0,1,6,0,6,Ghana
11710,Stephen Astwood,0,140.0,0,0,2,0,2,Bermuda
11711,Stephen Elliott,0,6.0,0,0,0,1,1,Cyprus
11712,Stephen Eustáquio,3,100.0,0,0,1,2,3,Canada
11713,Stephen Ireland,0,144.0,0,0,1,3,4,Cyprus
11714,Stephen Keshi,3,383.0,0,1,2,6,8,Ethiopia
11715,Stephen Malcolm,0,84.0,0,0,1,0,1,Jamaica
11716,Stephen McManus,0,167.0,0,0,2,0,2,Scotland
11717,Stephen O'Donnell,0,59.0,1,0,0,1,1,Scotland
11718,Stephen Ward,0,32.0,0,0,1,0,1,Republic of Ireland
11719,Stephen Wellman,0,74.0,0,0,1,0,1,Malta
11720,Stern John,3,1339.0,0,0,15,8,23,Trinidad and Tobago
11721,Stevan Jovetić,0,1075.0,0,3,11,6,17,Montenegro
11722,Steve Archibald,1,147.0,0,0,2,0,2,Scotland
11723,Steve Borg,0,77.0,0,1,1,0,1,Malta
11724,Steve Coppell,0,22.0,0,0,1,0,1,England
11725,Steve Corica,1,93.0,0,0,2,0,2,Australia
11726,Steve Fatupua-Lecaill,2,167.0,0,0,1,1,2,Tahiti
11727,Steve Finnan,0,90.0,0,0,1,0,1,Republic of Ireland
11728,Steve Hodge,0,19.0,0,0,0,1,1,Northern Ireland
11729,Steve Horvat,1,15.0,0,0,1,0,1,Australia
11730,Steve Lomas,0,25.0,0,0,1,0,1,Northern Ireland
11731,Steve Marlet,0,108.0,0,0,2,1,3,South Korea
11732,Steve McManaman,1,92.0,0,0,2,1,3,England
11733,Steve Morison,0,28.0,0,0,1,0,1,Wales
11734,Steve Morrow,0,62.0,1,0,0,1,1,Northern Ireland
11735,Steve Mounié,0,173.0,0,0,1,2,3,Madagascar
11736,Steve Penney,0,23.0,0,0,1,0,1,Northern Ireland
11737,Steve Purdy,0,13.0,0,0,1,0,1,El Salvador
11738,Steve Ralston,0,163.0,0,0,3,0,3,United States
11739,Steve Staunton,0,150.0,0,0,1,3,4,Republic of Ireland
11740,Steve Sumner,2,884.0,0,1,14,3,17,New Zealand
11741,Steve Wooddin,2,238.0,0,0,5,4,9,New Zealand
11742,Steven Berghuis,0,74.0,0,0,1,1,2,Netherlands
11743,Steven Bergwijn,0,84.0,0,0,1,0,1,Netherlands
11744,Steven Bryce,3,253.0,0,0,2,2,4,Costa Rica
11745,Steven Davis,0,557.0,0,3,8,2,10,Northern Ireland
11746,Steven Defour,0,109.0,0,0,1,1,2,Belgium
11747,Steven Dias,0,90.0,0,0,1,0,1,India
11748,Steven Fletcher,3,594.0,0,0,5,4,9,Scotland
11749,Steven Gerrard,6,796.0,0,0,10,6,16,Germany
11750,Steven Naismith,1,431.0,0,0,5,2,7,Scotland
11751,Steven Pienaar,0,85.0,0,0,2,0,2,South Africa
11752,Steven Séance,0,81.0,0,0,1,0,1,Haiti
11753,Steven Tan,1,35.0,0,1,0,1,1,Vietnam
11754,Steven Thompson,0,31.0,0,0,0,1,1,Moldova
11755,Steven Zuber,1,256.0,0,0,3,3,6,Switzerland
11756,Stevenson Morancie,0,60.0,0,0,0,1,1,Antigua and Barbuda
11757,Stevie Chalmers,0,38.0,0,0,1,0,1,Scotland
11758,Stig Fredriksson,0,69.0,0,0,0,1,1,Malta
11759,Stig Holmqvist,0,8.0,1,0,1,0,1,Italy
11760,Stig Sundqvist,3,72.0,0,0,1,2,3,Paraguay
11761,Stig Tøfting,1,156.0,0,1,0,2,2,Wales
11762,Stiliyan Petrov,0,177.0,1,0,1,4,5,Belgium
11763,Stjepan Bobek,1,167.0,0,1,1,3,4,Yugoslavia
11764,Stjepan Lončar,0,90.0,1,0,1,0,1,Armenia
11765,Stock Dandize,0,71.0,0,0,1,0,1,Malawi
11766,Stokely Mason,0,54.0,0,0,1,0,1,Trinidad and Tobago
11767,Stophira Sunzu,1,15.0,0,0,1,0,1,Zambia
11768,Stopira,0,80.0,0,0,1,1,2,Cape Verde
11769,Stoyan Kitov,0,69.0,0,0,1,0,1,Bulgaria
11770,Stoycho Mladenov,0,247.0,0,0,2,2,4,Albania
11771,Strahinja Pavlović,1,45.0,0,0,0,1,1,Cameroon
11772,Stratos Apostolakis,0,321.0,1,2,3,2,5,Hungary
11773,Stuart Armstrong,0,112.0,0,0,1,1,2,Lithuania
11774,Stuart Dallas,0,90.0,0,0,0,1,1,Azerbaijan
11775,Stuart Elliott,0,237.0,0,0,2,1,3,Bulgaria
11776,Stuart Findlay,0,67.0,0,0,1,0,1,Scotland
11777,Stuart Holden,0,179.0,0,0,3,0,3,United States
11778,Stuart McCall,1,11.0,0,0,0,1,1,Sweden
11779,Stuart Oosthuizen,0,90.0,0,0,1,0,1,Suriname
11780,Stuart Pearce,0,113.0,0,0,2,0,2,England
11781,Stuart Pearson,0,14.0,0,0,0,1,1,Finland
11782,Ståle Solbakken,0,130.0,0,0,4,1,5,Norway
11783,Stéphane Abaul,1,70.0,0,0,0,1,1,Cuba
11784,Stéphane Auvray,1,57.0,0,0,1,0,1,Guadeloupe
11785,Stéphane Bahoken,2,181.0,0,0,2,1,3,Cameroon
11786,Stéphane Bruey,0,71.0,0,0,0,1,1,Greece
11787,Stéphane Chapuisat,2,920.0,0,0,10,7,17,San Marino
11788,Stéphane Demol,1,102.0,0,0,0,1,1,Russia
11789,Stéphane Grichting,0,84.0,0,0,1,0,1,Switzerland
11790,Stéphane Lambese,1,56.0,0,0,1,0,1,Haiti
11791,Stéphane Mbia,2,147.0,0,0,0,3,3,Tunisia
11792,Stéphane N'Guéma,0,226.0,0,0,4,0,4,Gabon
11793,Stéphane Sessègnon,0,181.0,0,1,2,2,4,Egypt
11794,Su Maozhen,1,117.0,0,0,2,1,3,China PR
11795,Suan Lam Mang,1,64.0,0,0,3,0,3,Myanmar
11796,Suat Mamat,4,106.0,0,0,1,3,4,Turkey
11797,Subait Khater,0,124.0,0,0,2,1,3,Brunei
11798,Subash Madushan,0,34.0,0,0,0,1,1,Bhutan
11799,Subhi Al-Gnimaz,2,149.0,0,0,1,2,3,Jordan
11800,Sudirman,2,137.0,0,1,3,0,3,Indonesia
11801,Sujal Shrestha,0,90.0,0,0,1,0,1,Nepal
11802,Suk Bahadur,1,85.0,0,0,1,0,1,Myanmar
11803,Suk Hyun-jun,0,100.0,0,0,1,1,2,South Korea
11804,Sukhrob Hamidov,4,255.0,0,1,4,1,5,Tajikistan
11805,Sukumar Samajpati,1,60.0,0,0,0,1,1,Hong Kong
11806,Suleiman Faris,0,38.0,0,0,0,1,1,Syria
11807,Sulejman Demollari,0,86.0,0,0,0,1,1,Lithuania
11808,Sulley Muntari,2,582.0,0,1,8,4,12,Ghana
11809,Sultan Bakhit Al-Kuwari,0,60.0,0,0,1,0,1,Qatar
11810,Sun Fucheng,0,47.0,0,0,1,0,1,China PR
11811,Sun Jihai,0,62.0,0,0,1,0,1,China PR
11812,Sun Ke,3,111.0,0,0,3,0,3,China PR
11813,Sun Xiang,0,12.0,0,0,0,1,1,Australia
11814,Sunday Ineh,0,55.0,0,0,0,1,1,Sudan
11815,Sunday Mba,2,118.0,0,0,1,1,2,Ivory Coast
11816,Sunday Oliseh,1,91.0,0,0,1,1,2,Nigeria
11817,Sunday Oyarekhua,0,28.0,0,0,0,1,1,Congo
11818,Sundayin Moriri,0,135.0,0,0,1,1,2,Uganda
11819,Sune Andersson,1,117.0,0,2,1,2,3,Sweden
11820,Sung Nak-woon,2,134.0,0,0,1,2,3,Japan
11821,Sunil Chhetri,6,628.0,0,2,5,8,13,Lebanon
11822,Supachai Jaided,1,31.0,0,0,1,0,1,Thailand
11823,Supachok Sarachat,0,126.0,0,0,0,2,2,Indonesia
11824,Supakit Meelarpkit,1,140.0,1,0,1,1,2,Thailand
11825,Suphanat Mueanta,0,54.0,0,0,0,1,1,United Arab Emirates
11826,Surachai Jirasirichote,0,83.0,0,0,1,0,1,Thailand
11827,Suree Sukha,0,39.0,0,0,0,1,1,Macau
11828,Suriamurthy Rajagopal,0,70.0,0,0,1,0,1,Singapore
11829,Surprise Moriri,0,33.0,0,0,1,0,1,South Africa
11830,Sutche Wambo,0,85.0,0,0,1,0,1,Burundi
11831,Sutee Suksomkit,1,128.0,0,1,3,1,4,Thailand
11832,Svein Mathisen,0,79.0,0,0,0,1,1,Switzerland
11833,Sven Andersson,0,79.0,0,0,1,0,1,Sweden
11834,Sven Jacobsson,1,19.0,1,0,1,0,1,Hungary
11835,Sven Jonasson,3,153.0,0,1,1,3,4,Argentina
11836,Sven Otto Birkeland,0,46.0,0,0,1,0,1,Norway
11837,Sverre Brandhaug,0,64.0,0,0,0,1,1,Cyprus
11838,Svetoslav Todorov,0,161.0,0,1,2,0,2,Bulgaria
11839,Syafiq Ahmad,0,66.0,0,0,1,1,2,Indonesia
11840,Syam Ben Youssef,0,51.0,0,0,1,0,1,Tunisia
11841,Syarhey Herasimets,0,310.0,0,1,2,3,5,Belarus
11842,Syarhey Kislyak,0,86.0,0,0,0,1,1,France
11843,Syd Bartlett,0,36.0,0,0,1,0,1,Jamaica
11844,Sydney Urikhob,0,169.0,0,0,1,1,2,Djibouti
11845,Sylvain Booene,1,42.0,0,0,0,1,1,Solomon Islands
11846,Sylvain Graglia,0,144.0,0,0,0,2,2,Papua New Guinea
11847,Sylvain Wiltord,3,735.0,0,0,11,4,15,France
11848,Sylvio Pirillo,6,289.0,0,0,6,0,6,Brazil
11849,Sylwester Czereszewski,0,63.0,0,0,0,2,2,Bulgaria
11850,Syriakata Hassan,1,82.0,0,0,0,1,1,Sudan
11851,Szabolcs Huszti,0,188.0,0,2,1,2,3,Iceland
11852,Szilárd Devecseri,0,65.0,1,0,1,0,1,Netherlands
11853,Szilárd Németh,0,499.0,0,0,10,3,13,Slovakia
11854,Sándor Kiss,0,57.0,0,0,1,0,1,Hungary
11855,Sándor Kocsis,11,603.0,0,0,5,6,11,Hungary
11856,Sándor Müller,0,65.0,0,1,0,1,1,Switzerland
11857,Sándor Pintér,0,52.0,0,0,2,0,2,Hungary
11858,Sándor Schwartz,0,38.0,0,0,1,0,1,Romania
11859,Sándor Torghelle,0,238.0,0,0,3,3,6,Hungary
11860,Sándor Zombori,1,63.0,0,0,1,1,2,Hungary
11861,Sándor Zámbó,0,83.0,0,0,2,0,2,Hungary
11862,Sávio Bortolini Pimentel,2,94.0,0,0,1,1,2,Brazil
11863,Séamus Coleman,0,56.0,0,0,1,0,1,Republic of Ireland
11864,Sébastien Fournier,0,107.0,0,0,1,1,2,Belarus
11865,Sébastien Haller,1,74.0,0,1,3,0,3,Ivory Coast
11866,Sébastien Siani,1,61.0,0,0,1,0,1,Cameroon
11867,Sébastien Thill,0,168.0,0,0,1,1,2,Luxembourg
11868,Sébastien Vorbe,1,61.0,0,0,1,0,1,Haiti
11869,Sékou Bamba,0,169.0,0,0,2,0,2,Ivory Coast
11870,Sékou Dramé,0,16.0,0,0,1,0,1,Guinea
11871,Sérgio Conceição,4,450.0,0,0,6,3,9,Portugal
11872,Séïdath Tchomogo,0,85.0,0,0,0,3,3,Cameroon
11873,Símun Samuelsen,0,90.0,0,0,0,1,1,Israel
11874,Sócrates,4,408.0,0,3,5,5,10,Argentina
11875,Sølvi Vatnhamar,0,62.0,0,0,0,1,1,Israel
11876,Søren Busk,0,76.0,0,0,1,0,1,Denmark
11877,Søren Frederiksen,0,58.0,0,0,1,0,1,Denmark
11878,Søren Larsen,0,434.0,0,0,7,3,10,Denmark
11879,Søren Lerby,2,348.0,0,1,5,3,8,Denmark
11880,Súni Olsen,0,73.0,1,0,3,0,3,Faroe Islands
11881,Süleýman Muhadow,0,67.0,0,0,1,0,1,Turkmenistan
11882,Sławomir Peszko,0,26.0,0,0,0,1,1,Republic of Ireland
11883,T. Tapunuu,1,10.0,0,0,1,0,1,Samoa
11884,Taavi Rähn,0,33.0,1,0,1,0,1,England
11885,Tab Ramos,0,151.0,0,0,2,0,2,United States
11886,Tabania Ametepé,0,55.0,0,0,0,1,1,Guinea
11887,Tadanari Lee,1,109.0,0,0,0,1,1,Australia
11888,Tadas Kijanskas,0,110.0,1,0,1,1,2,Lithuania
11889,Tadeusz Kraus,0,217.0,0,0,2,2,4,Czechoslovakia
11890,Tadjou Salou,0,163.0,0,1,2,0,2,Togo
11891,Tafari Smith,0,48.0,1,0,1,0,1,Panama
11892,Taha Basry,3,159.0,0,0,4,0,4,Egypt
11893,Taha Yassine Khenissi,2,109.0,0,0,0,2,2,Zimbabwe
11894,Tahar Chaïbi,1,102.0,0,0,3,0,3,Tunisia
11895,Tahar Chérif El-Ouazzani,0,81.0,0,0,1,0,1,Algeria
11896,Tahar El Khalej,0,42.0,0,0,1,0,1,Morocco
11897,Taher Abouzeid,2,361.0,0,0,4,3,7,Cameroon
11898,Tahir Agha,1,12.0,0,0,0,1,1,Yemen
11899,Taisir Al-Jassim,3,427.0,0,0,6,2,8,Saudi Arabia
11900,Taiwo Awoniyi,1,45.0,0,0,1,0,1,Nigeria
11901,Tajon Buchanan,1,231.0,0,0,3,1,4,Mexico
11902,Tak Yong-Bin,0,4.0,0,0,0,1,1,Hong Kong
11903,Takashi Fukunishi,1,252.0,0,0,1,4,5,Japan
11904,Takashi Inui,2,86.0,0,0,1,1,2,Japan
11905,Takashi Mizunuma,0,175.0,0,0,3,0,3,Japan
11906,Takashi Usami,1,88.0,0,0,0,1,1,Syria
11907,Takayuki Suzuki,1,297.0,0,0,5,2,7,Japan
11908,Takehiro Tomiyasu,1,20.0,0,0,1,0,1,Japan
11909,Takhirdjon Mouminov,0,108.0,0,0,2,1,3,Tajikistan
11910,Takis Antoniou,0,13.0,0,0,1,0,1,Cyprus
11911,Takis Mavris,0,47.0,0,0,1,0,1,Cyprus
11912,Takis Nikoloudis,0,65.0,0,0,3,0,3,Greece
11913,Takuma Asano,1,448.0,0,0,3,3,6,Thailand
11914,Takumi Horiike,1,54.0,0,0,1,1,2,Japan
11915,Takumi Minamino,1,425.0,0,1,7,4,11,Japan
11916,Takuya Takagi,9,861.0,0,0,8,8,16,Japan
11917,Tal Banin,0,203.0,0,3,4,1,5,Israel
11918,Tal Ben Haim,0,266.0,0,1,2,4,6,Israel
11919,Tala Luvu,1,62.0,1,0,0,1,1,American Samoa
11920,Talal Al-Bloushi,0,86.0,0,0,1,0,1,Qatar
11921,Talal Al-Meshal,3,836.0,0,0,13,4,17,Kuwait
11922,Talal El Karkouri,1,252.0,0,0,3,1,4,Morocco
11923,Talal Yousef,2,304.0,0,0,3,3,6,Bahrain
11924,Tam Siu Wai,0,13.0,0,0,0,1,1,Lebanon
11925,Tama Fasavalu,0,83.0,0,0,2,0,2,Samoa
11926,Tamarley Thomas,0,263.0,0,0,4,2,6,Antigua and Barbuda
11927,Tamer Abdel Hamid,1,58.0,0,0,0,1,1,Zimbabwe
11928,Tamer Haj Mohamad,0,13.0,0,0,0,1,1,Iran
11929,Tamer Seyam,3,264.0,0,2,3,2,5,Malaysia
11930,Tamirlan Kozubaev,0,83.0,0,0,1,0,1,Kyrgyzstan
11931,Tamkin Khalilzade,0,72.0,0,0,1,0,1,Azerbaijan
11932,Tammy Abraham,0,221.0,0,0,1,2,3,England
11933,Tamás Hajnal,0,74.0,0,0,2,1,3,Hungary
11934,Tamás Kádár,0,6.0,0,0,1,0,1,Hungary
11935,Tamás Preszeller,0,88.0,0,0,1,0,1,Hungary
11936,Tamás Priskin,0,166.0,0,0,3,1,4,Hungary
11937,Tan Chun Lok,0,16.0,0,0,0,1,1,Cambodia
11938,Tan Long,1,79.0,0,0,1,0,1,China PR
11939,Tana Chanabut,0,139.0,0,0,1,1,2,Thailand
11940,Tanaboon Kesarat,0,84.0,1,0,0,1,1,Thailand
11941,Tanat Nusserbayev,0,19.0,0,0,0,1,1,Ukraine
11942,Tang Hung Cheong,0,65.0,0,0,1,0,1,Hong Kong
11943,Tang Yaodong,1,116.0,0,0,1,1,2,Thailand
11944,Tang Yee Kit,0,10.0,0,0,1,0,1,Hong Kong
11945,Tanju Çolak,0,188.0,0,0,2,2,4,Austria
11946,Taoufik Herichi,0,121.0,0,0,0,3,3,Benin
11947,Tapiwa Gadibolae,0,14.0,0,0,1,0,1,Botswana
11948,Taqi Mubarak,0,127.0,0,0,3,1,4,Oman
11949,Tarak Dhiab,0,100.0,0,0,1,1,2,Morocco
11950,Tarcisio Burgnich,1,98.0,0,0,0,1,1,Germany
11951,Tarcisio Rodríguez Viquez,0,55.0,0,0,1,0,1,Costa Rica
11952,Tarek El Ali,0,64.0,0,0,1,0,1,Lebanon
11953,Tarek El-Said,0,350.0,0,0,5,0,5,Egypt
11954,Tarek Jabban,0,115.0,0,0,3,0,3,Syria
11955,Tarek Lazizi,0,84.0,0,0,0,1,1,South Africa
11956,Tarek Mostafa,1,13.0,0,0,0,1,1,South Africa
11957,Tareq Ahmed,0,90.0,0,0,1,0,1,United Arab Emirates
11958,Tareq Khattab,1,43.0,0,0,1,0,1,Jordan
11959,Tarik El Taib,0,108.0,0,0,2,0,2,Libya
11960,Tarik Elyounoussi,0,193.0,0,1,3,1,4,Cyprus
11961,Tarik Sektioui,1,48.0,0,1,0,2,2,Namibia
11962,Tarik Tissoudali,0,121.0,0,0,1,1,2,DR Congo
11963,Tariku Ingdawerk,0,60.0,0,0,2,1,3,Ethiopia
11964,Tariq Abdullah Kassim,0,75.0,0,0,0,1,1,Bahrain
11965,Tarlan Ahmadov,0,33.0,1,0,0,1,1,Azerbaijan
11966,Tarmo Kink,0,143.0,0,0,1,2,3,Serbia
11967,Tasos Mitropoulos,0,224.0,0,0,3,2,5,Poland
11968,Tatsuhiko Kubo,0,102.0,0,0,2,0,2,Japan
11969,Tatsuya Tanaka,0,19.0,0,0,0,1,1,Qatar
11970,Tauhiti Keck,0,90.0,0,0,1,0,1,Tahiti
11971,Tay Peng Kee,1,53.0,0,0,1,0,1,Singapore
11972,Taye Taiwo,1,85.0,0,0,1,0,1,Nigeria
11973,Tayfun Korkut,0,2.0,0,0,1,0,1,Turkey
11974,Tayfur Havutçu,0,408.0,0,2,1,5,6,Turkey
11975,Taylor Saghabi,1,189.0,0,0,1,3,4,Tonga
11976,Taylor Twellman,0,130.0,0,0,2,0,2,United States
11977,Taysir Amer,1,166.0,0,0,1,1,2,Palestine
11978,Tchiressoua Guel,4,121.0,0,1,4,1,5,Ivory Coast
11979,Teafore Bennett,1,80.0,0,0,1,0,1,Jamaica
11980,Teaonui Tehau,5,403.0,0,0,4,3,7,Samoa
11981,Teboho Masia,0,65.0,0,0,1,0,1,Lesotho
11982,Teboho Mokoena,1,134.0,0,0,1,2,3,Paraguay
11983,Ted MacDougall,0,61.0,0,0,1,0,1,Scotland
11984,Ted Robledo,0,16.0,0,0,1,0,1,Chile
11985,Teddy Sheringham,0,328.0,0,0,4,2,6,England
11986,Tedj Bensaoula,4,402.0,0,0,7,2,9,Algeria
11987,Teemu Pukki,1,1153.0,0,4,11,9,20,Spain
11988,Teemu Tainio,0,181.0,0,0,1,3,4,Albania
11989,Teerasil Dangda,1,336.0,0,1,7,4,11,Thailand
11990,Teeratep Winothai,0,122.0,0,1,2,1,3,Thailand
11991,Teet Allas,0,22.0,0,0,1,0,1,Estonia
11992,Teitur Gestsson,0,34.0,1,0,0,1,1,Faroe Islands
11993,Teitur Thordarson,0,33.0,0,0,1,0,1,Iceland
11994,Teitur Þórðarson,0,80.0,0,0,0,1,1,Turkey
11995,Tejinder Kumar,0,68.0,0,0,0,1,1,Lebanon
11996,Tekalinge Kassahun,0,40.0,0,0,1,0,1,Ethiopia
11997,Tekeste Gebremedhin,0,30.0,0,0,0,1,1,Tanzania
11998,Telinho,0,10.0,0,0,0,1,1,Mauritius
11999,Telmo Zarra,4,342.0,0,0,4,3,7,Spain
12000,Telésforo Báez,0,44.0,0,0,0,1,1,Argentina
12001,Temirlan Yerlanov,0,34.0,0,0,1,0,1,Kazakhstan
12002,Temur Ketsbaia,0,343.0,0,0,5,4,9,Georgia
12003,Tenant Chilumba,1,87.0,0,0,1,0,1,Zambia
12004,Tendai Ndoro,1,58.0,0,0,1,0,1,Zimbabwe
12005,Tenema Ndiaye,0,68.0,0,0,0,1,1,Ghana
12006,Tengiz Sulakvelidze,0,44.0,0,0,0,1,1,Iceland
12007,Teodor Țarălungă,0,72.0,0,0,0,1,1,Albania
12008,Teodoro Fernández,7,550.0,0,1,9,6,15,Peru
12009,Teppo Heikkinen,0,54.0,0,0,1,0,1,Finland
12010,Terence Groothusen,1,45.0,0,0,0,1,1,Cayman Islands
12011,Terence Scerri,0,71.0,0,0,1,0,1,Malta
12012,Terence Vancooten,2,48.0,1,0,1,1,2,Guyana
12013,Terio Vakatawa,0,90.0,0,0,0,1,1,New Zealand
12014,Terrence Tisdell,0,18.0,0,1,1,0,1,Liberia
12015,Terry Butcher,0,80.0,0,0,0,1,1,Luxembourg
12016,Terry Conroy,0,110.0,0,0,2,0,2,Republic of Ireland
12017,Terry Harkin,0,123.0,0,0,0,2,2,Turkey
12018,Terry Hennessey,0,65.0,1,0,1,0,1,England
12019,Terry McDermott,0,170.0,0,0,2,1,3,England
12020,Terry Medwin,1,95.0,0,0,0,2,2,Hungary
12021,Terry Neill,0,62.0,0,0,1,0,1,Northern Ireland
12022,Terry Yorath,0,75.0,0,0,1,0,1,Wales
12023,Teruki Miyamoto,1,38.0,0,0,0,2,2,South Korea
12024,Tes Sean,1,59.0,0,0,1,0,1,Cambodia
12025,Tesfalem Tekle,0,35.0,0,0,1,0,1,Eritrea
12026,Tesfaye Tafese,0,47.0,0,0,1,0,1,Ethiopia
12027,Tesho Akindele,0,4.0,0,0,1,0,1,Canada
12028,Teshome Getu,0,81.0,0,1,1,0,1,Ethiopia
12029,Tesourinha,1,380.0,0,1,7,1,8,Bolivia
12030,Tetahio Auraa,1,65.0,0,0,1,0,1,Tahiti
12031,Teteh Bangura,0,25.0,0,0,0,1,1,Equatorial Guinea
12032,Tetsuji Hashiratani,0,38.0,0,0,2,0,2,Japan
12033,Teu Fakava,1,86.0,0,0,0,1,1,American Samoa
12034,Teuvo Moilanen,0,90.0,1,0,0,1,1,Finland
12035,Teva Zaveroni,2,92.0,0,0,1,1,2,Tahiti
12036,Tevaughn Harriette,0,106.0,0,0,2,0,2,Antigua and Barbuda
12037,Tevin Slater,0,318.0,0,0,2,3,5,Saint Vincent and the Grenadines
12038,Tevita Waranaivalu,1,12.0,0,0,1,0,1,Fiji
12039,Teófilo Aguilar,0,62.0,0,0,0,1,1,Chile
12040,Teófilo Cubillas,12,861.0,0,2,6,9,15,Peru
12041,Teófilo Gutiérrez,1,534.0,0,0,8,1,9,Colombia
12042,Tha'er Bawab,0,176.0,0,0,0,2,2,Turkmenistan
12043,Thabo Matlaba,0,33.0,0,0,1,0,1,South Africa
12044,Thabo Mngomeni,1,48.0,0,0,1,0,1,South Africa
12045,Thadée Cisowski,0,390.0,0,0,7,2,9,France
12046,Thamsanqa Gabuza,0,20.0,0,0,0,1,1,Angola
12047,Thamsanqa Mkhize,0,38.0,1,0,0,1,1,South Africa
12048,Thanasis Bembis,0,52.0,0,0,1,0,1,Greece
12049,Thanis Areesngarkul,1,132.0,0,0,1,1,2,Thailand
12050,Thapelo Tale,0,16.0,0,0,0,1,1,Burundi
12051,Thasmbiayah Pathmanathan,0,87.0,0,0,0,1,1,Hong Kong
12052,Thawatchai Damrong-Ongtrakul,1,84.0,0,0,1,0,1,Thailand
12053,Theerathon Bunmathan,0,215.0,0,2,1,2,3,Thailand
12054,Themba Zwane,0,34.0,0,0,1,0,1,South Africa
12055,Thembinkosi Fanteni,0,62.0,0,0,1,0,1,South Africa
12056,Thembinkosi Lorch,0,85.0,0,0,0,1,1,Egypt
12057,Themistoklis Nikolaidis,0,69.0,0,0,0,1,1,England
12058,Themistoklis Tzimopoulos,1,16.0,0,0,1,0,1,New Zealand
12059,Theo Corbeanu,2,170.0,0,0,2,0,2,Canada
12060,Theo Laseroms,0,64.0,0,0,0,1,1,Switzerland
12061,Theo Pahlplatz,0,185.0,0,0,3,0,3,Netherlands
12062,Theo Walcott,1,422.0,0,0,1,6,7,Croatia
12063,Theo de Jong,1,158.0,0,0,1,1,2,Netherlands
12064,Theodor Gebre Selassie,0,96.0,0,0,1,2,3,Czech Republic
12065,Theodor Wagner,0,327.0,0,0,3,3,6,Austria
12066,Theodore Filomina,0,124.0,0,0,2,0,2,Aruba
12067,Theodore Whitmore,2,339.0,0,0,5,4,9,Suriname
12068,Theodoros Zagorakis,0,128.0,2,0,2,1,3,Greece
12069,Theofanis Gekas,1,952.0,0,1,12,7,19,Greece
12070,Therdsak Chaiman,2,206.0,0,0,3,0,3,Thailand
12071,Theódór Elmar Bjarnason,0,42.0,0,0,1,0,1,Iceland
12072,Thiago Alcântara,0,27.0,0,0,1,0,1,Spain
12073,Thiago Cionek,1,37.0,1,0,0,1,1,Poland
12074,Thiago Motta,0,73.0,0,0,0,1,1,Slovenia
12075,Thiago Silva,2,83.0,0,0,2,1,3,Brazil
12076,Thierno Youm,0,67.0,0,0,0,1,1,Egypt
12077,Thierry Bin,0,29.0,0,0,0,1,1,Macau
12078,Thierry Fondelot,1,86.0,0,0,0,1,1,Canada
12079,Thierry Henry,9,1605.0,0,2,21,13,34,France
12080,Thierry Issiémou,0,73.0,0,0,2,0,2,Gabon
12081,Thierry Tinmar,1,59.0,0,1,0,1,1,Costa Rica
12082,Thievy Bifouma,2,314.0,0,0,3,3,6,Equatorial Guinea
12083,Thitipan Puangchan,0,41.0,0,0,0,1,1,United Arab Emirates
12084,Thomas Beck,0,368.0,0,0,5,0,5,Liechtenstein
12085,Thomas Berthold,0,8.0,0,0,0,1,1,Czechoslovakia
12086,Thomas Bickel,0,125.0,0,0,3,1,4,Switzerland
12087,Thomas Buffel,0,181.0,0,0,3,0,3,Belgium
12088,Thomas Christiansen,0,86.0,0,0,1,0,1,Spain
12089,Thomas Delaney,1,334.0,0,0,2,5,7,Denmark
12090,Thomas Doll,0,187.0,0,0,1,2,3,Iceland
12091,Thomas Dooley,0,127.0,0,0,2,0,2,United States
12092,Thomas Elliot,0,72.0,0,0,1,0,1,Cayman Islands
12093,Thomas Flögel,0,95.0,0,0,1,1,2,Liechtenstein
12094,Thomas Foket,0,76.0,0,0,0,1,1,Estonia
12095,Thomas Fontaine,0,45.0,0,0,0,1,1,Tanzania
12096,Thomas Gravesen,0,169.0,0,0,2,2,4,Denmark
12097,Thomas Helmer,0,82.0,0,0,2,0,2,Germany
12098,Thomas Helveg,1,76.0,0,0,0,1,1,Nigeria
12099,Thomas Hitzlsperger,0,338.0,0,0,2,3,5,San Marino
12100,Thomas Häßler,1,411.0,0,0,4,4,8,Germany
12101,Thomas Kahlenberg,0,251.0,0,0,3,1,4,Denmark
12102,Thomas Larsson,0,38.0,0,0,0,1,1,Portugal
12103,Thomas Lemar,0,161.0,0,0,2,0,2,France
12104,Thomas Linke,1,73.0,0,0,1,0,1,Germany
12105,Thomas Mavros,0,337.0,0,2,6,1,7,Greece
12106,Thomas Meunier,1,249.0,0,0,5,3,8,Belgium
12107,Thomas Müller,9,1547.0,0,2,20,14,34,Germany
12108,Thomas Nordahl,0,108.0,0,0,2,1,3,Norway
12109,Thomas Parits,0,279.0,0,0,5,0,5,Austria
12110,Thomas Partey,1,359.0,0,0,2,5,7,Ghana
12111,Thomas Sjöberg,1,379.0,0,0,2,5,7,Norway
12112,Thomas Sowunmi,0,55.0,0,0,1,0,1,Hungary
12113,Thomas Strunz,0,44.0,0,0,0,1,1,Bulgaria
12114,Thomas Sunesson,0,150.0,0,0,2,1,3,Italy
12115,Thomas Ulimwengu,0,103.0,0,0,3,0,3,Tanzania
12116,Thomas Vermaelen,0,24.0,0,0,0,1,1,Scotland
12117,Thomas Vulivuli,1,24.0,0,0,1,0,1,Fiji
12118,Thomaz Soares da Silva,0,136.0,0,0,2,0,2,Brazil
12119,Thompson Oliha,0,20.0,0,0,1,0,1,Nigeria
12120,Thompson Usiyan,2,175.0,0,0,5,0,5,Nigeria
12121,Thorgan Hazard,1,270.0,0,0,4,2,6,Belgium
12122,Thorstein Helstad,0,229.0,0,0,2,2,4,Wales
12123,Thrizen Leader,0,117.0,1,0,1,1,2,Saint Kitts and Nevis
12124,Thulani Hlatshwayo,1,67.0,1,0,1,0,1,Algeria
12125,Thuso Phala,1,51.0,0,0,0,1,1,Algeria
12126,Thuwein Ali,0,242.0,0,0,2,1,3,Kenya
12127,Thuwein Waziri,2,145.0,0,0,0,2,2,Egypt
12128,Théo Hernandez,1,5.0,0,0,1,0,1,France
12129,Théo Malget,0,71.0,0,0,0,2,2,Hungary
12130,Théodore Nzue Nguema,0,246.0,0,0,4,1,5,Gabon
12131,Théophile Abega,3,220.0,0,0,4,0,4,Cameroon
12132,Théophile Speicher,0,47.0,0,0,1,0,1,Luxembourg
12133,Tia Koffi,0,27.0,0,0,1,0,1,Ivory Coast
12134,Tiago Mendes,2,154.0,0,0,2,1,3,Serbia
12135,Tiberio Godoy,3,95.0,0,0,0,3,3,Chile
12136,Tiberiu Ghioane,0,81.0,0,0,0,1,1,Luxembourg
12137,Tibor Jančula,1,309.0,0,0,4,2,6,Azerbaijan
12138,Tibor Nyilasi,2,778.0,0,0,17,3,20,Hungary
12139,Tibor Vigh,0,92.0,0,0,2,0,2,Canada
12140,Tibor Wollek,0,78.0,0,0,1,0,1,Hungary
12141,Tibou Bangoura,0,61.0,0,0,1,0,1,Guinea
12142,Tico-Tico,1,211.0,0,0,4,1,5,Tunisia
12143,Tigran Barseghyan,0,325.0,0,1,3,2,5,Armenia
12144,Tigran Yesayan,0,220.0,0,0,2,1,3,Armenia
12145,Tihomir Ognjanov,1,84.0,0,0,0,1,1,Switzerland
12146,Tijan Jaiteh,0,106.0,0,1,1,1,2,Gambia
12147,Tijani Babangida,1,162.0,0,0,5,0,5,Nigeria
12148,Tijani Belaid,0,38.0,0,0,1,0,1,Tunisia
12149,Tim Bredbury,0,54.0,0,0,1,1,2,Hong Kong
12150,Tim Cahill,9,1865.0,0,0,26,10,36,Australia
12151,Tim Matavž,0,347.0,0,0,6,2,8,Slovenia
12152,Tim Payne,0,91.0,0,0,0,2,2,Solomon Islands
12153,Tim Stevens,0,80.0,0,0,1,0,1,New Zealand
12154,Timmy Simons,0,203.0,0,6,4,2,6,San Marino
12155,Timo Rahja,0,19.0,0,0,2,0,2,Finland
12156,Timo Werner,4,739.0,0,0,7,6,13,Germany
12157,Timofei Kalachev,0,528.0,0,0,6,4,10,Belarus
12158,Timote Maamaaloa,1,26.0,0,0,1,0,1,Tonga
12159,Timote Moleni,0,87.0,0,0,2,0,2,Tonga
12160,Timothy Batabaire,0,19.0,0,0,1,0,1,Uganda
12161,Timothy Castagne,0,104.0,0,0,2,0,2,Belgium
12162,Timothy Mwitwa,0,68.0,0,0,1,0,1,Zambia
12163,Timothy Weah,1,47.0,0,0,1,1,2,Jamaica
12164,Timur Kapadze,1,245.0,0,0,4,2,6,Malaysia
12165,Tinashe Nengomasha,0,79.0,0,0,0,1,1,Rwanda
12166,Tinol Christie,1,1.0,0,0,1,0,1,New Zealand
12167,Tishan Hanley,0,68.0,0,0,1,0,1,Saint Kitts and Nevis
12168,Tita,0,252.0,0,0,5,0,5,Brazil
12169,Titi Camara,2,615.0,0,0,5,6,11,Guinea
12170,Tito Montaño,0,45.0,0,0,0,1,1,Peru
12171,Titus Buberník,0,168.0,0,0,5,0,5,Czechoslovakia
12172,Titus Elva,0,209.0,0,0,2,1,3,British Virgin Islands
12173,Titus Mulama,1,103.0,0,0,2,0,2,Kenya
12174,Titus Ozon,0,78.0,0,0,0,1,1,Greece
12175,Tivadar Monostori,0,21.0,0,0,1,0,1,Hungary
12176,Tjay De Barr,0,71.0,0,1,0,1,1,Latvia
12177,Tobias Hysén,0,164.0,0,0,2,1,3,San Marino
12178,Toby Alderweireld,1,145.0,0,0,2,2,4,Hungary
12179,Todi Jónsson,0,367.0,0,0,3,4,7,Faroe Islands
12180,Todor Diev,0,240.0,0,0,5,0,5,Bulgaria
12181,Todor Kolev,1,89.0,0,0,1,0,1,Bulgaria
12182,Todor Nedelev,0,198.0,0,1,3,0,3,Bulgaria
12183,Todor Veselinović,3,222.0,0,0,0,4,4,Greece
12184,Togbe Dovi-Akon,0,87.0,0,0,1,0,1,Togo
12185,Tokelo Rantie,0,58.0,0,0,1,2,3,South Africa
12186,Tokhirjon Muminov,1,13.0,0,0,1,0,1,Tajikistan
12187,Tokia Russell,0,34.0,0,0,1,0,1,Bermuda
12188,Tol Kimchi,0,93.0,0,0,0,2,2,Thailand
12189,Tolga Seyhan,0,12.0,0,0,0,1,1,Georgia
12190,Tolutau Vane,0,29.0,0,0,1,0,1,Tonga
12191,Tom Boyd,1,99.0,1,0,2,0,2,Scotland
12192,Tom Finney,2,152.0,0,1,2,0,2,England
12193,Tom Florie,1,45.0,0,0,0,1,1,Belgium
12194,Tom Høgli,0,152.0,0,0,1,1,2,Norway
12195,Tom Lawrence,0,49.0,0,0,0,1,1,Georgia
12196,Tom Lund,0,365.0,0,0,6,2,8,Norway
12197,Tom McColl,3,194.0,0,0,1,3,4,Japan
12198,Tom McCulloch,0,86.0,0,0,0,1,1,Solomon Islands
12199,Tom Rodríguez,0,16.0,0,0,1,0,1,Ecuador
12200,Tom Rogic,2,463.0,0,0,9,0,9,Australia
12201,Tom Sundby,0,164.0,0,0,1,2,3,Norway
12202,Tom Søndergaard,0,92.0,0,0,1,1,2,Denmark
12203,Tom Turesson,1,231.0,0,0,3,1,4,Sweden
12204,Tomas Brolin,4,590.0,0,3,10,2,12,Brazil
12205,Tomas Danilevičius,0,418.0,0,2,6,3,9,Lithuania
12206,Tomas Jun,0,6.0,0,0,0,1,1,Finland
12207,Tomas Ramelis,0,107.0,0,0,0,2,2,Estonia
12208,Tomas Ražanauskas,0,332.0,0,2,2,3,5,Liechtenstein
12209,Tomas Žiukas,0,51.0,0,0,1,0,1,Lithuania
12210,Tomasz Frankowski,0,376.0,0,0,3,4,7,Austria
12211,Tomasz Hajto,0,15.0,0,0,1,0,1,Poland
12212,Tomasz Iwan,0,178.0,0,0,1,2,3,Bulgaria
12213,Tomasz Kędziora,0,50.0,0,0,1,0,1,Poland
12214,Tomasz Kłos,0,96.0,0,0,0,2,2,Latvia
12215,Tomasz Radzinski,1,215.0,0,0,3,1,4,Brazil
12216,Tomasz Wałdoch,0,33.0,0,0,1,0,1,Poland
12217,Tomasz Wieszczycki,0,58.0,0,0,1,0,1,Poland
12218,Tome Faisi,0,77.0,1,0,0,1,1,Solomon Islands
12219,Tome Pačovski,0,8.0,1,0,0,1,1,North Macedonia
12220,Tomer Hemed,0,569.0,0,2,6,7,13,Croatia
12221,Tomi Juric,1,373.0,0,0,6,1,7,Australia
12222,Tomislav Kaloperović,0,42.0,0,1,1,0,1,Yugoslavia
12223,Tomislav Knez,0,75.0,0,0,0,1,1,France
12224,Tomislav Marić,0,70.0,0,0,1,0,1,Croatia
12225,Tommy Carroll,0,44.0,0,1,1,0,1,Republic of Ireland
12226,Tommy Casey,0,22.0,0,0,1,0,1,Northern Ireland
12227,Tommy Coyne,0,6.0,0,0,2,0,2,Republic of Ireland
12228,Tommy Eglington,0,59.0,0,0,1,0,1,Republic of Ireland
12229,Tommy Finney,0,3.0,0,0,0,1,1,Norway
12230,Tommy Gemmell,0,76.0,0,0,1,0,1,Scotland
12231,Tommy Lindholm,0,95.0,0,1,1,1,2,Belgium
12232,Tommy Oar,0,149.0,0,0,0,2,2,Japan
12233,Tommy Ring,0,71.0,0,0,0,1,1,Switzerland
12234,Tommy Semmy,2,112.0,0,0,2,1,3,Papua New Guinea
12235,Tommy Smith,1,101.0,0,0,1,1,2,Fiji
12236,Tommy Taylor,0,303.0,0,0,6,2,8,England
12237,Tommy Troelsen,0,79.0,0,0,1,0,1,Denmark
12238,Tomokazu Myojin,2,123.0,0,0,1,1,2,Japan
12239,Tomás Balcázar,1,280.0,0,0,4,2,6,Mexico
12240,Tomás Fernández,1,57.0,0,0,1,0,1,Cuba
12241,Tomáš Galásek,0,52.0,0,0,1,0,1,Czech Republic
12242,Tomáš Holeš,1,68.0,0,0,0,1,1,Netherlands
12243,Tomáš Hübschman,0,3.0,0,0,0,1,1,Malta
12244,Tomáš Kalas,0,84.0,1,0,1,0,1,England
12245,Tomáš Necid,1,392.0,0,1,3,3,6,San Marino
12246,Tomáš Oravec,0,89.0,0,0,0,1,1,North Macedonia
12247,Tomáš Pekhart,0,142.0,0,0,1,1,2,Czech Republic
12248,Tomáš Pospíchal,1,246.0,0,0,4,0,4,Czechoslovakia
12249,Tomáš Rosický,2,848.0,0,1,8,7,15,Czech Republic
12250,Tomáš Sivok,0,105.0,0,0,1,1,2,Czech Republic
12251,Tomáš Skuhravý,6,681.0,0,1,9,4,13,Czechoslovakia
12252,Tomáš Souček,3,177.0,0,0,0,4,4,Montenegro
12253,Tomáš Řepka,0,65.0,0,0,1,0,1,Czech Republic
12254,Toni Kroos,1,666.0,0,1,7,4,11,Republic of Ireland
12255,Toni Micevski,0,114.0,0,0,1,2,3,Liechtenstein
12256,Toni Polster,1,1353.0,0,5,16,13,29,Austria
12257,Toni Šunjić,0,33.0,0,0,0,1,1,Cyprus
12258,Toninho Cerezo,1,70.0,0,0,1,0,1,Brazil
12259,Tonny van de Linden,0,22.0,0,0,0,2,2,Hungary
12260,Tony Adams,1,41.0,0,0,1,1,2,Yugoslavia
12261,Tony Cascarino,0,836.0,0,0,8,5,13,Republic of Ireland
12262,Tony Dunne,0,85.0,2,0,1,1,2,Republic of Ireland
12263,Tony Galvin,0,44.0,0,0,0,1,1,Luxembourg
12264,Tony Grealish,0,245.0,0,0,5,1,6,Denmark
12265,Tony Henderson,0,17.0,0,0,1,0,1,Australia
12266,Tony Laus,0,131.0,0,0,3,0,3,New Zealand
12267,Tony Lochhead,0,69.0,0,0,1,0,1,New Zealand
12268,Tony Mawejje,0,93.0,0,0,2,0,2,Uganda
12269,Tony Persson,0,89.0,0,0,0,1,1,Portugal
12270,Tony Popovic,1,307.0,0,0,6,0,6,Australia
12271,Tony Senechal,3,73.0,0,0,0,3,3,Vanuatu
12272,Tony Tsabedze,0,83.0,0,0,0,1,1,Djibouti
12273,Tony Vidmar,0,134.0,0,0,2,0,2,Australia
12274,Tony Woodcock,1,485.0,0,0,3,8,11,Northern Ireland
12275,Tony Yeboah,3,155.0,0,0,2,2,4,Egypt
12276,Toon Brusselers,0,80.0,0,0,1,0,1,Netherlands
12277,Topu Barman,1,83.0,0,0,1,0,1,Bangladesh
12278,Tor Egil Johansen,0,229.0,0,0,1,2,3,Norway
12279,Tor Fuglset,0,83.0,0,0,0,1,1,Bulgaria
12280,Torbjörn Jonsson,0,107.0,0,0,3,0,3,Sweden
12281,Torbjörn Nilsson,0,38.0,0,0,0,1,1,Portugal
12282,Tore André Dahlum,0,69.0,0,0,2,0,2,Norway
12283,Tore André Flo,1,585.0,0,0,2,8,10,Finland
12284,Tore Cervin,0,29.0,0,0,1,0,1,Sweden
12285,Tore Keller,1,80.0,0,0,0,1,1,Cuba
12286,Tore Reginiussen,0,4.0,0,0,1,0,1,Norway
12287,Torea,1,90.0,0,0,0,1,1,Australia
12288,Torkil Nielsen,1,61.0,0,0,1,0,1,Faroe Islands
12289,Tornike Okriashvili,1,219.0,0,2,4,3,7,Georgia
12290,Torsten Bunke,0,43.0,0,0,1,0,1,Sweden
12291,Torsten Frings,1,173.0,0,1,3,0,3,Germany
12292,Tosaint Ricketts,0,410.0,0,0,6,1,7,Puerto Rico
12293,Toshio Iwatani,0,78.0,0,0,2,0,2,Japan
12294,Toshiya Fujita,0,81.0,0,0,0,1,1,Singapore
12295,Tostão,3,472.0,0,0,8,5,13,Brazil
12296,Totchtawan Sripan,0,80.0,0,1,1,1,2,Thailand
12297,Toto Tamuz,1,106.0,0,0,1,1,2,Israel
12298,Traianos Dellas,1,105.0,0,0,1,0,1,Greece
12299,Tranquillo Barnetta,1,221.0,0,0,0,4,4,Togo
12300,Travis Nicklaw,0,100.0,1,0,2,0,2,Guam
12301,Trayon Bobb,0,69.0,0,0,0,2,2,El Salvador
12302,Tremain Paul,0,33.0,0,0,0,2,2,Canada
12303,Trent Sainsbury,1,89.0,0,0,2,1,3,Australia
12304,Tressor Moreno,3,130.0,0,2,4,2,6,Colombia
12305,Tresór Toropité,1,53.0,0,0,1,0,1,Central African Republic
12306,Trevin Caesar,0,175.0,0,0,2,0,2,Trinidad and Tobago
12307,Trevor Anderson,2,161.0,0,0,3,0,3,Northern Ireland
12308,Trevor Brooking,1,178.0,0,0,1,3,4,England
12309,Trevor Francis,2,348.0,0,0,4,4,8,England
12310,Trevor Hockey,0,85.0,0,0,1,0,1,Wales
12311,Trevor Lennen,0,90.0,1,0,1,0,1,Mexico
12312,Trevor Peters,0,38.0,0,0,1,0,1,British Virgin Islands
12313,Trifon Ivanov,0,199.0,0,0,2,3,5,Bulgaria
12314,Troy Greenidge,0,90.0,0,0,0,1,1,Antigua and Barbuda
12315,Troy Halpin,0,80.0,0,0,1,0,1,Australia
12316,Tryggvi Guðmundsson,0,336.0,0,0,4,2,6,Liechtenstein
12317,Trésor Mputu,2,339.0,0,0,4,5,9,DR Congo
12318,Trézéguet,1,141.0,0,0,2,0,2,Egypt
12319,Trải Văn Đào,1,20.0,0,0,0,1,1,South Korea
12320,Trần Minh Vương,0,90.0,0,0,0,1,1,United Arab Emirates
12321,Trần Phi Sơn,0,90.0,0,0,0,1,1,Taiwan
12322,Trần Văn Nhung,1,68.0,0,1,0,1,1,Israel
12323,Trần Văn Tổng,1,88.0,0,0,0,2,2,Hong Kong
12324,Tsepo Lekhoana,0,75.0,0,0,0,1,1,Sudan
12325,Tsepo Seturumane,0,119.0,0,0,2,1,3,Sudan
12326,Tshepiso Molwantwa,0,101.0,0,0,3,1,4,Botswana
12327,Tshepo Motlhabankwe,0,88.0,0,0,0,1,1,Malawi
12328,Tshering Dorji,0,250.0,0,1,2,2,4,Sri Lanka
12329,Tshilumba Mukendi,0,53.0,0,0,0,1,1,Cameroon
12330,Tsholola Tshinyama,0,59.0,0,0,1,0,1,DR Congo
12331,Tsoanelo Koetle,0,77.0,0,0,0,1,1,Sudan
12332,Tsukasa Shiotani,1,58.0,0,0,1,0,1,Japan
12333,Tsuneyasu Miyamoto,0,87.0,0,0,0,1,1,India
12334,Tsuyoshi Kitazawa,0,57.0,0,0,1,0,1,Japan
12335,Tsvetan Atanasov,0,29.0,0,0,1,0,1,Bulgaria
12336,Tsvetan Yonchev,0,66.0,0,0,1,0,1,Bulgaria
12337,Tueba Menayane,1,1.0,0,0,0,1,1,Cameroon
12338,Tukamin Bahari,2,179.0,0,0,1,1,2,United Arab Emirates
12339,Tuncay,1,665.0,0,0,6,6,12,Georgia
12340,Tuncay Şanlı,2,121.0,0,0,1,2,3,Turkey
12341,Tuomo Hakala,0,82.0,0,0,0,1,1,Russia
12342,Turbie Terblanche,0,85.0,0,0,1,0,1,Eswatini
12343,Turlough O'Connor,0,86.0,0,1,0,1,1,Czechoslovakia
12344,Turo Flink,0,15.0,0,0,1,0,1,Finland
12345,Tursunali Rustamov,1,112.0,0,0,0,2,2,United Arab Emirates
12346,Tutizama Tanito,0,33.0,0,0,1,0,1,Solomon Islands
12347,Txiki Begiristain,1,317.0,0,1,4,1,5,Malta
12348,Tyio Simon,0,81.0,0,0,1,0,1,Antigua and Barbuda
12349,Tyler Boyd,0,132.0,0,0,2,0,2,United States
12350,Tymerlan Huseynov,0,269.0,0,0,1,4,5,Ukraine
12351,Tyrell Burgess,0,99.0,0,0,2,0,2,Bermuda
12352,Tyrone Loran,1,42.0,0,0,1,0,1,Curaçao
12353,Tyrone Marshall,0,56.0,0,0,2,0,2,Jamaica
12354,Tyrone Mings,0,69.0,0,0,0,1,1,San Marino
12355,Tyrone White,0,55.0,0,0,1,0,1,Barbados
12356,Tyrone de la Bastide,0,78.0,1,0,1,0,1,Guatemala
12357,Témime Lahzami,0,153.0,0,0,3,0,3,Tunisia
12358,Túlio Costa,1,76.0,0,0,1,0,1,Brazil
12359,Túlio Maravilha,1,111.0,0,0,1,1,2,Brazil
12360,Tümer Metin,1,354.0,0,0,2,4,6,Liechtenstein
12361,Ubaldo Cruche,0,35.0,0,0,0,1,1,Chile
12362,Uche Okechukwu,1,18.0,0,0,1,0,1,Nigeria
12363,Ul Radike Mateiwai,1,5.0,0,0,0,1,1,Samoa
12364,Uladzimir Makowski,0,113.0,0,0,2,0,2,Belarus
12365,Ulaiasi Mateiwai,1,31.0,0,0,1,0,1,Fiji
12366,Ulaisi Seruvatu,1,43.0,0,0,0,1,1,Tahiti
12367,Ulan Konysbayev,0,55.0,0,0,0,1,1,Turkey
12368,Ulf Eriksson,0,90.0,0,0,0,1,1,Czechoslovakia
12369,Ulf Kirsten,3,879.0,0,0,9,7,16,German DR
12370,Uli Hoeneß,0,133.0,0,1,2,1,3,England
12371,Uli Stielike,0,66.0,0,0,1,0,1,Germany
12372,Ulises Ramos,1,72.0,0,0,1,0,1,Chile
12373,Ulises de la Cruz,0,130.0,0,0,1,3,4,Brazil
12374,Ulrich Kapolongo,0,76.0,0,0,0,1,1,Niger
12375,Ulrich Lepaye,0,81.0,0,0,1,0,1,Congo
12376,Ulrik Laursen,0,27.0,0,0,1,0,1,Denmark
12377,Ulrik le Fevre,0,35.0,0,0,1,0,1,Denmark
12378,Ulugbek Bakayev,3,494.0,0,1,5,3,8,Turkmenistan
12379,Umar Sadiq,1,56.0,0,0,0,1,1,Guinea-Bissau
12380,Umberto Barberis,0,172.0,0,0,2,2,4,German DR
12381,Umut Bulut,0,231.0,0,0,5,1,6,Turkey
12382,Unaloto Feao,1,88.0,0,0,0,1,1,American Samoa
12383,Uni Arge,0,354.0,0,0,5,1,6,Cyprus
12384,Upendran Choy,0,90.0,0,0,1,0,1,Indonesia
12385,Uri Malmilian,0,219.0,0,0,2,1,3,South Korea
12386,Uriel Antuna,4,172.0,0,0,4,1,5,Mexico
12387,Urmas Kirs,0,134.0,1,0,2,0,2,Ukraine
12388,Uston Nawawi,0,220.0,0,0,4,0,4,Indonesia
12389,Uwa Elderson Echiéjilé,2,105.0,0,0,0,2,2,Mali
12390,Uwe Bein,1,88.0,0,0,1,1,2,Germany
12391,Uwe Rahn,0,102.0,0,0,3,0,3,Germany
12392,Uwe Reinders,1,83.0,0,0,1,0,1,Germany
12393,Uwe Seeler,8,850.0,0,0,8,6,14,Argentina
12394,Uwe Zötzsche,0,4.0,0,1,1,0,1,German DR
12395,Uğur Boral,1,22.0,0,0,0,1,1,Germany
12396,V. P. Sathyan,1,172.0,0,1,0,2,2,Lebanon
12397,V. Sundramoorthy,3,274.0,0,0,1,3,4,North Korea
12398,Vaclavs Borduško,0,41.0,0,0,0,2,2,Lithuania
12399,Vadim Boret,0,16.0,0,0,1,0,1,Moldova
12400,Vadim Evseev,0,21.0,0,0,0,1,1,Wales
12401,Vadim Rață,0,9.0,0,0,0,1,1,France
12402,Vadim Vasilyev,0,29.0,0,1,1,1,2,Slovakia
12403,Vaggelis Panakis,0,29.0,0,0,1,0,1,Greece
12404,Vagif Javadov,0,328.0,0,0,3,2,5,Liechtenstein
12405,Vagiz Khidiyatullin,0,54.0,0,0,1,0,1,Russia
12406,Vahagn Minasyan,0,85.0,0,0,0,1,1,Bosnia and Herzegovina
12407,Vahid Amiri,0,61.0,0,0,1,0,1,Iran
12408,Vahid Halilhodžić,0,113.0,0,0,4,0,4,Yugoslavia
12409,Vahid Hashemian,0,186.0,0,0,2,2,4,Qatar
12410,Vahidin Musemić,0,344.0,0,0,5,1,6,France
12411,Vaidotas Šlekys,0,118.0,0,0,2,0,2,Lithuania
12412,Valasine Dalaphone,0,55.0,0,0,1,0,1,Laos
12413,Valdas Ivanauskas,0,293.0,0,0,5,1,6,Ukraine
12414,Valdes Pasolini,0,30.0,0,1,1,0,1,San Marino
12415,Valdet Rama,0,49.0,0,0,1,1,2,Albania
12416,Valdir Pereira,0,11.0,0,0,1,0,1,Brazil
12417,Valdomiro Vaz Franco,1,79.0,0,0,0,1,1,DR Congo
12418,Valentin Belkevich,0,97.0,0,0,2,1,3,Belarus
12419,Valentin Bubukin,2,98.0,0,0,2,0,2,Russia
12420,Valentin Ivanov,3,177.0,0,0,0,3,3,Czechoslovakia
12421,Valentin Kozmich Ivanov,8,588.0,0,0,6,5,11,Poland
12422,Valentin Mihăilă,0,50.0,0,0,1,0,1,Romania
12423,Valentin Stocker,0,270.0,0,0,3,1,4,Switzerland
12424,Valentino Lazaro,0,80.0,0,0,1,1,2,North Macedonia
12425,Valentinos Sielis,0,87.0,0,0,1,0,1,Cyprus
12426,Valentín Mendoza,0,70.0,1,0,0,1,1,Paraguay
12427,Valeri Aleksanyan,0,43.0,1,0,1,0,1,Republic of Ireland
12428,Valeri Berezovsky,0,12.0,0,0,1,0,1,Kyrgyzstan
12429,Valeri Bojinov,0,58.0,0,0,1,0,1,Bulgaria
12430,Valeri Broshin,0,20.0,0,0,0,1,1,Vietnam
12431,Valeri Domovchiyski,0,90.0,0,0,1,0,1,Bulgaria
12432,Valeri Gulyan,0,53.0,0,0,1,0,1,Turkmenistan
12433,Valeri Qazaishvili,0,245.0,0,0,4,1,5,Georgia
12434,Valeri Yablochkin,0,49.0,0,0,1,0,1,Kazakhstan
12435,Valerian Gvilia,0,38.0,0,0,1,1,2,Austria
12436,Valeriano López,2,137.0,0,0,0,2,2,Chile
12437,Valerică Găman,0,90.0,0,0,1,0,1,Romania
12438,Valerio Nasema,2,118.0,0,0,1,1,2,Fiji
12439,Valerio Nawatu,0,2.0,0,0,1,0,1,Fiji
12440,Valeriu Andronic,0,90.0,0,0,1,0,1,Moldova
12441,Valeriu Călinoiu,0,52.0,0,0,0,1,1,Bulgaria
12442,Valeriu Pogorelov,0,76.0,0,0,1,0,1,Moldova
12443,Valeriy Porkujan,4,247.0,0,0,0,4,4,Chile
12444,Valery Karpin,1,571.0,0,2,5,5,10,Russia
12445,Valery Kechinov,0,73.0,0,0,2,0,2,Russia
12446,Valery Kichin,0,77.0,1,0,2,0,2,Bangladesh
12447,Valery Maslov,0,14.0,0,0,0,1,1,Finland
12448,Valery Ondo,0,82.0,0,0,1,0,1,Gabon
12449,Valery Voronin,3,186.0,0,0,3,1,4,Russia
12450,Valon Behrami,0,86.0,0,0,1,0,1,Switzerland
12451,Valon Berisha,0,110.0,0,1,0,3,3,Finland
12452,Valter Birsa,1,297.0,0,2,4,2,6,Slovenia
12453,Valyantsin Byalkevich,0,147.0,0,0,0,3,3,Sweden
12454,Valērijs Šabala,0,385.0,0,1,4,3,7,Latvia
12455,Vampeta,0,95.0,0,0,2,0,2,Brazil
12456,Van-Dave Harmon,1,45.0,0,0,1,0,1,Liberia
12457,Vangelis Pavlidis,0,108.0,0,0,2,0,2,Greece
12458,Vaniel Sirin,0,46.0,0,0,0,1,1,United States
12459,Vanče Šikov,0,146.0,0,0,0,2,2,Andorra
12460,Vančo Micevski,0,90.0,0,0,0,1,1,Liechtenstein
12461,Vančo Trajanov,0,36.0,0,0,0,2,2,Azerbaijan
12462,Varazdat Haroyan,0,161.0,0,0,2,0,2,Armenia
12463,Vasil Bozhikov,0,95.0,0,0,1,1,2,Kosovo
12464,Vasil Mitkov,0,44.0,0,0,1,0,1,Bulgaria
12465,Vasili Baranov,0,30.0,0,0,1,0,1,Belarus
12466,Vasili Berezutski,1,164.0,0,0,3,1,4,Russia
12467,Vasili Kulkov,0,265.0,0,0,1,4,5,Luxembourg
12468,Vasilis Botinos,0,162.0,0,0,2,1,3,Portugal
12469,Vasilis Dimitriadis,0,30.0,0,1,1,0,1,Greece
12470,Vasilis Torosidis,2,419.0,1,0,5,4,9,Luxembourg
12471,Vassilios Tsiartas,0,272.0,0,1,3,2,5,Greece
12472,Vassilis Karapialis,0,40.0,0,0,1,0,1,Greece
12473,Vassos Melanarkitis,0,18.0,0,0,1,0,1,Cyprus
12474,Vasyl Rats,2,178.0,0,0,0,3,3,France
12475,Vato Arveladze,0,76.0,0,1,1,0,1,Georgia
12476,Vaughan Coveny,10,877.0,0,1,21,2,23,New Zealand
12477,Vavá,5,379.0,0,0,5,4,9,Brazil
12478,Veaceslav Sofroni,0,90.0,0,0,0,1,1,Latvia
12479,Vedad Ibišević,1,927.0,0,0,9,9,18,Greece
12480,Vedat Muriqi,0,327.0,0,2,4,3,7,Bulgaria
12481,Vedran Ćorluka,0,153.0,1,0,1,2,3,Turkey
12482,Vegard Forren,0,57.0,0,0,0,1,1,Bulgaria
12483,Veigar Páll Gunnarsson,0,100.0,0,0,2,0,2,Iceland
12484,Veli Lampi,0,65.0,1,0,1,0,1,Russia
12485,Velibor Vasović,0,112.0,0,0,2,0,2,Yugoslavia
12486,Velizar Dimitrov,0,6.0,0,0,1,0,1,Bulgaria
12487,Veliče Šumulikoski,0,90.0,0,0,1,0,1,North Macedonia
12488,Venancio García,0,13.0,0,0,1,0,1,Spain
12489,Venancio Ramos,0,150.0,0,0,2,0,2,Uruguay
12490,Ventsislav Hristov,0,87.0,0,0,0,1,1,Azerbaijan
12491,Veresa Toma,7,213.0,0,0,7,1,8,Fiji
12492,Verner Lička,0,67.0,0,0,1,0,1,Czechoslovakia
12493,Vernon De Marco,0,72.0,0,0,0,1,1,Malta
12494,Vernon Sargeant,0,66.0,0,0,2,0,2,Saint Kitts and Nevis
12495,Viacheslav Knizaev,0,90.0,0,0,0,2,2,Turkmenistan
12496,Viačeslavas Sukristovas,0,25.0,0,0,1,0,1,Lithuania
12497,Vic Bozanic,2,180.0,0,0,2,0,2,Australia
12498,Vicente Aguirre,3,221.0,0,0,3,0,3,Argentina
12499,Vicente Flores,0,88.0,0,0,1,0,1,Venezuela
12500,Vicente Guillot,0,104.0,0,0,3,0,3,Spain
12501,Vicente Matías Vuoso,0,149.0,0,0,0,3,3,Canada
12502,Vicente Rodríguez,0,138.0,0,0,1,2,3,Paraguay
12503,Vicente Sánchez,4,302.0,0,0,1,4,5,Argentina
12504,Vicente de la Mata,2,345.0,0,0,5,0,5,Argentina
12505,Vicente del Bosque,0,10.0,0,0,1,0,1,Spain
12506,Victor Agali,0,184.0,0,0,4,0,4,Nigeria
12507,Victor Covilhã,0,85.0,0,0,1,0,1,Angola
12508,Victor Diagne,0,89.0,0,0,1,0,1,Senegal
12509,Victor Ikpeba,1,176.0,0,0,3,0,3,Nigeria
12510,Victor Karpenko,0,112.0,0,0,1,2,3,Uzbekistan
12511,Victor Lemberechts,0,40.0,0,0,0,1,1,Sweden
12512,Victor Lindelöf,0,81.0,0,0,1,1,2,Sweden
12513,Victor Manuel Azucar,0,144.0,0,0,2,0,2,El Salvador
12514,Victor Mees,0,97.0,0,0,3,0,3,Belgium
12515,Victor Moreland,0,50.0,0,1,1,0,1,Northern Ireland
12516,Victor Moses,3,461.0,0,5,6,2,8,Ethiopia
12517,Victor Núñez,0,165.0,0,0,1,1,2,Grenada
12518,Victor Obinna,2,417.0,0,1,7,0,7,Nigeria
12519,Victor Osimhen,2,91.0,0,1,1,3,4,Cape Verde
12520,Victor Pițurcă,0,40.0,0,0,2,0,2,Romania
12521,Victor Pálsson,0,77.0,0,0,0,1,1,Liechtenstein
12522,Victor Wanyama,0,74.0,0,0,1,0,1,Kenya
12523,Victorien Adebayor,2,230.0,0,0,3,2,5,Djibouti
12524,Vidadi Rzayev,0,28.0,0,0,1,0,1,Azerbaijan
12525,Vidal Sanabria,1,81.0,0,0,1,0,1,Paraguay
12526,Vidar Davidsen,0,88.0,0,0,1,0,1,Norway
12527,Vidar Riseth,0,39.0,0,0,1,0,1,Norway
12528,Viera Ellong,0,24.0,0,0,0,1,1,Madagascar
12529,Vikash Dhorasoo,0,44.0,0,0,1,0,1,France
12530,Viktor Claesson,1,342.0,0,0,5,1,6,Sweden
12531,Viktor Fayzulin,0,147.0,0,0,1,2,3,Russia
12532,Viktor Kolotov,0,376.0,0,2,6,2,8,Cyprus
12533,Viktor Onopko,0,332.0,0,0,3,3,6,Russia
12534,Viktor Pasulko,1,73.0,0,0,0,1,1,England
12535,Viktor Pečovský,0,77.0,0,0,0,1,1,Bosnia and Herzegovina
12536,Viktor Ponedelnik,6,542.0,0,0,6,4,10,Czechoslovakia
12537,Viktor Skrypnyk,0,24.0,0,0,0,1,1,Slovenia
12538,Viktor Tsyhankov,0,93.0,0,0,2,1,3,Luxembourg
12539,Viktor Zubarev,0,294.0,0,0,1,3,4,Pakistan
12540,Viliami Vaitaki,1,61.0,0,0,1,0,1,Tonga
12541,Viljormur Davidsen,0,40.0,0,1,0,1,1,Romania
12542,Vilmos Kohut,1,13.0,0,0,1,0,1,Hungary
12543,Vilmos Sebők,0,304.0,0,3,6,0,6,Hungary
12544,Vilmos Vanczák,0,45.0,1,0,1,2,3,Hungary
12545,Vincent Aboubakar,5,982.0,0,5,13,4,17,Niger
12546,Vincent Candela,0,54.0,0,0,1,0,1,France
12547,Vincent Casimir,0,213.0,0,0,0,3,3,Bahamas
12548,Vincent Guérin,0,95.0,0,0,2,0,2,France
12549,Vincent Janssen,0,148.0,0,1,2,0,2,Netherlands
12550,Vincent John,0,11.0,0,0,1,0,1,Saint Vincent and the Grenadines
12551,Vincent Kompany,0,162.0,0,0,2,1,3,Belgium
12552,Vincent Kwarula,0,58.0,0,0,1,0,1,Kenya
12553,Vincent Laban,0,148.0,0,0,1,2,3,Albania
12554,Vincent Magro,0,79.0,0,0,1,0,1,Malta
12555,Vincent Mutale,1,100.0,0,0,2,0,2,Zambia
12556,Vincent Simon,0,74.0,1,0,1,1,2,Solomon Islands
12557,Vincenzo Iaquinta,2,162.0,0,1,4,0,4,Italy
12558,Vinceroy Nelson,1,42.0,0,0,1,0,1,Saint Kitts and Nevis
12559,Vinícius Júnior,1,52.0,0,0,2,0,2,Brazil
12560,Viorel Frunză,0,272.0,0,0,3,3,6,Moldova
12561,Viorel Mateianu,0,106.0,0,1,2,0,2,Romania
12562,Viorel Moldovan,3,674.0,0,0,7,9,16,Romania
12563,Virgil van Dijk,0,95.0,0,0,2,0,2,Netherlands
12564,Virgilio Ferreira,2,87.0,0,0,0,2,2,Peru
12565,Virgilio Sille,1,77.0,0,0,0,2,2,Cuba
12566,Virginijus Baltušnikas,0,110.0,0,0,2,0,2,Lithuania
12567,Virginio De Paoli,0,43.0,0,0,1,0,1,Italy
12568,Visar Musliu,0,36.0,0,0,1,0,1,North Macedonia
12569,Visay Phaphouvanin,0,185.0,0,0,3,1,4,Laos
12570,Vita Lutonadio,0,88.0,0,0,0,1,1,Morocco
12571,Vital Bulyga,0,214.0,0,0,3,1,4,Belarus
12572,Vitali Culibaba,0,77.0,1,0,0,1,1,Moldova
12573,Vitali Kutuzov,0,348.0,0,0,3,5,8,Belarus
12574,Vitali Rodionov,0,177.0,0,0,1,2,3,Andorra
12575,Vitali Sparyshev,0,55.0,0,0,1,0,1,Kazakhstan
12576,Vitali Yevstigneyev,0,77.0,0,0,0,1,1,Azerbaijan
12577,Vitalij Lux,3,197.0,0,0,4,1,5,Kyrgyzstan
12578,Vitalis Takawira,0,293.0,0,2,3,2,5,Madagascar
12579,Vitaliy Denisov,0,42.0,0,0,0,1,1,Singapore
12580,Vitaliy Khmelnytskyi,1,110.0,0,0,0,2,2,Turkey
12581,Vitaliy Kosovskyi,0,35.0,0,0,1,1,2,Ukraine
12582,Vitaliy Mandzyuk,0,80.0,0,0,0,1,1,San Marino
12583,Vitaliy Shevchenko,0,133.0,0,0,1,1,2,Cyprus
12584,Vitaly Daraselia,1,13.0,0,0,1,0,1,Russia
12585,Vitaly Lisakovich,1,157.0,0,2,3,0,3,Belarus
12586,Vitolo,0,223.0,0,0,3,1,4,Spain
12587,Vitoon Kijmongkolsak,0,90.0,0,0,1,0,1,Thailand
12588,Vitālijs Astafjevs,0,400.0,0,0,4,4,8,Northern Ireland
12589,Viv Anderson,0,143.0,0,0,1,1,2,Turkey
12590,Vivian Wickham,2,64.0,0,0,0,2,2,Vanuatu
12591,Viðar Örn Kjartansson,0,80.0,0,0,0,1,1,Andorra
12592,Vladan Lukić,0,18.0,0,0,0,1,1,Austria
12593,Vladas Douksas,3,137.0,0,0,0,3,3,Bolivia
12594,Vladica Kovačević,0,15.0,0,0,1,0,1,Yugoslavia
12595,Vladimir Ambros,0,89.0,0,0,1,0,1,Moldova
12596,Vladimir Barkaya,2,146.0,0,0,2,0,2,Russia
12597,Vladimir Bayramov,1,67.0,0,0,2,0,2,Turkmenistan
12598,Vladimir Beschastnykh,3,865.0,0,2,9,9,18,Greece
12599,Vladimir Burduli,0,85.0,0,0,0,1,1,Albania
12600,Vladimir Bystrov,0,84.0,0,0,0,2,2,North Macedonia
12601,Vladimir Chertkov,1,50.0,0,0,1,1,2,Maldives
12602,Vladimir Dvalishvili,0,79.0,0,0,0,2,2,Montenegro
12603,Vladimir Edouard,0,137.0,0,0,1,2,3,Haiti
12604,Vladimir Farrell,1,48.0,0,0,1,0,1,Montserrat
12605,Vladimir Fedotov,0,145.0,0,0,2,1,3,Russia
12606,Vladimir Gaidamașciuc,0,22.0,0,0,0,1,1,Northern Ireland
12607,Vladimir Gregorio,1,66.0,0,0,0,1,1,Montserrat
12608,Vladimir Jugović,1,146.0,0,0,0,3,3,Faroe Islands
12609,Vladimir Kokol,0,90.0,0,0,1,0,1,Slovenia
12610,Vladimir Koman,0,322.0,0,0,3,2,5,Hungary
12611,Vladimir Korytko,0,150.0,0,0,2,0,2,Belarus
12612,Vladimir Kragić,0,121.0,0,0,1,1,2,Yugoslavia
12613,Vladimir Loginov,0,120.0,0,0,1,2,3,Iraq
12614,Vladimir Maminov,0,165.0,0,2,2,1,3,Uzbekistan
12615,Vladimir Muntyan,2,199.0,0,0,2,1,3,Russia
12616,Vladimir Onishchenko,0,82.0,0,0,2,0,2,Russia
12617,Vladimir Petrović,1,318.0,0,2,1,4,5,Romania
12618,Vladimir Shishelov,1,128.0,0,0,2,0,2,Uzbekistan
12619,Vladimir Soria,0,28.0,0,0,1,0,1,Bolivia
12620,Vladimir Todorov,0,61.0,0,0,0,1,1,Hungary
12621,Vladimir Veremeyev,0,81.0,0,0,1,0,1,Russia
12622,Vladimir Voskoboinikov,0,7.0,0,0,0,1,1,Turkey
12623,Vladimiro Schettina,0,22.0,0,0,0,1,1,Chile
12624,Vladimirs Babičevs,0,67.0,0,0,0,2,2,Liechtenstein
12625,Vladimirs Kamešs,0,69.0,0,0,1,1,2,Latvia
12626,Vladimirs Koļesņičenko,0,89.0,0,0,1,0,1,Latvia
12627,Vladimír Darida,0,289.0,0,2,1,4,5,Latvia
12628,Vladimír Hagara,0,166.0,0,0,2,1,3,Denmark
12629,Vladimír Hruška,0,21.0,0,0,1,0,1,Czechoslovakia
12630,Vladimír Janočko,0,120.0,0,0,1,1,2,Slovakia
12631,Vladimír Labant,0,92.0,0,1,1,1,2,Slovakia
12632,Vladimír Táborský,0,81.0,0,0,0,1,1,Wales
12633,Vladimír Weiss,1,124.0,0,0,1,4,5,Armenia
12634,Vladimír Šmicer,9,1089.0,0,0,4,16,20,Russia
12635,Vladis-Emmerson Illoy-Ayyet,0,43.0,0,0,1,0,1,Congo
12636,Vladislao Cap,0,69.0,0,0,1,0,1,Argentina
12637,Vladislav Bogićević,1,48.0,0,0,1,1,2,Yugoslavia
12638,Vladislav Lauda,0,62.0,0,0,0,1,1,Germany
12639,Vladislav Radimov,0,8.0,0,0,1,0,1,Russia
12640,Vladislavs Gutkovskis,0,160.0,0,1,2,1,3,Latvia
12641,Vladyslav Vashchuk,0,59.0,0,0,1,0,1,Ukraine
12642,Vlastimil Bubník,0,202.0,0,0,2,2,4,Czechoslovakia
12643,Vlastimil Kopecký,1,25.0,0,0,0,1,1,Brazil
12644,Vlatko Grozdanoski,0,25.0,0,0,1,1,2,North Macedonia
12645,Vlatko Stojanovski,0,90.0,0,0,0,1,1,Austria
12646,Vojin Lazarević,0,56.0,0,0,1,0,1,Yugoslavia
12647,Vojislav Melić,1,82.0,0,0,0,1,1,Colombia
12648,Vojtech Masný,0,47.0,0,0,0,1,1,Republic of Ireland
12649,Vokhid Shodiev,1,71.0,0,0,1,0,1,Uzbekistan
12650,Volkan Yayim,0,81.0,0,0,1,0,1,Turkey
12651,Volkan Şen,1,62.0,0,0,1,1,2,Turkey
12652,Volodymyr Bezsonov,1,137.0,0,0,2,0,2,Russia
12653,Volodymyr Muntyan,0,43.0,0,0,1,0,1,Russia
12654,Volodymyr Onyshchenko,2,142.0,0,0,2,0,2,Russia
12655,Volodymyr Yezerskiy,0,20.0,0,0,0,1,1,Faroe Islands
12656,Voulani Ely,0,44.0,0,0,0,1,1,Ethiopia
12657,Vratislav Greško,0,48.0,0,0,1,0,1,Slovakia
12658,Vratislav Lokvenc,0,611.0,0,0,7,2,9,Czech Republic
12659,Vujadin Stanojković,1,5.0,0,0,0,1,1,Cyprus
12660,Vurlon Mills,0,110.0,0,0,2,0,2,Guyana
12661,Vyacheslav Amin,0,47.0,0,0,0,1,1,Syria
12662,Vyacheslav Hleb,0,90.0,0,0,0,1,1,Andorra
12663,Vyacheslav Lychkin,0,113.0,0,0,1,1,2,Hungary
12664,Vyacheslav Sukristov,0,64.0,0,0,0,1,1,Slovenia
12665,Vykintas Slivka,0,87.0,0,0,1,1,2,Lithuania
12666,Vytautas Andriuškevičius,0,28.0,0,0,1,0,1,Lithuania
12667,Václav Daněk,0,200.0,0,0,5,0,5,Czechoslovakia
12668,Václav Hovorka,2,171.0,0,0,0,2,2,Argentina
12669,Václav Kadlec,0,163.0,0,0,1,2,3,Liechtenstein
12670,Václav Mašek,1,67.0,0,0,2,0,2,Czechoslovakia
12671,Václav Němeček,0,241.0,0,1,3,2,5,Czechoslovakia
12672,Václav Pilař,2,301.0,0,0,3,2,5,Czech Republic
12673,Václav Svěrkoš,0,208.0,0,0,2,1,3,Switzerland
12674,Vágner Love,1,104.0,0,0,1,1,2,Chile
12675,Víctor Aguayo,4,138.0,0,0,1,3,4,Ecuador
12676,Víctor Aristizábal,2,625.0,0,3,8,4,12,Colombia
12677,Víctor Artega,1,35.0,0,0,1,0,1,Ecuador
12678,Víctor Ayala,1,71.0,0,0,0,1,1,Colombia
12679,Víctor Benítez,0,78.0,1,0,1,0,1,Argentina
12680,Víctor Bernárdez,0,62.0,0,0,0,1,1,Cuba
12681,Víctor Bielich,0,35.0,0,0,1,0,1,Peru
12682,Víctor Bonilla,3,196.0,0,0,1,3,4,Uruguay
12683,Víctor Celestino Algañaraz,1,57.0,0,0,1,0,1,Bolivia
12684,Víctor Cuesta,1,32.0,0,0,1,0,1,Argentina
12685,Víctor Cáceres,0,55.0,0,0,0,1,1,Chile
12686,Víctor Diogo,0,80.0,0,0,1,0,1,Uruguay
12687,Víctor Espárrago,1,117.0,0,0,0,1,1,Russia
12688,Víctor Guaglianone,1,17.0,0,0,0,1,1,Bolivia
12689,Víctor Muñoz,0,60.0,0,0,0,1,1,Republic of Ireland
12690,Víctor Pacheco,0,48.0,0,0,2,0,2,Colombia
12691,Víctor Pedraza,3,197.0,0,0,0,3,3,Colombia
12692,Víctor Rangel,1,52.0,0,0,1,0,1,Mexico
12693,Víctor René Mendieta Ocampo,1,271.0,0,3,3,2,5,Panama
12694,Víctor Rogelio Ramos,0,50.0,0,0,1,0,1,Argentina
12695,Víctor Ruiz,0,250.0,0,2,2,2,4,Mexico
12696,Víctor Turcios,0,6.0,0,0,1,0,1,El Salvador
12697,Víctor Ugarte,5,475.0,0,3,7,2,9,Bolivia
12698,Víctor Velásquez,0,61.0,0,0,2,0,2,El Salvador
12699,Víctor Zegarra,0,37.0,0,0,1,0,1,Peru
12700,Víctor Ábrego,0,84.0,0,0,1,0,1,Bolivia
12701,Vítor Baptista,0,96.0,0,0,2,0,2,Portugal
12702,Vítor Baía,0,44.0,1,0,1,0,1,Republic of Ireland
12703,Vítor Paneira,0,163.0,0,1,3,0,3,Portugal
12704,Vítor Silva,0,10.0,0,0,1,0,1,Portugal
12705,Vüqar Nadirov,0,167.0,0,0,1,2,3,Kazakhstan
12706,Vīts Rimkus,0,384.0,0,0,3,4,7,Portugal
12707,Vũ Văn Thanh,1,74.0,0,0,1,0,1,Vietnam
12708,Wael Gomaa,0,23.0,1,0,1,0,1,Ghana
12709,Wael Nazha,1,125.0,0,0,1,1,2,Hong Kong
12710,Wagdan Mahmoud Shadli,1,170.0,0,0,1,2,3,Bahrain
12711,Wagner Lopes,2,211.0,0,1,1,4,5,Uzbekistan
12712,Wahbi Khazri,8,718.0,0,4,7,6,13,Tunisia
12713,Wahyt Orazsähedow,0,96.0,0,0,1,1,2,Sri Lanka
12714,Wail Al Habashi,1,81.0,0,0,1,0,1,Kuwait
12715,Waisake Sabutu,2,178.0,0,0,2,1,3,Fiji
12716,Waldemar Sobota,0,34.0,0,0,0,1,1,San Marino
12717,Waldemar Victorino,0,246.0,0,2,2,2,4,Ecuador
12718,Waldir Guerra,0,87.0,0,0,1,0,1,El Salvador
12719,Waldir Sáenz,1,87.0,0,0,0,1,1,Honduras
12720,Waldo Ponce,0,36.0,0,0,1,1,2,Colombia
12721,Waleed Ali,0,132.0,0,0,1,1,2,Kuwait
12722,Waleed Bakhit Maayof,0,47.0,0,0,1,0,1,Qatar
12723,Waleed Hamzah,0,213.0,0,0,1,3,4,Oman
12724,Waleed Jassem,0,155.0,0,0,2,0,2,Qatar
12725,Waleed Salim Al-Lami,1,28.0,0,0,1,0,1,Iraq
12726,Walford Vaughns,0,88.0,0,0,1,0,1,Costa Rica
12727,Walid Abbas,2,248.0,3,0,1,2,3,United Arab Emirates
12728,Walid Abu Al-Sel,4,242.0,0,1,1,4,5,Kuwait
12729,Walid Al-Nasser,1,124.0,0,0,1,1,2,Syria
12730,Walid Badir,1,277.0,0,0,3,1,4,Cyprus
12731,Walid Salah Abdel Latif,0,90.0,0,0,1,0,1,Egypt
12732,Walieldin Khedr,1,70.0,0,1,0,1,1,Nigeria
12733,Walker Zimmerman,0,37.0,0,0,1,0,1,United States
12734,Walmer Martinez,1,175.0,0,0,1,1,2,El Salvador
12735,Walt Schmotolocha,0,49.0,0,0,1,0,1,United States
12736,Walter Ayoví,0,130.0,0,0,3,0,3,Ecuador
12737,Walter Bahr,1,16.0,0,0,1,0,1,United States
12738,Walter Bakouma,0,131.0,0,0,2,0,2,Congo
12739,Walter Baseggio,0,64.0,0,0,1,0,1,Belgium
12740,Walter Boyd,1,377.0,0,0,3,3,6,Honduras
12741,Walter Casagrande,0,82.0,0,0,0,2,2,Bolivia
12742,Walter Centeno,9,722.0,0,2,10,5,15,Costa Rica
12743,Walter Haummer,0,79.0,0,0,1,0,1,Austria
12744,Walter Horak,0,40.0,0,0,0,1,1,France
12745,Walter Julián Martínez,3,135.0,0,1,2,2,4,Honduras
12746,Walter Kelsch,0,70.0,0,0,1,0,1,Germany
12747,Walter Koleznik,0,38.0,0,0,0,1,1,Republic of Ireland
12748,Walter Morel,3,202.0,0,0,0,3,3,Chile
12749,Walter Pearson,0,85.0,0,0,1,0,1,Costa Rica
12750,Walter Samuel,0,199.0,1,0,3,0,3,Peru
12751,Walter Schachner,3,669.0,0,0,11,7,18,Austria
12752,Wamidh Munir,0,90.0,0,0,0,1,1,Jordan
12753,Wan Chi Keung,0,205.0,0,0,2,2,4,Hong Kong
12754,Wandel Gross,0,89.0,0,0,1,0,1,Aruba
12755,Wang Baoshan,0,74.0,0,0,1,1,2,China PR
12756,Wang Dong,0,141.0,0,0,0,2,2,Malaysia
12757,Wang Huiliang,0,60.0,0,0,1,0,1,China PR
12758,Wang Jilian,1,58.0,0,0,1,0,1,China PR
12759,Wang Lu,0,75.0,0,0,1,0,1,China PR
12760,Wang Rui,0,37.0,0,0,0,1,1,Brunei
12761,Wang Yongpo,0,147.0,0,0,2,0,2,China PR
12762,Ward Al Salama,1,23.0,0,0,1,0,1,Syria
12763,Waren Waiwai,1,82.0,0,0,0,1,1,Cook Islands
12764,Warren Archibald,0,360.0,0,0,0,4,4,Haiti
12765,Warren Feeney,0,229.0,0,0,4,0,4,Northern Ireland
12766,Warren Granados,1,64.0,0,0,1,0,1,Costa Rica
12767,Warren Spink,0,25.0,0,0,1,0,1,Australia
12768,Warsama Hassan,1,90.0,0,0,1,0,1,Djibouti
12769,Wartan Ghazarian,3,130.0,0,0,0,4,4,Pakistan
12770,Waseem Al-Bzour,0,33.0,0,0,0,1,1,Turkmenistan
12771,Washington,1,53.0,0,0,1,0,1,Brazil
12772,Washington Muñoz,0,258.0,0,0,2,3,5,Colombia
12773,Washington Oliveira,0,5.0,0,0,0,1,1,Venezuela
12774,Washington Puente,2,174.0,0,0,0,4,4,Ecuador
12775,Washington Villacreses,0,64.0,0,0,0,1,1,Chile
12776,Wasieu Sounmonu,0,123.0,0,0,2,0,2,Sierra Leone
12777,Waskito Kaihun,1,12.0,0,0,0,1,1,Hong Kong
12778,Wason Rentería,0,88.0,0,0,1,0,1,Colombia
12779,Wataru Endo,0,57.0,0,0,1,0,1,Japan
12780,Wayne Dyer,1,83.0,0,0,1,0,1,Montserrat
12781,Wayne Rooney,6,1770.0,0,6,18,19,37,North Macedonia
12782,Webster Chikabala,2,131.0,0,0,0,2,2,Cameroon
12783,Weerarathne Kassun,1,83.0,0,0,0,1,1,Pakistan
12784,Wellington Sánchez,1,94.0,0,0,0,2,2,Paraguay
12785,Wen Chih-hao,1,167.0,0,0,1,1,2,Iraq
12786,Wensley Christoph,2,209.0,0,0,1,4,5,Montserrat
12787,Werner Heine,0,12.0,0,0,0,1,1,Hungary
12788,Werner Krämer,0,77.0,0,0,0,2,2,Sweden
12789,Werner Otto,0,30.0,0,0,0,1,1,Norway
12790,Werner Peter,0,6.0,0,0,1,0,1,German DR
12791,Wes Hoolahan,1,104.0,0,0,2,0,2,Republic of Ireland
12792,Wes Morgan,0,52.0,1,0,0,1,1,Jamaica
12793,Wesam Rizik,1,95.0,0,1,0,2,2,Bahrain
12794,Wesley Charles,0,114.0,0,0,2,0,2,Saint Vincent and the Grenadines
12795,Wesley Marquette,0,52.0,0,0,1,1,2,Tanzania
12796,Wesley Sneijder,9,1112.0,0,0,16,5,21,Netherlands
12797,Wesley Sonck,1,721.0,0,1,11,4,15,San Marino
12798,Wesley Waiwai,0,68.0,0,0,0,1,1,Fiji
12799,Weston McKennie,0,127.0,0,0,4,0,4,United States
12800,Whayne Wilson,0,40.0,0,1,1,0,1,Costa Rica
12801,Widlin Calixte,0,19.0,0,2,2,0,2,Turks and Caicos Islands
12802,Widodo Cahyono Putro,2,225.0,0,0,2,3,5,Indonesia
12803,Wietse Veenstra,0,35.0,0,0,1,0,1,Netherlands
12804,Wilberforce Mfum,5,450.0,0,0,4,2,6,Ghana
12805,Wilbur Cush,1,49.0,0,0,1,1,2,Northern Ireland
12806,Wilde-Donald Guerrier,1,163.0,0,0,2,1,3,Curaçao
12807,Wilf Mannion,1,51.0,0,0,0,1,1,Chile
12808,Wilfred Bouma,1,46.0,0,0,1,1,2,Netherlands
12809,Wilfred Moke,0,77.0,1,0,0,1,1,DR Congo
12810,Wilfred de Lanoy,0,54.0,0,0,0,2,2,Guatemala
12811,Wilfredo Alvarado,0,131.0,0,0,2,0,2,Venezuela
12812,Wilfredo Camacho,0,272.0,0,0,4,1,5,Uruguay
12813,Wilfredo Iraheta Sanabria,0,68.0,0,0,1,0,1,El Salvador
12814,Wilfried Bony,7,604.0,0,1,6,4,10,Ivory Coast
12815,Wilfried Kanon,1,68.0,0,0,0,1,1,DR Congo
12816,Wilfried Puis,0,253.0,0,1,3,2,5,Israel
12817,Wilfried Urbain Elvis Endzanga,0,147.0,0,0,2,0,2,Congo
12818,Wilfried Van Moer,2,173.0,0,0,4,1,5,Belgium
12819,Wilfried Zaha,2,160.0,0,0,0,2,2,Namibia
12820,Wilhelm Hahnemann,1,8.0,0,0,1,0,1,Germany
12821,Wilhelm Kreuz,0,237.0,0,0,4,1,5,Cyprus
12822,Wilkins Lauru,2,128.0,0,0,0,2,2,Fiji
12823,Wilko Risser,0,83.0,0,0,3,0,3,Namibia
12824,Will Johnson,0,208.0,0,0,2,1,3,Canada
12825,Willi Lippens,0,26.0,0,0,1,0,1,Netherlands
12826,Willi Orbán,0,166.0,0,0,1,3,4,Azerbaijan
12827,Willi Wigold,0,12.0,0,0,0,1,1,Luxembourg
12828,William Antonio Torres,1,36.0,0,0,0,1,1,Anguilla
12829,William Campbell,0,76.0,0,0,1,0,1,Northern Ireland
12830,William Carvalho,0,260.0,0,0,2,2,4,Portugal
12831,William Chiroque,1,41.0,0,0,1,0,1,Peru
12832,William Gallas,0,155.0,0,0,2,0,2,France
12833,William Jebor,0,146.0,0,1,1,3,4,Liberia
12834,William Kvist,0,45.0,0,0,0,1,1,Italy
12835,William Martínez,0,88.0,0,0,1,0,1,Uruguay
12836,William N'Gounou,1,9.0,0,0,1,0,1,Niger
12837,William Ouma,0,377.0,0,0,4,2,6,Kenya
12838,William Quirós,0,228.0,0,0,3,0,3,Costa Rica
12839,William Ramallo,0,53.0,0,0,1,0,1,Bolivia
12840,William Renderos Iraheta,0,132.0,0,0,3,0,3,El Salvador
12841,William Sango,0,37.0,0,0,0,1,1,Niger
12842,William Scheppel,0,16.0,1,0,1,0,1,Mexico
12843,William Sunsing,0,86.0,0,0,0,2,2,Jamaica
12844,William Torres,0,160.0,0,0,2,0,2,El Salvador
12845,William Troost-Ekong,3,226.0,1,1,3,1,4,Nigeria
12846,William Waddell,0,36.0,0,1,0,2,2,Northern Ireland
12847,Willian,0,231.0,0,0,3,2,5,Brazil
12848,Willie August Marango,1,6.0,0,0,0,1,1,Fiji
12849,Willie Henderson,0,70.0,0,0,1,0,1,Scotland
12850,Willie Irvine,0,134.0,0,0,0,2,2,Spain
12851,Willie Klutse,1,145.0,0,0,2,0,2,Ghana
12852,Willie Morgan,0,83.0,0,0,0,1,1,Denmark
12853,Willie Ormond,0,89.0,0,0,1,0,1,Scotland
12854,Willie Phiri,0,87.0,0,0,2,0,2,Zambia
12855,Willie Rutherford,1,57.0,0,0,0,1,1,Zimbabwe
12856,Willie Vassallo,0,66.0,0,0,1,0,1,Malta
12857,Willington Ortiz,0,354.0,0,0,3,4,7,Colombia
12858,Willy Brokamp,0,282.0,0,0,5,0,5,Netherlands
12859,Willy Jäggi,1,158.0,0,0,0,2,2,Yugoslavia
12860,Willy Roy,0,139.0,0,0,1,2,3,Canada
12861,Willy Stephanus,0,103.0,0,0,1,1,2,Gambia
12862,Willy Tröger,0,61.0,0,0,1,0,1,German DR
12863,Willy van de Kerkhof,2,420.0,0,0,0,6,6,Yugoslavia
12864,Willy van der Kuijlen,0,192.0,0,0,4,0,4,Netherlands
12865,Wilmar Cabrera,0,78.0,0,0,2,0,2,Uruguay
12866,Wilmer Cabrera,1,130.0,0,1,2,0,2,Colombia
12867,Wilmer López,1,113.0,0,1,1,1,2,Costa Rica
12868,Wilmer Velásquez,3,213.0,0,0,3,1,4,Saint Vincent and the Grenadines
12869,Wilson Chevalier,0,11.0,0,0,1,0,1,Haiti
12870,Wilson Gaspar,0,31.0,0,0,0,1,1,Gambia
12871,Wilson Nieves,0,88.0,0,0,0,1,1,Paraguay
12872,Wilson Oruma,1,94.0,0,0,2,0,2,Nigeria
12873,Wilson Palacios,0,165.0,0,0,2,1,3,Honduras
12874,Wilson Pérez,0,76.0,0,0,1,0,1,Colombia
12875,Wim Jansen,0,22.0,0,0,1,0,1,Netherlands
12876,Wim Jonk,4,414.0,0,1,4,5,9,San Marino
12877,Wim Kieft,2,387.0,0,0,5,2,7,Netherlands
12878,Wim Rijsbergen,0,17.0,0,0,1,0,1,Netherlands
12879,Wim Suurbier,0,220.0,0,0,1,2,3,Hungary
12880,Wim van Hanegem,0,161.0,0,0,4,0,4,Netherlands
12881,Windsor del Llano,0,84.0,1,0,0,1,1,Bolivia
12882,Winston Anglin,0,65.0,0,0,0,1,1,Trinidad and Tobago
12883,Winston Kalengo,0,109.0,0,0,1,1,2,Sudan
12884,Winston Parks,1,86.0,0,0,1,0,1,Costa Rica
12885,Winston Reid,1,90.0,0,0,1,0,1,New Zealand
12886,Winston Roberts,0,39.0,0,0,1,0,1,Antigua and Barbuda
12887,Winston Trott,0,34.0,0,0,0,1,1,United States
12888,Wisam El Abdy,0,78.0,0,0,0,1,1,Botswana
12889,Wisdom Mumba Chansa,0,4.0,0,0,1,0,1,Zambia
12890,Wissam Ben Yedder,0,120.0,0,0,1,1,2,Andorra
12891,Wissem Ben Yahia,0,21.0,0,1,1,0,1,Tunisia
12892,Witson Nyirenda,0,10.0,0,0,1,0,1,Zambia
12893,Witthaya Laohakul,2,141.0,0,0,1,1,2,Malaysia
12894,Wladimir Baýramow,2,170.0,0,0,4,0,4,Turkmenistan
12895,Wojciech Kowalczyk,0,94.0,0,0,1,2,3,Netherlands
12896,Wojciech Rudy,0,4.0,0,0,0,1,1,Netherlands
12897,Wojciech Szczęsny,1,18.0,1,0,0,1,1,Poland
12898,Wojciech Łobodziński,0,34.0,0,0,1,0,1,Poland
12899,Wole Odegbami,0,5.0,0,0,1,0,1,Nigeria
12900,Wolfgang Dremmler,0,119.0,0,0,1,1,2,Germany
12901,Wolfgang Overath,1,276.0,0,0,8,0,8,Germany
12902,Wolfgang Weber,0,89.0,0,0,0,1,1,England
12903,Wolfram Löwe,0,322.0,0,0,3,4,7,Denmark
12904,Wong Chi Keung,1,66.0,0,0,1,0,1,Hong Kong
12905,Wong Chi-keung,1,64.0,0,0,0,1,1,Myanmar
12906,Wong Chun Yue,0,51.0,0,0,1,0,1,Hong Kong
12907,Woo Sang-kwon,3,208.0,0,1,4,1,5,Israel
12908,Worrawoot Srimaka,0,21.0,0,0,1,0,1,Thailand
12909,Wout Weghorst,2,231.0,0,0,3,0,3,Netherlands
12910,Wouter Brokke,1,90.0,0,0,1,0,1,Curaçao
12911,Wu Chengying,0,87.0,0,0,1,1,2,China PR
12912,Wu Chun-ching,0,140.0,0,0,1,2,3,Taiwan
12913,Wu Kwok Hung,0,62.0,0,0,1,0,1,Hong Kong
12914,Wu Lei,9,912.0,0,4,11,6,17,Bhutan
12915,Wu Qunli,0,66.0,0,0,0,1,1,Jordan
12916,Wu Wei'an,1,13.0,0,0,0,1,1,Myanmar
12917,Wu Xi,2,356.0,0,0,3,3,6,China PR
12918,Wu Xinghan,1,65.0,0,0,1,0,1,China PR
12919,Wun Chee Keung,1,137.0,0,0,1,2,3,Hong Kong
12920,Wyn Davies,0,122.0,0,0,2,1,3,Wales
12921,Wynton Rufer,1,318.0,0,0,5,4,9,Kuwait
12922,Wálter Flores,0,85.0,0,0,1,0,1,Bolivia
12923,Wýaçeslaw Krendelew,0,12.0,0,0,1,0,1,Turkmenistan
12924,Włodzimierz Ciołek,1,76.0,0,0,1,0,1,Poland
12925,Włodzimierz Lubański,0,1043.0,0,0,17,4,21,Poland
12926,Włodzimierz Mazur,0,146.0,0,1,1,1,2,Cyprus
12927,Włodzimierz Smolarek,2,540.0,0,2,7,6,13,Malta
12928,Xabi Alonso,4,342.0,0,3,4,3,7,Spain
12929,Xavi,1,313.0,0,0,4,4,8,Northern Ireland
12930,Xavier Arreaga,0,39.0,0,0,1,0,1,Ecuador
12931,Xavier Camargo,0,137.0,0,0,2,0,2,Brazil
12932,Xavier Chen,0,75.0,0,1,1,0,1,Taiwan
12933,Xavier García,0,90.0,0,0,0,1,1,Cayman Islands
12934,Xavier Samin,1,59.0,1,0,0,1,1,Tahiti
12935,Xherdan Shaqiri,9,1194.0,0,0,12,9,21,Switzerland
12936,Xiao Zhi,1,141.0,0,0,0,2,2,Qatar
12937,Xie Hui,0,405.0,0,0,5,2,7,China PR
12938,Xie Yuxin,3,101.0,0,0,2,2,4,China PR
12939,Xu Deshuai,0,63.0,0,0,1,0,1,Hong Kong
12940,Xu Hong,0,136.0,0,0,2,0,2,China PR
12941,Xu Xin,0,90.0,0,0,0,1,1,Vietnam
12942,Xu Yonglai,4,359.0,0,0,4,0,4,China PR
12943,Xu Yunlong,0,205.0,0,0,5,0,5,China PR
12944,Yabe Siad Isman,0,84.0,0,0,0,1,1,Niger
12945,Yacine Bammou,0,66.0,0,0,1,0,1,Morocco
12946,Yacine Bezzaz,0,68.0,0,0,1,0,1,Algeria
12947,Yacine Brahimi,1,117.0,0,0,1,2,3,South Korea
12948,Yacouba Ali,0,14.0,0,0,0,1,1,Gabon
12949,Yahia Kébé,0,54.0,0,0,1,1,2,Burkina Faso
12950,Yahya Al Ghassani,0,70.0,0,0,1,0,1,United Arab Emirates
12951,Yahya Al-Shehri,0,186.0,0,0,4,1,5,Saudi Arabia
12952,Yahya Golmohammadi,1,201.0,1,0,2,1,3,Iran
12953,Yahya Madon,0,39.0,0,0,1,0,1,Singapore
12954,Yaki Yen,0,3.0,0,0,0,1,1,Thailand
12955,Yakubu,3,602.0,0,4,4,7,11,Sudan
12956,Yakubu Mambo,0,100.0,0,0,2,0,2,Nigeria
12957,Yamba Asha,0,72.0,0,0,0,1,1,Niger
12958,Yan Vorogovskiy,0,10.0,0,0,1,0,1,Kazakhstan
12959,Yang Chen,3,235.0,0,0,5,0,5,China PR
12960,Yang Lin,0,58.0,0,0,1,0,1,China PR
12961,Yang Seung-kook,1,25.0,0,0,1,0,1,North Korea
12962,Yang Xu,0,722.0,0,2,12,5,17,China PR
12963,Yang Zhaohui,1,89.0,0,0,3,0,3,China PR
12964,Yangel Herrera,0,84.0,0,0,0,1,1,Paraguay
12965,Yanik Frick,0,151.0,0,0,2,0,2,Liechtenstein
12966,Yaniv Katan,0,155.0,0,0,1,1,2,Israel
12967,Yann M'Vila,0,18.0,0,0,0,1,1,Albania
12968,Yann Sommer,1,90.0,1,0,0,1,1,Switzerland
12969,Yannick Bolasie,1,128.0,0,0,0,3,3,Zambia
12970,Yannick Carrasco,1,414.0,0,0,3,3,6,Hungary
12971,Yannick Mukunzi,0,93.0,0,0,1,1,2,Seychelles
12972,Yannick Stopyra,2,240.0,0,0,2,4,6,Luxembourg
12973,Yanti Barsales,0,59.0,0,0,0,1,1,Syria
12974,Yao Junior Sènaya,0,161.0,0,0,2,0,2,Togo
12975,Yao Lambert Amani,0,81.0,0,0,1,0,1,Ivory Coast
12976,Yaqoob Juma Al-Mukhaini,0,579.0,0,0,11,0,11,Oman
12977,Yari Verschaeren,0,84.0,0,1,1,0,1,Belgium
12978,Yaroslav Rakytskiy,0,170.0,0,0,1,1,2,Andorra
12979,Yaseen Al-Bakhit,0,58.0,0,0,0,1,1,Bangladesh
12980,Yaser Hamed,2,143.0,0,0,2,1,3,Singapore
12981,Yaser Kasim,1,77.0,0,0,0,1,1,Jordan
12982,Yaser Salem Ali,0,502.0,0,0,4,6,10,Brunei
12983,Yashir Pinto,0,71.0,0,0,2,0,2,Palestine
12984,Yasmani Duk,0,59.0,0,0,0,1,1,Paraguay
12985,Yasser Al-Qahtani,6,670.0,0,3,8,6,14,Saudi Arabia
12986,Yasser Al-Shahrani,0,104.0,0,0,2,0,2,Saudi Arabia
12987,Yasser Ezzat,0,83.0,0,0,1,0,1,Egypt
12988,Yasser Radwan,3,180.0,0,0,1,2,3,Zambia
12989,Yassin Mikari,0,18.0,0,0,1,0,1,Tunisia
12990,Yassine Chikhaoui,2,238.0,0,0,1,2,3,Tunisia
12991,Yassine Meriah,1,51.0,1,1,2,0,2,Tunisia
12992,Yasuhito Endō,2,187.0,0,2,2,4,6,Vietnam
12993,Yasuto Honda,1,90.0,0,0,0,1,1,Nepal
12994,Yasuyuki Konno,0,88.0,0,0,0,2,2,Tajikistan
12995,Yasuyuki Kuwahara,0,50.0,0,0,0,1,1,South Korea
12996,Yatma Diop,2,92.0,0,0,0,2,2,Ghana
12997,Yatma Diouck,2,176.0,0,0,0,2,2,Congo
12998,Yaw Preko,0,75.0,0,0,1,0,1,Ghana
12999,Yaya Dissa,0,80.0,0,0,1,0,1,Mali
13000,Yaya Touré,6,609.0,0,1,5,8,13,Libya
13001,Yazan Al-Arab,1,67.0,0,0,0,1,1,Nepal
13002,Yaúca,0,291.0,0,0,3,1,4,Portugal
13003,Ye Nyunt,1,42.0,0,0,1,0,1,Myanmar
13004,Yeferson Soteldo,0,90.0,0,1,1,0,1,Venezuela
13005,Yegor Titov,1,357.0,0,0,5,1,6,Russia
13006,Yeh Ching-Tueng,1,66.0,0,0,1,0,1,Taiwan
13007,Yehoshua Feigenbaum,0,158.0,0,0,2,0,2,Israel
13008,Yehoshua Glazer,0,427.0,0,0,5,2,7,Israel
13009,Yeltsin Tejeda,1,58.0,0,0,1,0,1,Costa Rica
13010,Yerry Mina,4,393.0,1,0,2,4,6,Colombia
13011,Yervand Krbachyan,0,3.0,1,0,1,0,1,Belgium
13012,Yevgeni Varlamov,0,67.0,0,0,0,1,1,Ukraine
13013,Yevgeniy Lunev,1,73.0,0,0,0,1,1,Nepal
13014,Yevhen Khacheridi,0,169.0,0,0,3,0,3,Ukraine
13015,Yevhen Konoplyanka,0,464.0,0,1,5,3,8,England
13016,Yevhen Seleznyov,0,341.0,0,3,3,4,7,Ukraine
13017,Yiannos Ioannou,0,256.0,0,0,2,2,4,Cyprus
13018,Yiasoumis Yiasoumi,0,171.0,0,0,1,1,2,Cyprus
13019,Yisa Sofoluwe,0,89.0,0,0,1,0,1,Nigeria
13020,Yiu Cheuk Yin,1,90.0,0,0,1,0,1,Taiwan
13021,Ylber Ramadani,0,90.0,0,0,1,0,1,Albania
13022,Ylli Shehu,0,33.0,0,0,1,0,1,Albania
13023,Yngve Brodd,1,320.0,0,0,1,4,5,Sweden
13024,Yoane Wissa,0,12.0,0,0,1,0,1,DR Congo
13025,Yoann Gourcuff,0,307.0,0,0,2,2,4,Romania
13026,Yoann Langlet,0,3.0,0,0,1,0,1,Mauritania
13027,Yoel Bárcenas,1,135.0,0,0,2,0,2,Panama
13028,Yogan Santos,0,67.0,1,0,1,0,1,Germany
13029,Yohai Aharoni,0,76.0,0,0,1,0,1,Israel
13030,Yohan Cabaye,0,56.0,0,0,0,1,1,Ukraine
13031,Yohanan Sukenik,1,54.0,0,0,1,0,1,Israel
13032,Yohance Marshall,1,90.0,0,0,1,0,1,Trinidad and Tobago
13033,Yong Jin-Li,1,61.0,0,0,0,1,1,Vietnam
13034,Yony Flores,0,31.0,0,0,1,0,1,Guatemala
13035,Yoo Pan-soon,0,26.0,0,0,0,1,1,Japan
13036,Yoo Pan-sun,0,61.0,0,0,1,0,1,South Korea
13037,Yoo Sang-chul,1,347.0,0,0,4,2,6,South Korea
13038,Yoon Bit-garam,1,105.0,0,0,0,1,1,Iran
13039,Yordan Letchkov,2,325.0,0,0,5,0,5,Bulgaria
13040,Yordan Minev,0,4.0,1,0,0,1,1,Bulgaria
13041,Yordan Yordanov,0,83.0,0,0,0,1,1,Malta
13042,Yoshimar Yotún,3,223.0,0,0,4,1,5,Peru
13043,Yoshinori Muto,1,43.0,0,0,1,0,1,Japan
13044,Yoshito Ōkubo,0,76.0,0,0,2,0,2,Japan
13045,Yossi Abukasis,0,151.0,0,0,2,0,2,Israel
13046,Yossi Benayoun,1,712.0,0,2,13,4,17,Cyprus
13047,Yosuke Ideguchi,0,82.0,0,0,1,0,1,Japan
13048,Youcef Belaïli,3,102.0,0,0,1,2,3,Senegal
13049,Younes Al Shibani,0,78.0,0,0,2,0,2,Libya
13050,Younis Mahmoud,13,1229.0,0,2,11,9,20,Saudi Arabia
13051,Younès Belhanda,1,129.0,0,0,1,1,2,Niger
13052,Youri Djorkaeff,3,678.0,0,2,8,5,13,France
13053,Youri Mulder,0,178.0,0,0,3,0,3,Netherlands
13054,Youri Tielemans,0,59.0,0,0,2,0,2,Belgium
13055,Yousef Aboloya,0,90.0,0,0,1,0,1,Saudi Arabia
13056,Yousef Al-Naber,0,82.0,0,0,1,0,1,Jordan
13057,Yousef Al-Rawashdeh,1,64.0,0,0,1,1,2,Palestine
13058,Yousef Khalaf,0,50.0,0,0,1,0,1,Qatar
13059,Yousef Nasser,2,520.0,0,0,9,5,14,Kuwait
13060,Yousef Sheikh Al-Eshreh,0,92.0,0,0,1,1,2,Bahrain
13061,Yousif Al-Sobaei,0,60.0,0,0,0,1,1,Yemen DPR
13062,Youssef Chippo,1,45.0,1,0,0,1,1,Morocco
13063,Youssef El-Arabi,1,301.0,0,0,3,2,5,Morocco
13064,Youssef En-Nesyri,7,362.0,0,0,5,2,7,Morocco
13065,Youssef Farhat,1,38.0,0,0,0,1,1,Hong Kong
13066,Youssef Fertout,1,261.0,0,0,3,2,5,Morocco
13067,Youssef Mohamad,0,27.0,0,0,1,0,1,Lebanon
13068,Youssef Mokhtari,2,140.0,0,0,2,2,4,Morocco
13069,Youssef Msakni,7,542.0,0,1,2,8,10,Morocco
13070,Youssef Safri,1,248.0,0,3,3,3,6,Morocco
13071,Youssouf Abdi Ahmed,0,33.0,0,0,0,1,1,Niger
13072,Youssouf Arouna,0,62.0,0,0,1,0,1,Benin
13073,Youssouf Falikou Fofana,1,87.0,0,0,1,1,2,Ivory Coast
13074,Youssouf Hadji,3,625.0,0,0,8,1,9,Nigeria
13075,Youssouf M'Changama,0,81.0,0,0,0,1,1,Cameroon
13076,Youssouf Oumarou,1,81.0,1,1,1,1,2,Algeria
13077,Youssuf Camara,0,52.0,0,0,0,1,1,Ghana
13078,Yousuf Al-Thunayan,5,430.0,0,1,7,1,8,Saudi Arabia
13079,Yousuf Jazea'a,1,78.0,0,0,1,0,1,Saudi Arabia
13080,Yousuf Saleh Al-Alawi,2,35.0,0,0,1,1,2,Oman
13081,Yousuf Shaaban,0,3.0,0,0,0,1,1,Singapore
13082,Yozhef Sabo,0,198.0,0,2,1,3,4,Denmark
13083,Ysrael Zúñiga,2,156.0,0,0,1,1,2,Peru
13084,Yssouf Koné,0,261.0,0,0,1,2,3,Tunisia
13085,Yu Dabao,2,551.0,0,0,7,3,10,China PR
13086,Yu Genwei,0,124.0,0,0,2,0,2,China PR
13087,Yu Hai,2,275.0,0,0,2,3,5,China PR
13088,Yu Hanchao,0,229.0,0,0,2,2,4,Laos
13089,Yu Song-chol,0,90.0,0,0,0,1,1,Singapore
13090,Yuan Kuan Yick,1,75.0,0,0,1,0,1,Hong Kong
13091,Yuen Kuen-Chu,1,73.0,0,0,1,1,2,Hong Kong
13092,Yuji Nakazawa,4,527.0,0,0,5,4,9,Japan
13093,Yuki Abe,1,53.0,0,0,1,0,1,Japan
13094,Yun Jong-su,1,125.0,0,0,2,1,3,North Korea
13095,Yunis Aman Al-Naseeb,1,35.0,0,0,1,0,1,Oman
13096,Yunus Alif,0,40.0,0,0,1,0,1,Malaysia
13097,Yura Movsisyan,0,305.0,0,0,3,5,8,North Macedonia
13098,Yuri Borodolimov,1,72.0,0,0,0,1,1,Taiwan
13099,Yuri Chesnokov,0,43.0,0,0,2,0,2,Russia
13100,Yuri Gavrilov,2,226.0,0,0,3,2,5,Russia
13101,Yuri Kovtun,0,112.0,1,0,2,0,2,Iceland
13102,Yuriy Dmytrulin,0,56.0,0,0,1,0,1,Ukraine
13103,Yuriy Kalitvintsev,0,13.0,0,0,1,0,1,Ukraine
13104,Yuriy Logvinenko,0,195.0,0,0,2,1,3,Kazakhstan
13105,Yuriy Maksymov,0,142.0,0,0,1,1,2,Ukraine
13106,Yuriy Nikiforov,0,159.0,0,0,3,1,4,Russia
13107,Yuriy Pertsukh,0,6.0,0,0,1,0,1,Kazakhstan
13108,Yuriy Voynov,1,81.0,0,0,1,1,2,Russia
13109,Yury Gazinsky,0,12.0,0,0,1,0,1,Russia
13110,Yury Kendysh,0,64.0,0,0,1,0,1,Belarus
13111,Yusef Ahmed,0,178.0,0,0,4,1,5,Qatar
13112,Yussuf Poulsen,1,469.0,0,0,7,2,9,Denmark
13113,Yusuf A'Amer Al Sadi,3,259.0,0,0,3,2,5,Bahrain
13114,Yusuf Abdurisag,0,28.0,0,0,0,1,1,Bangladesh
13115,Yusuf Altıntaş,0,68.0,0,0,1,0,1,Turkey
13116,Yusuf Rabiev,0,102.0,0,0,2,0,2,Tajikistan
13117,Yusuf Yazıcı,0,119.0,0,0,1,1,2,Moldova
13118,Yutaka Akita,1,35.0,0,0,1,2,3,Macau
13119,Yuto Nagatomo,0,33.0,0,0,1,0,1,Japan
13120,Yuya Kubo,0,71.0,0,0,1,1,2,United Arab Emirates
13121,Yuya Osako,7,766.0,0,3,11,5,16,Iraq
13122,Yuzo Kurihara,0,154.0,0,0,1,1,2,Japan
13123,Yvan Rajoarimanana,0,54.0,0,0,1,0,1,Madagascar
13124,Yves Bissouma,1,73.0,0,0,0,1,1,Uganda
13125,Yves Diba Ilunga,0,66.0,0,0,1,0,1,DR Congo
13126,Yves Herbet,0,8.0,0,0,0,1,1,Luxembourg
13127,Yves Vanderhaeghe,0,60.0,0,0,2,0,2,Belgium
13128,Yves Yuvuladio,1,28.0,0,0,1,0,1,DR Congo
13129,Yvon Douis,1,82.0,0,0,2,0,2,France
13130,Yvon Goujon,0,133.0,0,0,2,1,3,England
13131,Yénier Márquez,2,332.0,0,0,4,1,5,Cuba
13132,Yıldıray Baştürk,0,26.0,0,0,2,0,2,Turkey
13133,Yūichi Komano,0,35.0,0,0,1,0,1,Japan
13134,Zach Muscat,0,53.0,0,0,0,1,1,Cyprus
13135,Zachary Brault-Guillard,1,49.0,0,0,0,1,1,Aruba
13136,Zafar Babajanow,1,59.0,0,0,1,0,1,Turkmenistan
13137,Zah Rahan Krangar,0,89.0,0,0,0,1,1,Senegal
13138,Zahi Armeli,0,230.0,0,0,4,1,5,Israel
13139,Zahir Rafiq,0,53.0,0,0,1,0,1,Pakistan
13140,Zainal Abidin Hassan,1,240.0,0,0,4,1,5,Malaysia
13141,Zaine Pierre,0,65.0,0,0,1,0,1,Saint Lucia
13142,Zainudin Kassim,0,49.0,0,0,1,0,1,Brunei
13143,Zakaria Aboukhlal,2,178.0,0,0,1,1,2,Morocco
13144,Zakaria Sanogo,0,37.0,0,0,0,1,1,Algeria
13145,Zakariya Souleymane,0,70.0,1,0,1,0,1,Algeria
13146,Zaker Berdykulov,2,129.0,0,0,2,0,2,Tajikistan
13147,Zamel Al Kuwari,2,138.0,0,0,1,2,3,Indonesia
13148,Zamel Essa Al-Kuwari,0,60.0,0,0,0,1,1,China PR
13149,Zamirbek Jumagulov,1,8.0,0,0,1,0,1,Kyrgyzstan
13150,Zanzan Atte-Oudeyi,0,78.0,0,0,0,1,1,Libya
13151,Zaur Tagizade,0,166.0,0,0,3,0,3,Azerbaijan
13152,Zaw Min Tun,1,97.0,1,0,1,1,2,Laos
13153,Zaza Janashia,0,99.0,0,0,2,0,2,Georgia
13154,Zbigniew Boniek,6,599.0,0,0,9,5,14,Poland
13155,Zdenko Morovic,1,39.0,1,0,1,0,1,Brazil
13156,Zdeněk Grygera,0,13.0,0,0,1,0,1,Czech Republic
13157,Zdeněk Nehoda,3,628.0,0,1,11,5,16,Czechoslovakia
13158,Zdeněk Ondrášek,0,85.0,0,0,1,0,1,Czech Republic
13159,Zdeněk Pospěch,0,53.0,0,0,0,1,1,San Marino
13160,Zdeněk Prokeš,0,37.0,0,0,1,0,1,Czechoslovakia
13161,Zdeněk Zikán,4,117.0,0,0,2,2,4,Czechoslovakia
13162,Zdravko Kuzmanović,0,310.0,0,0,2,2,4,Belgium
13163,Zdravko Lazarov,0,55.0,0,0,1,0,1,Bulgaria
13164,Zdravko Rajkov,1,73.0,0,0,0,1,1,Paraguay
13165,Zeca,0,127.0,0,0,2,0,2,Greece
13166,Zeddy Saileti,1,30.0,0,0,1,0,1,Zambia
13167,Zeiko Lewis,0,29.0,0,0,0,1,1,Bahamas
13168,Zelfy Nazary,1,45.0,0,0,1,0,1,Afghanistan
13169,Zelimkhan Bakayev,0,84.0,0,1,1,0,1,Russia
13170,Zenón González,3,188.0,0,0,3,0,3,Bolivia
13171,Zerga Geremew,0,180.0,0,0,2,0,2,Ethiopia
13172,Zhambyl Kukeyev,0,68.0,0,0,0,1,1,England
13173,Zhang Enhua,2,164.0,0,0,1,2,3,Saudi Arabia
13174,Zhang Honggen,0,1.0,0,0,1,0,1,China PR
13175,Zhang Linpeng,2,200.0,1,0,2,1,3,Kuwait
13176,Zhang Xiaowen,1,165.0,0,0,1,1,2,Bahrain
13177,Zhang Xizhe,0,131.0,0,0,2,0,2,China PR
13178,Zhang Yaokun,1,39.0,0,1,0,1,1,Myanmar
13179,Zhang Yuning,2,212.0,0,0,3,0,3,China PR
13180,Zhao Dayu,6,441.0,0,0,5,3,8,Singapore
13181,Zhao Faqing,0,89.0,0,0,1,0,1,China PR
13182,Zheng Bin,1,35.0,0,0,0,1,1,Myanmar
13183,Zheng Zheng,0,154.0,0,0,0,2,2,Singapore
13184,Zheng Zhi,1,394.0,1,4,5,1,6,China PR
13185,Zhou Haibin,0,33.0,0,0,1,0,1,China PR
13186,Zhu Chenjie,1,82.0,0,1,1,0,1,China PR
13187,Zia Arabshahi,1,69.0,0,0,0,1,1,China PR
13188,Ziad Jaziri,1,406.0,0,0,7,2,9,Tunisia
13189,Ziad Tlemçani,2,100.0,0,0,2,1,3,Benin
13190,Zico,9,790.0,0,5,15,3,18,Brazil
13191,Zico Tumba,1,26.0,0,0,1,0,1,DR Congo
13192,Zidane Sam,1,20.0,0,0,1,0,1,Saint Vincent and the Grenadines
13193,Zinedine Zidane,9,973.0,0,4,9,8,17,France
13194,Zinho,1,77.0,0,1,1,0,1,Brazil
13195,Zini,0,106.0,0,0,1,1,2,Angola
13196,Zisis Vryzas,1,123.0,0,0,0,3,3,Armenia
13197,Zito,1,69.0,0,0,1,0,1,Brazil
13198,Ziyad Al-Kord,1,10.0,0,0,1,0,1,Palestine
13199,Zizi Roberts,0,75.0,0,0,2,0,2,Liberia
13200,Zizinho,12,785.0,0,1,16,1,17,Brazil
13201,Zlatan Bajramović,0,165.0,0,0,1,2,3,Bosnia and Herzegovina
13202,Zlatan Ibrahimović,5,2364.0,0,5,26,18,44,Sweden
13203,Zlatan Ljubijankić,1,217.0,0,0,3,0,3,Slovenia
13204,Zlatan Muslimović,0,393.0,0,0,5,3,8,Malta
13205,Zlatko Dedić,0,176.0,0,0,3,1,4,Poland
13206,Zlatko Junuzović,0,350.0,0,0,3,2,5,Azerbaijan
13207,Zlatko Kranjčar,0,119.0,0,0,3,0,3,Yugoslavia
13208,Zlatko Vujović,0,997.0,0,0,11,7,18,Cyprus
13209,Zlatko Yankov,0,81.0,0,0,2,0,2,Bulgaria
13210,Zlatko Zahovič,3,1168.0,0,5,14,10,24,Slovenia
13211,Zlatko Čajkovski,0,41.0,0,0,0,1,1,Israel
13212,Zoilo Saldombide,2,129.0,0,1,0,2,2,Paraguay
13213,Zola Matumona,0,242.0,0,1,2,2,4,DR Congo
13214,Zoltan Crişan,0,243.0,0,0,2,2,4,Spain
13215,Zoltán Böőr,0,4.0,0,0,0,1,1,San Marino
13216,Zoltán Czibor,3,80.0,0,0,2,1,3,Hungary
13217,Zoltán Gera,1,1244.0,0,4,14,7,21,Hungary
13218,Zoltán Halmosi,0,30.0,0,0,1,0,1,Hungary
13219,Zoltán Kereki,0,151.0,0,0,1,1,2,Greece
13220,Zoltán Kovács,0,22.0,0,0,1,0,1,Hungary
13221,Zoltán Lipták,0,40.0,0,0,0,1,1,San Marino
13222,Zoltán Péter,0,65.0,0,0,1,0,1,Hungary
13223,Zoltán Stieber,1,169.0,0,0,0,2,2,Finland
13224,Zoltán Varga,0,83.0,0,0,1,0,1,Hungary
13225,Zoran Boškovski,0,51.0,0,0,0,1,1,Belgium
13226,Zoran Filipović,0,95.0,0,0,0,2,2,German DR
13227,Zoran Janković,0,17.0,0,0,0,1,1,Belgium
13228,Zoran Mirković,1,2.0,0,0,1,0,1,Serbia
13229,Zoran Tošić,0,354.0,0,0,6,2,8,Lithuania
13230,Zoran Vujović,0,37.0,0,0,1,0,1,Yugoslavia
13231,Zoran Vulić,0,65.0,0,0,1,0,1,Yugoslavia
13232,Zoubeir Baya,2,542.0,0,0,7,5,12,Gabon
13233,Zouheir Dhaouadi,1,40.0,0,0,0,1,1,Zambia
13234,Zsolt Kalmár,0,47.0,0,0,0,1,1,Bulgaria
13235,Zuhair Bakheet,1,477.0,0,0,4,3,7,Kuwait
13236,Zulkarnaen Zainal,0,88.0,0,0,0,1,1,Lebanon
13237,Zulkifli Hamzah,1,134.0,0,0,1,1,2,Malaysia
13238,Zumratul Hossain Mithu,0,50.0,0,0,1,0,1,Bangladesh
13239,Zuo Shusheng,5,273.0,0,0,4,2,6,China PR
13240,Zuriko Davitashvili,0,82.0,0,0,0,1,1,Kosovo
13241,Zvenyika Makonese,0,30.0,1,0,0,1,1,Zimbabwe
13242,Zvezdan Cvetković,0,14.0,0,0,1,0,1,Yugoslavia
13243,Zvezdan Čebinac,0,87.0,0,0,2,0,2,Yugoslavia
13244,Zvi Farkash,1,50.0,0,0,1,0,1,Israel
13245,Zvi Rozen,2,157.0,0,0,2,0,2,Israel
13246,Zvjezdan Misimović,0,838.0,0,4,11,8,19,Spain
13247,Zvonimir Boban,1,501.0,0,0,9,0,9,Yugoslavia
13248,Zvonimir Soldo,0,171.0,0,0,1,2,3,Slovenia
13249,Zvonimir Vukić,1,172.0,0,0,1,4,5,Wales
13250,Zvonko Ivezić,0,77.0,0,0,0,1,1,Sweden
13251,Zvonko Živković,0,17.0,0,0,1,0,1,Yugoslavia
13252,Zyad Chaabo,0,216.0,0,0,4,1,5,Indonesia
13253,Zygfryd Szołtysik,0,162.0,0,0,2,0,2,Poland
13254,Zé Kalanga,0,162.0,0,0,2,0,2,Angola
13255,Zé Roberto,3,402.0,0,0,4,2,6,Bolivia
13256,Zé de Mello,0,45.0,0,0,0,1,1,Ecuador
13257,Zéphirin Zoko,0,86.0,0,0,0,1,1,Madagascar
13258,it:Lee Ki-Bum,0,79.0,0,0,3,0,3,South Korea
13259,Ádám Gyurcsó,0,83.0,0,0,1,1,2,Latvia
13260,Ádám Lang,0,43.0,0,0,1,0,1,Hungary
13261,Ádám Szalai,1,765.0,0,2,11,7,18,Hungary
13262,Ákos Buzsáky,0,42.0,0,0,1,1,2,Hungary
13263,Ákos Takács,0,64.0,0,0,1,0,1,Hungary
13264,Álex Aguinaga,4,807.0,0,1,8,7,15,Ecuador
13265,Álex da Rosa,0,45.0,0,0,1,0,1,Bolivia
13266,Álvaro Grant,0,54.0,0,0,0,1,1,Mexico
13267,Álvaro Morata,8,1127.0,0,1,13,8,21,Spain
13268,Álvaro Murillo,0,180.0,0,0,2,1,3,Guatemala
13269,Álvaro Negredo,0,366.0,0,0,4,3,7,Bosnia and Herzegovina
13270,Álvaro Pereira,3,222.0,1,0,4,1,5,South Africa
13271,Álvaro Peña,0,136.0,0,0,2,0,2,Bolivia
13272,Álvaro Recoba,3,283.0,0,1,3,3,6,Uruguay
13273,Álvaro Saborío,4,813.0,0,2,11,10,21,Cuba
13274,Ángel Berni,3,229.0,0,0,1,3,4,Chile
13275,Ángel Cabrera,1,22.0,0,0,2,0,2,Uruguay
13276,Ángel Correa,0,74.0,0,0,0,1,1,Venezuela
13277,Ángel Di María,7,802.0,0,0,10,7,17,Argentina
13278,Ángel Fernández,1,256.0,0,0,3,1,4,Ecuador
13279,Ángel Guirado,2,88.0,0,0,3,1,4,Philippines
13280,Ángel Jara Saguier,0,122.0,0,0,1,1,2,Colombia
13281,Ángel Labruna,5,553.0,0,0,10,0,10,Argentina
13282,Ángel Martínez,0,64.0,0,0,0,1,1,Haiti
13283,Ángel María Villar,0,34.0,0,0,0,2,2,Romania
13284,Ángel Mena,1,242.0,0,0,3,2,5,Ecuador
13285,Ángel Piedra,1,73.0,0,0,1,0,1,Cuba
13286,Ángel Reyna,1,86.0,0,0,0,1,1,Guyana
13287,Ángel Romano,5,524.0,0,0,6,6,12,Uruguay
13288,Ángel Romero,2,420.0,0,2,6,1,7,Paraguay
13289,Ángel Sepúlveda,1,80.0,0,0,0,2,2,El Salvador
13290,Ángel Tejeda,0,18.0,0,1,0,1,1,Jamaica
13291,Ángelo Padilla,0,45.0,0,0,1,0,1,Guatemala
13292,Ármann Björnsson,0,6.0,0,0,1,0,1,Iceland
13293,Árni Sveinsson,0,75.0,0,0,1,0,1,Iceland
13294,Ásgeir Sigurvinsson,0,208.0,0,0,1,3,4,Iceland
13295,Änis Ben-Hatira,0,79.0,0,0,1,0,1,Tunisia
13296,Åge Hareide,0,120.0,0,0,3,1,4,Norway
13297,Çağlar Söyüncü,1,28.0,0,0,0,1,1,Norway
13298,Éder,1,258.0,0,0,2,2,4,Bulgaria
13299,Éder Aleixo de Assis,2,297.0,0,0,3,1,4,Brazil
13300,Éder Militão,0,37.0,0,0,1,0,1,Brazil
13301,Édgar Barreto,1,29.0,0,0,0,1,1,United States
13302,Édgar Benítez,1,371.0,1,0,2,4,6,Ecuador
13303,Édgar González,0,90.0,0,0,1,0,1,Guatemala
13304,Édison Méndez,4,730.0,1,1,10,5,15,Peru
13305,Édouard Kargu,0,73.0,0,0,0,1,1,Luxembourg
13306,Élmer Ponciano,0,2.0,0,0,1,0,1,Guatemala
13307,Émerson Ferreira da Rosa,0,67.0,0,0,0,1,1,Uruguay
13308,Émile Mpenza,0,304.0,0,0,9,0,9,Belgium
13309,Émile Veinante,0,1.0,0,0,1,0,1,France
13310,Éric Assadourian,0,135.0,0,0,1,2,3,Northern Ireland
13311,Éric Mouloungui,0,119.0,0,0,2,0,2,Gabon
13312,Éric Pécout,0,67.0,0,0,1,0,1,France
13313,Étienne Capoue,0,49.0,0,0,1,0,1,France
13314,Étienne N'tsunda,1,29.0,0,0,1,0,1,DR Congo
13315,Éver Banega,1,103.0,0,0,1,1,2,Bolivia
13316,Éverton Ribeiro,0,168.0,0,0,2,1,3,Brazil
13317,Ísak Bergmann Jóhannesson,0,77.0,0,0,1,0,1,Iceland
13318,Ítalo Díaz,0,12.0,1,0,0,1,1,Chile
13319,Ítalo Estupiñán,0,35.0,0,0,1,0,1,Ecuador
13320,Óli Johannesen,0,70.0,1,0,0,1,1,Faroe Islands
13321,Óscar Aguilera,0,88.0,0,0,0,1,1,Colombia
13322,Óscar Cardozo,2,310.0,0,1,2,3,5,United States
13323,Óscar Carmelo Sánchez,0,71.0,0,0,0,1,1,Uruguay
13324,Óscar Duarte,1,77.0,0,0,1,1,2,Uruguay
13325,Óscar Gómez Sánchez,7,513.0,0,0,3,7,10,Peru
13326,Óscar Míguez,11,767.0,0,2,4,11,15,Bolivia
13327,Óscar Ramírez,0,93.0,0,0,1,1,2,Costa Rica
13328,Óscar Reyes,1,85.0,0,0,0,1,1,Bolivia
13329,Óscar Rojas,0,48.0,0,0,1,0,1,Mexico
13330,Óscar Romero,0,6.0,0,0,1,0,1,Paraguay
13331,Óscar Sonejee,0,110.0,1,0,1,1,2,Andorra
13332,Óscar Ulloa,0,399.0,0,0,2,4,6,Nicaragua
13333,Örjan Martinsson,0,50.0,0,0,0,2,2,Norway
13334,Örjan Persson,0,111.0,0,0,2,1,3,Sweden
13335,Örn Óskarsson,0,90.0,0,0,0,1,1,Norway
13336,Øssur Hansen,0,150.0,0,0,1,1,2,Malta
13337,Øyvind Leonhardsen,0,250.0,0,0,3,3,6,Norway
13338,Ümit Davala,1,181.0,0,0,2,2,4,North Macedonia
13339,Ümit Karan,0,63.0,0,0,0,1,1,Moldova
13340,Ünal Karaman,0,73.0,0,0,1,0,1,Turkey
13341,Þorsteinn Bjarnason,0,78.0,1,0,1,0,1,Czechoslovakia
13342,Þorvaldur Örlygsson,0,122.0,0,0,1,1,2,Iceland
13343,Þórður Guðjónsson,0,326.0,0,0,3,2,5,Iceland
13344,Þórður Jónsson,0,129.0,0,0,2,0,2,Iceland
13345,Þórður Þórðarson,0,110.0,0,0,0,2,2,Belgium
13346,Đinh Tiến Thành,0,109.0,1,0,0,2,2,Taiwan
13347,Đorđe Vujadinović,1,89.0,0,0,0,2,2,Bolivia
13348,Đovani Roso,0,71.0,0,0,0,1,1,Andorra
13349,Đỗ Duy Mạnh,0,26.0,0,0,0,1,1,Indonesia
13350,Ģirts Karlsons,0,61.0,0,0,2,2,4,Latvia
13351,İbrahim Toraman,0,15.0,0,0,0,1,1,Kazakhstan
13352,İlhan Mansız,1,265.0,0,0,2,4,6,Moldova
13353,İlkay Gündoğan,2,528.0,0,5,6,6,12,Germany
13354,İlyas Tüfekçi,0,140.0,0,1,2,0,2,Turkey
13355,İrfan Kahveci,1,62.0,0,0,0,1,1,Switzerland
13356,İsmail Arca,0,64.0,1,0,2,0,2,Turkey
13357,Ľubomír Meszároš,0,57.0,0,0,1,0,1,Slovakia
13358,Ľubomír Michalík,0,42.0,0,0,0,1,1,San Marino
13359,Ľubomír Moravčík,0,262.0,0,0,3,3,6,Czechoslovakia
13360,Ľubomír Reiter,0,312.0,0,0,2,4,6,North Macedonia
13361,Ľuboš Hanzel,0,68.0,0,0,1,0,1,Slovakia
13362,Ľudovít Lancz,0,39.0,0,0,1,0,1,Czechoslovakia
13363,Łukasz Garguła,0,89.0,0,0,1,0,1,Poland
13364,Łukasz Piszczek,0,128.0,0,0,2,1,3,Poland
13365,Łukasz Szukała,1,58.0,0,0,0,1,1,Gibraltar
13366,Łukasz Teodorczyk,0,60.0,0,0,1,0,1,Poland
13367,Ştefan Sameş,0,130.0,0,0,2,0,2,Romania
13368,Štěpán Vachoušek,0,78.0,0,0,0,1,1,Austria
13369,Žarko Odžakov,0,166.0,0,0,3,0,3,Australia
13370,Žarko Serafimovski,0,20.0,0,0,0,1,1,Turkey
13371,Žarko Tomašević,0,233.0,0,0,3,1,4,Montenegro
13372,Željko Milinovič,1,47.0,0,0,0,2,2,Luxembourg
13373,Željko Čajkovski,3,369.0,0,0,2,4,6,Yugoslavia
13374,Ștefan Dobay,3,292.0,0,0,1,4,5,Switzerland
13375,Ștefan Iovan,0,162.0,0,0,2,1,3,Turkey
